公投案編號,縣市,行政區,村里,投開票所,投票權人數,同意票數,不同意票數,有效票數,無效票數,投票人數
公投第１４案,連江縣,,,,11205,1493,4083,5576,183,5759
公投第１４案,金門縣,,,,122695,10414,31439,41853,2076,43929
公投第１４案,宜蘭縣,,,,386089,66039,133819,199858,14588,214446
公投第１４案,新竹縣,,,,445051,73718,166893,240611,11635,252246
公投第１４案,苗栗縣,,,,461580,69712,177248,246960,15666,262626
公投第１４案,彰化縣,,,,1066994,169785,406975,576760,37374,614134
公投第１４案,南投縣,,,,427089,64424,169616,234040,14360,248400
公投第１４案,雲林縣,,,,584480,83844,196025,279869,22541,302410
公投第１４案,嘉義縣,,,,442775,61462,144616,206078,18516,224594
公投第１４案,屏東縣,,,,711720,105349,238235,343584,28287,371871
公投第１４案,臺東縣,,,,185996,23365,65685,89050,6940,95990
公投第１４案,花蓮縣,,,,278059,36102,100144,136246,10129,146375
公投第１４案,澎湖縣,,,,90405,11008,27052,38060,2692,40752
公投第１４案,基隆市,,,,320030,53224,103741,156965,8372,165337
公投第１４案,新竹市,,,,351775,65851,124511,190362,8887,199249
公投第１４案,嘉義市,,,,221553,37776,77841,115617,6009,121626
公投第１４案,臺北市,,,,2228430,469793,762277,1232070,59045,1291115
公投第１４案,高雄市,,,,2353342,427186,885698,1312884,74414,1387298
公投第１４案,新北市,,,,3375513,616312,1148290,1764602,103690,1868292
公投第１４案,臺中市,,,,2295642,395557,866827,1262384,71128,1333512
公投第１４案,臺南市,,,,1594821,257730,515188,772918,47869,820787
公投第１４案,桃園市,,,,1801823,282142,603494,885636,44083,929719
公投第１４案,連江縣,南竿鄉,,,6461,790,2397,3187,101,3288
公投第１４案,連江縣,莒光鄉,,,1481,185,572,757,27,784
公投第１４案,連江縣,北竿鄉,,,2125,247,829,1076,34,1110
公投第１４案,連江縣,東引鄉,,,1138,271,285,556,21,577
公投第１４案,金門縣,金沙鎮,,,18560,1191,5049,6240,336,6576
公投第１４案,金門縣,烏坵鄉,,,567,37,124,161,4,165
公投第１４案,金門縣,烈嶼鄉,,,11676,823,3243,4066,193,4259
公投第１４案,金門縣,金城鎮,,,37815,3216,9370,12586,653,13239
公投第１４案,金門縣,金湖鎮,,,25915,2121,6928,9049,452,9501
公投第１４案,金門縣,金寧鄉,,,28162,3026,6725,9751,438,10189
公投第１４案,宜蘭縣,冬山鄉,,,45405,7599,15447,23046,1445,24491
公投第１４案,宜蘭縣,三星鄉,,,19051,2905,6235,9140,848,9988
公投第１４案,宜蘭縣,羅東鎮,,,57686,10777,20418,31195,2004,33199
公投第１４案,宜蘭縣,大同鄉,,,4935,556,2141,2697,192,2889
公投第１４案,宜蘭縣,壯圍鄉,,,21447,3966,7329,11295,1116,12411
公投第１４案,宜蘭縣,頭城鎮,,,25135,4144,8579,12723,1078,13801
公投第１４案,宜蘭縣,五結鄉,,,34892,5805,11661,17466,1252,18718
公投第１４案,宜蘭縣,宜蘭市,,,79167,14241,28110,42351,2473,44824
公投第１４案,宜蘭縣,員山鄉,,,28131,4660,9221,13881,1256,15137
公投第１４案,宜蘭縣,礁溪鄉,,,31084,5114,10560,15674,1128,16802
公投第１４案,宜蘭縣,蘇澳鎮,,,34512,5786,11967,17753,1621,19374
公投第１４案,宜蘭縣,南澳鄉,,,4644,486,2151,2637,175,2812
公投第１４案,新竹縣,橫山鄉,,,11346,1624,4608,6232,479,6711
公投第１４案,新竹縣,北埔鄉,,,8180,1229,3165,4394,248,4642
公投第１４案,新竹縣,峨眉鄉,,,5068,689,2114,2803,253,3056
公投第１４案,新竹縣,尖石鄉,,,7364,681,2889,3570,198,3768
公投第１４案,新竹縣,芎林鄉,,,17293,2767,6855,9622,571,10193
公投第１４案,新竹縣,竹東鎮,,,78794,12175,28462,40637,1990,42627
公投第１４案,新竹縣,關西鎮,,,24712,3623,9655,13278,786,14064
公投第１４案,新竹縣,新埔鎮,,,28894,4323,11109,15432,870,16302
公投第１４案,新竹縣,寶山鄉,,,12973,2262,4960,7222,347,7569
公投第１４案,新竹縣,湖口鄉,,,63511,9767,24243,34010,1712,35722
公投第１４案,新竹縣,新豐鄉,,,45790,7092,17354,24446,1199,25645
公投第１４案,新竹縣,五峰鄉,,,3997,393,1513,1906,78,1984
公投第１４案,新竹縣,竹北市,,,137129,27093,49966,77059,2904,79963
公投第１４案,苗栗縣,南庄鄉,,,8784,1088,2956,4044,295,4339
公投第１４案,苗栗縣,通霄鎮,,,29709,4317,10427,14744,1336,16080
公投第１４案,苗栗縣,大湖鄉,,,12653,1679,4573,6252,513,6765
公投第１４案,苗栗縣,苑裡鎮,,,38890,5758,15032,20790,1610,22400
公投第１４案,苗栗縣,竹南鎮,,,68528,11195,25219,36414,1980,38394
公投第１４案,苗栗縣,頭屋鄉,,,9390,1586,4187,5773,349,6122
公投第１４案,苗栗縣,泰安鄉,,,5180,727,2542,3269,200,3469
公投第１４案,苗栗縣,頭份市,,,83617,12822,32287,45109,2293,47402
公投第１４案,苗栗縣,卓蘭鎮,,,14772,2247,5873,8120,567,8687
公投第１４案,苗栗縣,苗栗市,,,74249,11499,29449,40948,2019,42967
公投第１４案,苗栗縣,三義鄉,,,13889,1971,5796,7767,381,8148
公投第１４案,苗栗縣,公館鄉,,,28318,4235,11312,15547,1169,16716
公投第１４案,苗栗縣,西湖鄉,,,6382,927,2377,3304,230,3534
公投第１４案,苗栗縣,造橋鄉,,,11027,1613,4303,5916,503,6419
公投第１４案,苗栗縣,銅鑼鄉,,,15424,2188,5976,8164,486,8650
公投第１４案,苗栗縣,後龍鎮,,,30948,4624,11173,15797,1316,17113
公投第１４案,苗栗縣,獅潭鄉,,,3968,436,1421,1857,183,2040
公投第１４案,苗栗縣,三灣鄉,,,5852,800,2345,3145,236,3381
公投第１４案,彰化縣,大城鄉,,,14713,1268,3990,5258,495,5753
公投第１４案,彰化縣,竹塘鄉,,,12821,1708,4713,6421,551,6972
公投第１４案,彰化縣,埤頭鄉,,,25677,3697,9130,12827,1227,14054
公投第１４案,彰化縣,溪州鄉,,,25405,3786,8329,12115,1054,13169
公投第１４案,彰化縣,芳苑鄉,,,29291,3302,9846,13148,1267,14415
公投第１４案,彰化縣,鹿港鎮,,,70505,10989,27443,38432,2624,41056
公投第１４案,彰化縣,伸港鄉,,,30407,4690,11464,16154,1123,17277
公投第１４案,彰化縣,埔心鄉,,,29642,4971,12155,17126,1166,18292
公投第１４案,彰化縣,社頭鄉,,,36306,5559,14208,19767,1223,20990
公投第１４案,彰化縣,田中鎮,,,35391,5233,13929,19162,1370,20532
公投第１４案,彰化縣,彰化市,,,190995,35013,74892,109905,5771,115676
公投第１４案,彰化縣,員林市,,,102028,16826,38432,55258,2885,58143
公投第１４案,彰化縣,和美鎮,,,75286,12440,28280,40720,2208,42928
公投第１４案,彰化縣,北斗鎮,,,27593,4468,10677,15145,1019,16164
公投第１４案,彰化縣,永靖鄉,,,31239,5312,12160,17472,1183,18655
公投第１４案,彰化縣,秀水鄉,,,32394,5339,12780,18119,1157,19276
公投第１４案,彰化縣,福興鄉,,,39745,5670,14443,20113,1517,21630
公投第１４案,彰化縣,溪湖鎮,,,45147,7098,17714,24812,1524,26336
公投第１４案,彰化縣,田尾鄉,,,23179,3604,9306,12910,861,13771
公投第１４案,彰化縣,二林鎮,,,42976,5654,15454,21108,1588,22696
公投第１４案,彰化縣,線西鄉,,,14065,2540,5284,7824,561,8385
公投第１４案,彰化縣,花壇鄉,,,38924,6356,15329,21685,1327,23012
公投第１４案,彰化縣,二水鄉,,,13339,2210,5233,7443,631,8074
公投第１４案,彰化縣,埔鹽鄉,,,28026,3951,11787,15738,1185,16923
公投第１４案,彰化縣,大村鄉,,,31492,4826,12656,17482,1082,18564
公投第１４案,彰化縣,芬園鄉,,,20408,3275,7341,10616,775,11391
公投第１４案,南投縣,竹山鎮,,,47034,6548,17847,24395,1714,26109
公投第１４案,南投縣,水里鄉,,,15458,2209,5887,8096,564,8660
公投第１４案,南投縣,信義鄉,,,13299,1752,5884,7636,583,8219
公投第１４案,南投縣,國姓鄉,,,16597,2278,6513,8791,613,9404
公投第１４案,南投縣,鹿谷鄉,,,15941,2541,5431,7972,552,8524
公投第１４案,南投縣,魚池鄉,,,13958,2215,4904,7119,507,7626
公投第１４案,南投縣,集集鎮,,,9611,1468,3726,5194,385,5579
公投第１４案,南投縣,草屯鎮,,,82922,13144,32838,45982,2329,48311
公投第１４案,南投縣,埔里鎮,,,68763,9897,27617,37514,2304,39818
公投第１４案,南投縣,南投市,,,84328,13599,35060,48659,2561,51220
公投第１４案,南投縣,名間鄉,,,33408,5059,13700,18759,1355,20114
公投第１４案,南投縣,中寮鄉,,,13181,1881,5238,7119,518,7637
公投第１４案,南投縣,仁愛鄉,,,12589,1833,4971,6804,375,7179
公投第１４案,雲林縣,虎尾鎮,,,58167,8894,20574,29468,1670,31138
公投第１４案,雲林縣,斗六市,,,89761,14769,34352,49121,2328,51449
公投第１４案,雲林縣,西螺鎮,,,38142,5739,12903,18642,1609,20251
公投第１４案,雲林縣,莿桐鄉,,,24570,3806,8512,12318,1193,13511
公投第１４案,雲林縣,土庫鎮,,,24412,3521,8220,11741,1105,12846
公投第１４案,雲林縣,古坑鄉,,,27477,3823,9653,13476,1066,14542
公投第１４案,雲林縣,水林鄉,,,22508,2789,6007,8796,973,9769
公投第１４案,雲林縣,斗南鎮,,,38138,6245,14041,20286,1395,21681
公投第１４案,雲林縣,口湖鄉,,,24193,2889,7343,10232,1240,11472
公投第１４案,雲林縣,臺西鄉,,,21125,2308,6511,8819,862,9681
公投第１４案,雲林縣,北港鎮,,,33958,5355,11642,16997,1559,18556
公投第１４案,雲林縣,二崙鄉,,,23367,3016,7007,10023,1122,11145
公投第１４案,雲林縣,林內鄉,,,15551,2451,5524,7975,845,8820
公投第１４案,雲林縣,四湖鄉,,,20983,2046,5442,7488,800,8288
公投第１４案,雲林縣,元長鄉,,,22830,2580,6422,9002,848,9850
公投第１４案,雲林縣,麥寮鄉,,,37119,4892,11932,16824,1402,18226
公投第１４案,雲林縣,崙背鄉,,,21050,2900,6510,9410,829,10239
公投第１４案,雲林縣,褒忠鄉,,,11381,1690,3767,5457,410,5867
公投第１４案,雲林縣,東勢鄉,,,13239,1805,4192,5997,600,6597
公投第１４案,雲林縣,大埤鄉,,,16509,2326,5471,7797,685,8482
公投第１４案,嘉義縣,溪口鄉,,,13105,1945,4013,5958,710,6668
公投第１４案,嘉義縣,中埔鄉,,,39139,5013,11948,16961,1386,18347
公投第１４案,嘉義縣,民雄鄉,,,61209,9608,20757,30365,2454,32819
公投第１４案,嘉義縣,六腳鄉,,,20821,2355,5572,7927,846,8773
公投第１４案,嘉義縣,梅山鄉,,,17083,2473,6061,8534,856,9390
公投第１４案,嘉義縣,大埔鄉,,,3999,612,1454,2066,121,2187
公投第１４案,嘉義縣,朴子市,,,35191,5003,11776,16779,1431,18210
公投第１４案,嘉義縣,鹿草鄉,,,13937,1839,3973,5812,755,6567
公投第１４案,嘉義縣,水上鄉,,,43857,6509,14932,21441,1798,23239
公投第１４案,嘉義縣,布袋鎮,,,23965,2878,7679,10557,1111,11668
公投第１４案,嘉義縣,竹崎鄉,,,31228,4207,10831,15038,1092,16130
公投第１４案,嘉義縣,新港鄉,,,27342,4181,9079,13260,1436,14696
公投第１４案,嘉義縣,番路鄉,,,10156,1364,3923,5287,394,5681
公投第１４案,嘉義縣,東石鄉,,,21915,2032,5889,7921,963,8884
公投第１４案,嘉義縣,阿里山鄉,,,4691,437,1639,2076,112,2188
公投第１４案,嘉義縣,大林鎮,,,26922,3920,9033,12953,988,13941
公投第１４案,嘉義縣,太保市,,,31568,4847,10763,15610,1198,16808
公投第１４案,嘉義縣,義竹鄉,,,16647,2239,5294,7533,865,8398
公投第１４案,屏東縣,里港鄉,,,22128,3647,7278,10925,1225,12150
公投第１４案,屏東縣,林邊鄉,,,15691,2351,5531,7882,860,8742
公投第１４案,屏東縣,竹田鄉,,,15353,2437,5438,7875,865,8740
公投第１４案,屏東縣,新埤鄉,,,9033,1201,2953,4154,407,4561
公投第１４案,屏東縣,麟洛鄉,,,9970,1695,3660,5355,371,5726
公投第１４案,屏東縣,枋山鄉,,,4856,682,1568,2250,212,2462
公投第１４案,屏東縣,屏東市,,,170148,26847,59054,85901,4615,90516
公投第１４案,屏東縣,瑪家鄉,,,5663,862,2507,3369,199,3568
公投第１４案,屏東縣,高樹鄉,,,21697,3064,6504,9568,1117,10685
公投第１４案,屏東縣,獅子鄉,,,4230,515,1674,2189,100,2289
公投第１４案,屏東縣,琉球鄉,,,10706,1062,3341,4403,345,4748
公投第１４案,屏東縣,泰武鄉,,,4344,631,1948,2579,228,2807
公投第１４案,屏東縣,霧臺鄉,,,2950,414,1291,1705,111,1816
公投第１４案,屏東縣,滿州鄉,,,7206,887,1982,2869,210,3079
公投第１４案,屏東縣,車城鄉,,,7595,968,1913,2881,266,3147
公投第１４案,屏東縣,恆春鎮,,,25661,3613,7664,11277,786,12063
公投第１４案,屏東縣,枋寮鄉,,,21394,2916,7210,10126,1218,11344
公投第１４案,屏東縣,鹽埔鄉,,,22402,3263,7500,10763,880,11643
公投第１４案,屏東縣,新園鄉,,,30706,4401,10267,14668,1535,16203
公投第１４案,屏東縣,春日鄉,,,3923,432,897,1329,52,1381
公投第１４案,屏東縣,三地門鄉,,,6373,938,2463,3401,230,3631
公投第１４案,屏東縣,長治鄉,,,26256,4391,8870,13261,1202,14463
公投第１４案,屏東縣,南州鄉,,,9479,1592,2968,4560,462,5022
公投第１４案,屏東縣,東港鎮,,,39495,5699,13456,19155,1835,20990
公投第１４案,屏東縣,崁頂鄉,,,12270,1904,3962,5866,570,6436
公投第１４案,屏東縣,內埔鄉,,,47558,6425,14587,21012,1607,22619
公投第１４案,屏東縣,牡丹鄉,,,4314,527,1196,1723,76,1799
公投第１４案,屏東縣,萬丹鄉,,,43478,6538,14763,21301,1917,23218
公投第１４案,屏東縣,潮州鎮,,,46444,6776,15936,22712,1538,24250
公投第１４案,屏東縣,來義鄉,,,6257,788,2692,3480,254,3734
公投第１４案,屏東縣,九如鄉,,,19132,2870,6438,9308,1113,10421
公投第１４案,屏東縣,萬巒鄉,,,17945,2591,5675,8266,900,9166
公投第１４案,屏東縣,佳冬鄉,,,17063,2422,5049,7471,981,8452
公投第１４案,臺東縣,成功鎮,,,12426,1189,4309,5498,649,6147
公投第１４案,臺東縣,長濱鄉,,,6484,562,1793,2355,363,2718
公投第１４案,臺東縣,蘭嶼鄉,,,4181,417,1093,1510,90,1600
公投第１４案,臺東縣,卑南鄉,,,14976,1956,5204,7160,708,7868
公投第１４案,臺東縣,延平鄉,,,2930,352,1135,1487,117,1604
公投第１４案,臺東縣,臺東市,,,87803,12117,33290,45407,2640,48047
公投第１４案,臺東縣,關山鎮,,,7509,924,2596,3520,227,3747
公投第１４案,臺東縣,綠島鄉,,,3579,481,1040,1521,58,1579
公投第１４案,臺東縣,大武鄉,,,5266,621,1713,2334,376,2710
公投第１４案,臺東縣,鹿野鄉,,,6936,864,2044,2908,220,3128
公投第１４案,臺東縣,東河鄉,,,7635,788,2203,2991,358,3349
公投第１４案,臺東縣,池上鄉,,,7162,818,2187,3005,301,3306
公投第１４案,臺東縣,太麻里鄉,,,9666,1099,3268,4367,420,4787
公投第１４案,臺東縣,海端鄉,,,3278,351,1281,1632,124,1756
公投第１４案,臺東縣,金峰鄉,,,3028,453,1217,1670,145,1815
公投第１４案,臺東縣,達仁鄉,,,3137,373,1312,1685,144,1829
公投第１４案,花蓮縣,鳳林鎮,,,9676,1242,3638,4880,468,5348
公投第１４案,花蓮縣,光復鄉,,,11417,1246,3966,5212,669,5881
公投第１４案,花蓮縣,壽豐鄉,,,15847,2161,5885,8046,758,8804
公投第１４案,花蓮縣,秀林鄉,,,12562,1602,4402,6004,449,6453
公投第１４案,花蓮縣,萬榮鄉,,,5269,667,2014,2681,262,2943
公投第１４案,花蓮縣,豐濱鄉,,,4395,485,1248,1733,273,2006
公投第１４案,花蓮縣,玉里鎮,,,20650,2279,6432,8711,1083,9794
公投第１４案,花蓮縣,瑞穗鄉,,,10279,1029,3532,4561,516,5077
公投第１４案,花蓮縣,吉安鄉,,,72116,9393,26662,36055,2081,38136
公投第１４案,花蓮縣,花蓮市,,,84807,12198,31255,43453,2228,45681
公投第１４案,花蓮縣,新城鄉,,,17029,2336,6293,8629,617,9246
公投第１４案,花蓮縣,卓溪鄉,,,4947,551,2007,2558,291,2849
公投第１４案,花蓮縣,富里鄉,,,9065,913,2810,3723,434,4157
公投第１４案,澎湖縣,望安鄉,,,4628,495,1193,1688,156,1844
公投第１４案,澎湖縣,白沙鄉,,,8625,886,2483,3369,287,3656
公投第１４案,澎湖縣,馬公市,,,53655,7199,17432,24631,1522,26153
公投第１４案,澎湖縣,湖西鄉,,,12741,1445,3701,5146,378,5524
公投第１４案,澎湖縣,西嶼鄉,,,7382,666,1618,2284,270,2554
公投第１４案,澎湖縣,七美鄉,,,3374,317,625,942,79,1021
公投第１４案,基隆市,暖暖區,,,33225,5920,11065,16985,713,17698
公投第１４案,基隆市,信義區,,,46014,7688,15505,23193,944,24137
公投第１４案,基隆市,中正區,,,45545,6497,13633,20130,1355,21485
公投第１４案,基隆市,中山區,,,41856,6749,13396,20145,1141,21286
公投第１４案,基隆市,仁愛區,,,36738,6151,12100,18251,1309,19560
公投第１４案,基隆市,安樂區,,,70396,12394,22700,35094,1570,36664
公投第１４案,基隆市,七堵區,,,46256,7825,15342,23167,1340,24507
公投第１４案,新竹市,東區,,,163757,32694,57138,89832,3741,93573
公投第１４案,新竹市,香山區,,,64896,11128,23396,34524,1950,36474
公投第１４案,新竹市,北區,,,123122,22029,43977,66006,3196,69202
公投第１４案,嘉義市,東區,,,100647,17757,34768,52525,2599,55124
公投第１４案,嘉義市,西區,,,120906,20019,43073,63092,3410,66502
公投第１４案,臺北市,大同區,,,107557,23597,35491,59088,3422,62510
公投第１４案,臺北市,中山區,,,195148,41628,64606,106234,5201,111435
公投第１４案,臺北市,中正區,,,128292,26803,45286,72089,3086,75175
公投第１４案,臺北市,士林區,,,241854,50658,80462,131120,7567,138687
公投第１４案,臺北市,萬華區,,,164020,32071,54169,86240,5330,91570
公投第１４案,臺北市,南港區,,,101907,21854,35073,56927,2530,59457
公投第１４案,臺北市,文山區,,,227211,47668,82459,130127,5924,136051
公投第１４案,臺北市,信義區,,,190444,39545,66509,106054,4758,110812
公投第１４案,臺北市,松山區,,,169278,36698,59358,96056,4370,100426
公投第１４案,臺北市,大安區,,,252645,53370,87228,140598,5605,146203
公投第１４案,臺北市,內湖區,,,236824,52075,81158,133233,5297,138530
公投第１４案,臺北市,北投區,,,213250,43826,70478,114304,5955,120259
公投第１４案,高雄市,內門區,,,13002,1561,4042,5603,614,6217
公投第１４案,高雄市,茂林區,,,1615,233,837,1070,43,1113
公投第１４案,高雄市,桃源區,,,3498,395,1376,1771,75,1846
公投第１４案,高雄市,杉林區,,,10607,1180,3386,4566,432,4998
公投第１４案,高雄市,美濃區,,,35311,4763,13154,17917,1568,19485
公投第１４案,高雄市,甲仙區,,,5417,681,1759,2440,245,2685
公投第１４案,高雄市,茄萣區,,,26212,4092,9081,13173,1016,14189
公投第１４案,高雄市,路竹區,,,43850,7707,16540,24247,1715,25962
公投第１４案,高雄市,阿蓮區,,,24534,3946,8606,12552,756,13308
公投第１４案,高雄市,湖內區,,,25729,4290,9315,13605,808,14413
公投第１４案,高雄市,梓官區,,,31025,5333,11730,17063,1155,18218
公投第１４案,高雄市,岡山區,,,81244,14572,32998,47570,2532,50102
公投第１４案,高雄市,鳥松區,,,39191,7872,14815,22687,1215,23902
公投第１４案,高雄市,大社區,,,30046,5495,10662,16157,1062,17219
公投第１４案,高雄市,橋頭區,,,32565,6068,12780,18848,1400,20248
公投第１４案,高雄市,田寮區,,,6671,903,2007,2910,302,3212
公投第１４案,高雄市,大樹區,,,36772,5867,13398,19265,1310,20575
公投第１４案,高雄市,旗津區,,,24860,3934,8078,12012,969,12981
公投第１４案,高雄市,鳳山區,,,300510,55389,114830,170219,9270,179489
公投第１４案,高雄市,前金區,,,23928,4649,9216,13865,685,14550
公投第１４案,高雄市,苓雅區,,,146786,28522,57208,85730,4100,89830
公投第１４案,高雄市,左營區,,,161367,29870,64229,94099,4131,98230
公投第１４案,高雄市,鼓山區,,,114979,22096,43286,65382,3072,68454
公投第１４案,高雄市,新興區,,,44355,9020,16882,25902,1319,27221
公投第１４案,高雄市,仁武區,,,73611,13145,28120,41265,1851,43116
公投第１４案,高雄市,小港區,,,132733,24368,49715,74083,3952,78035
公投第１４案,高雄市,楠梓區,,,153132,28203,58257,86460,5454,91914
公投第１４案,高雄市,三民區,,,289519,56428,107656,164084,7746,171830
公投第１４案,高雄市,彌陀區,,,16487,3231,6147,9378,837,10215
公投第１４案,高雄市,林園區,,,59129,9748,21186,30934,1974,32908
公投第１４案,高雄市,鹽埕區,,,21617,4601,7454,12055,501,12556
公投第１４案,高雄市,那瑪夏區,,,2424,285,1201,1486,117,1603
公投第１４案,高雄市,永安區,,,12001,2115,4960,7075,501,7576
公投第１４案,高雄市,大寮區,,,97309,16625,35779,52404,3199,55603
公投第１４案,高雄市,旗山區,,,31996,5161,11400,16561,1326,17887
公投第１４案,高雄市,燕巢區,,,26012,4238,9634,13872,1058,14930
公投第１４案,高雄市,前鎮區,,,161797,29186,60498,89684,5513,95197
公投第１４案,高雄市,六龜區,,,11501,1414,3476,4890,591,5481
公投第１４案,新北市,坪林區,,,5891,828,1904,2732,293,3025
公投第１４案,新北市,淡水區,,,147272,26961,47281,74242,3608,77850
公投第１４案,新北市,五股區,,,72443,12563,24051,36614,2267,38881
公投第１４案,新北市,中和區,,,355978,63839,124418,188257,9944,198201
公投第１４案,新北市,三峽區,,,94291,15839,31579,47418,2464,49882
公投第１４案,新北市,汐止區,,,173831,31677,55598,87275,4707,91982
公投第１４案,新北市,貢寮區,,,11279,1379,3133,4512,455,4967
公投第１４案,新北市,深坑區,,,20624,3779,6991,10770,587,11357
公投第１４案,新北市,新莊區,,,344981,66304,118755,185059,11384,196443
公投第１４案,新北市,萬里區,,,19297,2471,6352,8823,795,9618
公投第１４案,新北市,金山區,,,18978,2654,5944,8598,1046,9644
公投第１４案,新北市,泰山區,,,64252,11483,22314,33797,1789,35586
公投第１４案,新北市,三芝區,,,20119,3073,6026,9099,671,9770
公投第１４案,新北市,土城區,,,200783,36847,67566,104413,5912,110325
公投第１４案,新北市,樹林區,,,152102,27613,52060,79673,4595,84268
公投第１４案,新北市,蘆洲區,,,167457,30458,54275,84733,5146,89879
公投第１４案,新北市,鶯歌區,,,71645,12235,23842,36077,1985,38062
公投第１４案,新北市,平溪區,,,4321,523,1348,1871,207,2078
公投第１４案,新北市,新店區,,,264053,47379,95746,143125,6697,149822
公投第１４案,新北市,雙溪區,,,7999,1051,2456,3507,376,3883
公投第１４案,新北市,林口區,,,86203,16387,29678,46065,2208,48273
公投第１４案,新北市,三重區,,,329846,62307,109279,171586,12940,184526
公投第１４案,新北市,瑞芳區,,,35036,4937,10761,15698,1317,17015
公投第１４案,新北市,板橋區,,,463411,88512,158751,247263,15343,262606
公投第１４案,新北市,八里區,,,32970,5618,10819,16437,1047,17484
公投第１４案,新北市,石碇區,,,6861,1015,2155,3170,300,3470
公投第１４案,新北市,永和區,,,187798,36235,69918,106153,4925,111078
公投第１４案,新北市,石門區,,,10528,1535,3352,4887,570,5457
公投第１４案,新北市,烏來區,,,5264,810,1938,2748,112,2860
公投第１４案,臺中市,豐原區,,,136658,23853,53873,77726,4566,82292
公投第１４案,臺中市,西區,,,95040,18475,34789,53264,2577,55841
公投第１４案,臺中市,西屯區,,,183814,34071,67645,101716,4986,106702
公投第１４案,臺中市,大里區,,,171769,28448,63477,91925,4937,96862
公投第１４案,臺中市,中區,,,14696,2451,5329,7780,489,8269
公投第１４案,臺中市,東勢區,,,43181,6038,17546,23584,1865,25449
公投第１４案,臺中市,大甲區,,,63069,10111,23943,34054,2346,36400
公投第１４案,臺中市,霧峰區,,,55225,8969,22232,31201,2261,33462
公投第１４案,臺中市,清水區,,,71528,12030,27156,39186,2752,41938
公投第１４案,臺中市,南區,,,103643,20611,39862,60473,3253,63726
公投第１４案,臺中市,新社區,,,20860,2779,7819,10598,667,11265
公投第１４案,臺中市,和平區,,,9498,1190,4486,5676,327,6003
公投第１４案,臺中市,太平區,,,157926,24875,57165,82040,4681,86721
公投第１４案,臺中市,梧棲區,,,47040,7603,17622,25225,1685,26910
公投第１４案,臺中市,龍井區,,,63584,10845,23194,34039,1946,35985
公投第１４案,臺中市,大安區,,,16520,2478,6446,8924,810,9734
公投第１４案,臺中市,烏日區,,,61705,10429,23671,34100,2151,36251
公投第１４案,臺中市,大肚區,,,47457,7711,18322,26033,1711,27744
公投第１４案,臺中市,大雅區,,,77189,12308,29879,42187,2229,44416
公投第１４案,臺中市,外埔區,,,27059,3965,10906,14871,999,15870
公投第１４案,臺中市,石岡區,,,12880,1890,5229,7119,531,7650
公投第１４案,臺中市,神岡區,,,54565,8920,21601,30521,2080,32601
公投第１４案,臺中市,后里區,,,44962,7155,17267,24422,1819,26241
公投第１４案,臺中市,潭子區,,,89487,15517,33540,49057,2556,51613
公投第１４案,臺中市,沙鹿區,,,74207,12165,27773,39938,2330,42268
公投第１４案,臺中市,北屯區,,,227720,40045,85010,125055,5636,130691
公投第１４案,臺中市,南屯區,,,135448,26220,52042,78262,3769,82031
公投第１４案,臺中市,北區,,,124621,22588,44811,67399,3166,70565
公投第１４案,臺中市,東區,,,64291,11817,24192,36009,2003,38012
公投第１４案,臺南市,佳里區,,,50407,7962,16801,24763,1644,26407
公投第１４案,臺南市,學甲區,,,22567,3070,6899,9969,739,10708
公投第１４案,臺南市,東山區,,,18471,1904,4405,6309,686,6995
公投第１４案,臺南市,歸仁區,,,57387,9985,18947,28932,1603,30535
公投第１４案,臺南市,新營區,,,64949,10002,20659,30661,1697,32358
公投第１４案,臺南市,西港區,,,21564,3094,6473,9567,608,10175
公投第１４案,臺南市,左鎮區,,,4418,447,1308,1755,231,1986
公投第１４案,臺南市,新市區,,,30386,4981,10371,15352,957,16309
公投第１４案,臺南市,安南區,,,159654,26267,52189,78456,5141,83597
公投第１４案,臺南市,龍崎區,,,3713,483,1180,1663,151,1814
公投第１４案,臺南市,北區,,,110906,19963,37147,57110,2775,59885
公投第１４案,臺南市,白河區,,,24894,3182,6671,9853,901,10754
公投第１４案,臺南市,山上區,,,6511,852,1766,2618,255,2873
公投第１４案,臺南市,鹽水區,,,22121,3142,6633,9775,858,10633
公投第１４案,臺南市,北門區,,,9925,1237,2600,3837,258,4095
公投第１４案,臺南市,後壁區,,,20841,2733,5938,8671,964,9635
公投第１４案,臺南市,善化區,,,39950,6753,12468,19221,1254,20475
公投第１４案,臺南市,下營區,,,20947,2968,6079,9047,811,9858
公投第１４案,臺南市,將軍區,,,17754,2193,5225,7418,517,7935
公投第１４案,臺南市,新化區,,,37296,5988,12714,18702,1443,20145
公投第１４案,臺南市,麻豆區,,,37963,6054,11606,17660,991,18651
公投第１４案,臺南市,柳營區,,,18804,2607,5834,8441,866,9307
公投第１４案,臺南市,七股區,,,19950,2603,5898,8501,631,9132
公投第１４案,臺南市,永康區,,,195001,32872,63632,96504,4864,101368
公投第１４案,臺南市,玉井區,,,12357,1543,4001,5544,469,6013
公投第１４案,臺南市,楠西區,,,8528,892,2621,3513,334,3847
公投第１４案,臺南市,南化區,,,7786,974,2417,3391,327,3718
公投第１４案,臺南市,安定區,,,26104,4048,8901,12949,1132,14081
公投第１４案,臺南市,南區,,,108650,17491,35260,52751,3296,56047
公投第１４案,臺南市,仁德區,,,64632,10442,22130,32572,1886,34458
公投第１４案,臺南市,東區,,,153359,27901,52576,80477,3521,83998
公投第１４案,臺南市,關廟區,,,29913,4616,10284,14900,1039,15939
公投第１４案,臺南市,中西區,,,65261,12063,22317,34380,1921,36301
公投第１４案,臺南市,安平區,,,55379,9422,17626,27048,1183,28231
公投第１４案,臺南市,六甲區,,,19144,2846,5630,8476,805,9281
公投第１４案,臺南市,大內區,,,8654,1076,2658,3734,419,4153
公投第１４案,臺南市,官田區,,,18675,3074,5324,8398,692,9090
公投第１４案,桃園市,觀音區,,,55149,8076,18134,26210,1669,27879
公投第１４案,桃園市,龍潭區,,,101574,14882,36956,51838,2571,54409
公投第１４案,桃園市,中壢區,,,334402,53274,115313,168587,7636,176223
公投第１４案,桃園市,桃園區,,,359790,60327,114427,174754,7782,182536
公投第１４案,桃園市,平鎮區,,,183560,29045,64386,93431,4155,97586
公投第１４案,桃園市,八德區,,,165065,25238,53665,78903,4498,83401
公投第１４案,桃園市,蘆竹區,,,129252,20705,41836,62541,3072,65613
公投第１４案,桃園市,龜山區,,,131702,21039,40715,61754,3114,64868
公投第１４案,桃園市,大園區,,,73900,11241,23944,35185,1753,36938
公投第１４案,桃園市,復興區,,,9766,967,4060,5027,291,5318
公投第１４案,桃園市,大溪區,,,78285,11844,26711,38555,2818,41373
公投第１４案,桃園市,楊梅區,,,137917,19418,47700,67118,3315,70433
公投第１４案,桃園市,新屋區,,,41461,6086,15647,21733,1409,23142
公投第１４案,連江縣,南竿鄉,介壽村,1,1967,274,712,986,28,1014
公投第１４案,連江縣,南竿鄉,福沃村、復興村,2,1837,208,637,845,38,883
公投第１４案,連江縣,南竿鄉,清水村、珠螺村,3,1114,151,418,569,18,587
公投第１４案,連江縣,南竿鄉,馬祖村、津沙村、四維村、仁愛村,4,1543,157,630,787,17,804
公投第１４案,連江縣,北竿鄉,后沃村、橋仔村、塘岐村,5,1515,178,606,784,29,813
公投第１４案,連江縣,北竿鄉,坂里村、白沙村、芹壁村,6,610,69,223,292,5,297
公投第１４案,連江縣,莒光鄉,田沃村、西坵村、青帆村,7,698,84,247,331,11,342
公投第１４案,連江縣,莒光鄉,大坪村、福正村,8,783,101,325,426,16,442
公投第１４案,連江縣,東引鄉,樂華村、中柳村,9,1138,271,285,556,21,577
公投第１４案,金門縣,金城鎮,東門里,1,1396,110,373,483,25,508
公投第１４案,金門縣,金城鎮,東門里,2,1831,158,519,677,20,697
公投第１４案,金門縣,金城鎮,東門里,3,1750,134,468,602,40,642
公投第１４案,金門縣,金城鎮,南門里,4,1889,157,508,665,52,717
公投第１４案,金門縣,金城鎮,南門里,5,1675,146,364,510,26,536
公投第１４案,金門縣,金城鎮,南門里,6,1901,160,591,751,29,780
公投第１４案,金門縣,金城鎮,西門里,7,1610,135,384,519,38,557
公投第１４案,金門縣,金城鎮,西門里,8,1687,129,451,580,22,602
公投第１４案,金門縣,金城鎮,西門里,9,1594,115,443,558,23,581
公投第１４案,金門縣,金城鎮,西門里,10,1726,126,465,591,23,614
公投第１４案,金門縣,金城鎮,西門里,11,1733,466,145,611,20,631
公投第１４案,金門縣,金城鎮,西門里,12,1532,127,477,604,20,624
公投第１４案,金門縣,金城鎮,北門里,13,2079,171,504,675,46,721
公投第１４案,金門縣,金城鎮,北門里,14,2033,162,461,623,30,653
公投第１４案,金門縣,金城鎮,賢庵里,15,2517,206,638,844,38,882
公投第１４案,金門縣,金城鎮,賢庵里,16,2083,144,541,685,44,729
公投第１４案,金門縣,金城鎮,金水里,17,2140,141,557,698,33,731
公投第１４案,金門縣,金城鎮,古城里,18,2435,157,521,678,42,720
公投第１４案,金門縣,金城鎮,古城里,19,1353,72,255,327,18,345
公投第１４案,金門縣,金城鎮,珠沙里,20,1574,94,381,475,16,491
公投第１４案,金門縣,金城鎮,珠沙里,21,1277,106,324,430,48,478
公投第１４案,金門縣,金寧鄉,古寧村,22,1735,87,394,481,60,541
公投第１４案,金門縣,金寧鄉,古寧村,23,1537,100,356,456,30,486
公投第１４案,金門縣,金寧鄉,安美村,24,1766,179,380,559,33,592
公投第１４案,金門縣,金寧鄉,安美村,25,1015,88,270,358,17,375
公投第１４案,金門縣,金寧鄉,安美村,26,1726,119,467,586,29,615
公投第１４案,金門縣,金寧鄉,湖埔村,27,1691,107,407,514,24,538
公投第１４案,金門縣,金寧鄉,湖埔村,28,2044,531,316,847,19,866
公投第１４案,金門縣,金寧鄉,湖埔村,29,1848,174,568,742,22,764
公投第１４案,金門縣,金寧鄉,湖埔村,30,1735,143,456,599,15,614
公投第１４案,金門縣,金寧鄉,榜林村,31,1795,152,447,599,28,627
公投第１４案,金門縣,金寧鄉,榜林村,32,1834,97,445,542,38,580
公投第１４案,金門縣,金寧鄉,榜林村,33,1528,125,361,486,28,514
公投第１４案,金門縣,金寧鄉,盤山村,34,1473,108,441,549,19,568
公投第１４案,金門縣,金寧鄉,盤山村,35,1679,127,446,573,29,602
公投第１４案,金門縣,金寧鄉,盤山村,36,1921,663,256,919,14,933
公投第１４案,金門縣,金寧鄉,盤山村,37,1298,121,334,455,13,468
公投第１４案,金門縣,金寧鄉,后盤村,38,1537,105,381,486,20,506
公投第１４案,金門縣,烈嶼鄉,林湖村,39,1647,137,560,697,25,722
公投第１４案,金門縣,烈嶼鄉,林湖村,40,1733,118,473,591,26,617
公投第１４案,金門縣,烈嶼鄉,黃埔村,41,1635,132,451,583,24,607
公投第１４案,金門縣,烈嶼鄉,西口村,42,1296,91,328,419,21,440
公投第１４案,金門縣,烈嶼鄉,西口村,43,1099,49,282,331,25,356
公投第１４案,金門縣,烈嶼鄉,上林村,44,1425,104,353,457,28,485
公投第１４案,金門縣,烈嶼鄉,上岐村,45,1412,91,418,509,16,525
公投第１４案,金門縣,烈嶼鄉,上岐村,46,1429,101,378,479,28,507
公投第１４案,金門縣,烏坵鄉,大坵村,47,275,20,56,76,2,78
公投第１４案,金門縣,烏坵鄉,小坵村,48,292,17,68,85,2,87
公投第１４案,金門縣,金湖鎮,新市里,49,1348,150,360,510,30,540
公投第１４案,金門縣,金湖鎮,新市里,50,1386,118,343,461,27,488
公投第１４案,金門縣,金湖鎮,新市里,51,1403,123,455,578,27,605
公投第１４案,金門縣,金湖鎮,山外里,52,1771,157,490,647,27,674
公投第１４案,金門縣,金湖鎮,山外里,53,1493,142,379,521,35,556
公投第１４案,金門縣,金湖鎮,溪湖里,54,1510,103,394,497,39,536
公投第１４案,金門縣,金湖鎮,蓮庵里,55,1607,107,465,572,37,609
公投第１４案,金門縣,金湖鎮,料羅里,56,2006,131,507,638,36,674
公投第１４案,金門縣,金湖鎮,新湖里,57,1780,189,436,625,18,643
公投第１４案,金門縣,金湖鎮,新湖里,58,1739,153,466,619,16,635
公投第１４案,金門縣,金湖鎮,新湖里,59,1384,106,353,459,20,479
公投第１４案,金門縣,金湖鎮,新湖里,60,1400,127,380,507,21,528
公投第１４案,金門縣,金湖鎮,新湖里,61,1325,132,437,569,18,587
公投第１４案,金門縣,金湖鎮,正義里,62,1236,95,300,395,19,414
公投第１４案,金門縣,金湖鎮,正義里,63,1382,108,342,450,30,480
公投第１４案,金門縣,金湖鎮,瓊林里,64,1631,96,450,546,14,560
公投第１４案,金門縣,金湖鎮,瓊林里,65,1514,84,371,455,38,493
公投第１４案,金門縣,金沙鎮,汶沙里,66,1909,125,498,623,37,660
公投第１４案,金門縣,金沙鎮,汶沙里,67,1524,111,470,581,44,625
公投第１４案,金門縣,金沙鎮,汶沙里,68,1673,90,430,520,27,547
公投第１４案,金門縣,金沙鎮,何斗里,69,2003,93,525,618,42,660
公投第１４案,金門縣,金沙鎮,浦山里,70,1212,98,381,479,15,494
公投第１４案,金門縣,金沙鎮,浦山里,71,1126,74,312,386,23,409
公投第１４案,金門縣,金沙鎮,西園里,72,1540,103,353,456,23,479
公投第１４案,金門縣,金沙鎮,官嶼里,73,1216,74,287,361,17,378
公投第１４案,金門縣,金沙鎮,官嶼里,74,950,39,206,245,14,259
公投第１４案,金門縣,金沙鎮,三山里,75,1895,108,564,672,29,701
公投第１４案,金門縣,金沙鎮,大洋里,76,1135,109,327,436,27,463
公投第１４案,金門縣,金沙鎮,光前里,77,1252,90,327,417,21,438
公投第１４案,金門縣,金沙鎮,光前里,78,1125,77,369,446,17,463
公投第１４案,宜蘭縣,宜蘭市,民族里,1,982,161,360,521,16,537
公投第１４案,宜蘭縣,宜蘭市,民族里,2,1270,197,453,650,52,702
公投第１４案,宜蘭縣,宜蘭市,建軍里,3,849,170,283,453,17,470
公投第１４案,宜蘭縣,宜蘭市,建軍里,4,756,137,280,417,20,437
公投第１４案,宜蘭縣,宜蘭市,泰山里,5,1107,163,368,531,29,560
公投第１４案,宜蘭縣,宜蘭市,泰山里,6,893,130,324,454,43,497
公投第１４案,宜蘭縣,宜蘭市,負郭里,7,912,169,310,479,26,505
公投第１４案,宜蘭縣,宜蘭市,負郭里,8,1335,248,467,715,37,752
公投第１４案,宜蘭縣,宜蘭市,負郭里,9,686,102,245,347,20,367
公投第１４案,宜蘭縣,宜蘭市,思源里,10,1366,275,524,799,27,826
公投第１４案,宜蘭縣,宜蘭市,思源里,11,1363,307,442,749,27,776
公投第１４案,宜蘭縣,宜蘭市,思源里,12,1540,299,553,852,36,888
公投第１４案,宜蘭縣,宜蘭市,七結里,13,1341,239,490,729,17,746
公投第１４案,宜蘭縣,宜蘭市,七結里,14,1209,209,433,642,43,685
公投第１４案,宜蘭縣,宜蘭市,文化里,15,900,164,308,472,40,512
公投第１４案,宜蘭縣,宜蘭市,文化里,16,980,163,323,486,26,512
公投第１４案,宜蘭縣,宜蘭市,文化里,17,1165,242,375,617,33,650
公投第１４案,宜蘭縣,宜蘭市,復興里,18,904,146,338,484,22,506
公投第１４案,宜蘭縣,宜蘭市,復興里,19,813,139,304,443,23,466
公投第１４案,宜蘭縣,宜蘭市,復興里,20,978,159,358,517,26,543
公投第１４案,宜蘭縣,宜蘭市,民權里,21,1282,178,382,560,21,581
公投第１４案,宜蘭縣,宜蘭市,民權里,22,465,89,174,263,13,276
公投第１４案,宜蘭縣,宜蘭市,神農里,23,669,114,254,368,30,398
公投第１４案,宜蘭縣,宜蘭市,神農里,24,923,151,356,507,20,527
公投第１４案,宜蘭縣,宜蘭市,神農里,25,1006,169,344,513,23,536
公投第１４案,宜蘭縣,宜蘭市,大新里,26,762,159,306,465,35,500
公投第１４案,宜蘭縣,宜蘭市,新民里,27,727,141,297,438,29,467
公投第１４案,宜蘭縣,宜蘭市,新民里,28,833,172,328,500,53,553
公投第１４案,宜蘭縣,宜蘭市,進士里,29,1143,213,406,619,32,651
公投第１４案,宜蘭縣,宜蘭市,進士里,30,979,180,346,526,17,543
公投第１４案,宜蘭縣,宜蘭市,南橋里,31,1214,196,442,638,44,682
公投第１４案,宜蘭縣,宜蘭市,凱旋里,32,1283,220,468,688,51,739
公投第１４案,宜蘭縣,宜蘭市,南津里,33,946,171,352,523,28,551
公投第１４案,宜蘭縣,宜蘭市,南津里,34,1090,175,375,550,35,585
公投第１４案,宜蘭縣,宜蘭市,建業里,35,943,210,335,545,18,563
公投第１４案,宜蘭縣,宜蘭市,建業里,36,774,208,260,468,28,496
公投第１４案,宜蘭縣,宜蘭市,擺厘里,37,968,207,352,559,32,591
公投第１４案,宜蘭縣,宜蘭市,擺厘里,38,926,206,348,554,18,572
公投第１４案,宜蘭縣,宜蘭市,擺厘里,39,1019,211,368,579,33,612
公投第１４案,宜蘭縣,宜蘭市,延平里,40,1084,184,392,576,41,617
公投第１４案,宜蘭縣,宜蘭市,延平里,41,1095,204,367,571,24,595
公投第１４案,宜蘭縣,宜蘭市,延平里,42,1083,224,377,601,21,622
公投第１４案,宜蘭縣,宜蘭市,成功里,43,1108,191,377,568,24,592
公投第１４案,宜蘭縣,宜蘭市,成功里,44,848,172,311,483,10,493
公投第１４案,宜蘭縣,宜蘭市,成功里,45,1095,209,370,579,25,604
公投第１４案,宜蘭縣,宜蘭市,東村里,46,1110,200,402,602,27,629
公投第１４案,宜蘭縣,宜蘭市,東村里,47,1104,195,416,611,35,646
公投第１４案,宜蘭縣,宜蘭市,新東里,48,1134,199,416,615,33,648
公投第１４案,宜蘭縣,宜蘭市,新東里,49,1146,208,428,636,25,661
公投第１４案,宜蘭縣,宜蘭市,新東里,50,876,165,324,489,44,533
公投第１４案,宜蘭縣,宜蘭市,黎明里,51,905,133,329,462,45,507
公投第１４案,宜蘭縣,宜蘭市,黎明里,52,910,173,326,499,35,534
公投第１４案,宜蘭縣,宜蘭市,七張里,53,1434,229,445,674,30,704
公投第１４案,宜蘭縣,宜蘭市,孝廉里,54,1152,211,379,590,47,637
公投第１４案,宜蘭縣,宜蘭市,東門里,55,966,204,344,548,30,578
公投第１４案,宜蘭縣,宜蘭市,小東里,56,711,140,253,393,24,417
公投第１４案,宜蘭縣,宜蘭市,小東里,57,884,189,311,500,36,536
公投第１４案,宜蘭縣,宜蘭市,菜園里,58,1326,225,500,725,41,766
公投第１４案,宜蘭縣,宜蘭市,慈安里,59,909,161,289,450,24,474
公投第１４案,宜蘭縣,宜蘭市,慈安里,60,894,158,305,463,29,492
公投第１４案,宜蘭縣,宜蘭市,中興里,61,1259,200,404,604,35,639
公投第１４案,宜蘭縣,宜蘭市,中興里,62,789,125,275,400,17,417
公投第１４案,宜蘭縣,宜蘭市,中興里,63,867,146,310,456,28,484
公投第１４案,宜蘭縣,宜蘭市,新生里,64,1454,238,501,739,71,810
公投第１４案,宜蘭縣,宜蘭市,新生里,65,1130,190,478,668,22,690
公投第１４案,宜蘭縣,宜蘭市,茭白里,66,1087,151,351,502,16,518
公投第１４案,宜蘭縣,宜蘭市,茭白里,67,938,161,365,526,52,578
公投第１４案,宜蘭縣,宜蘭市,北津里,68,1285,232,443,675,45,720
公投第１４案,宜蘭縣,宜蘭市,北津里,69,952,175,308,483,25,508
公投第１４案,宜蘭縣,宜蘭市,梅洲里,70,948,163,362,525,47,572
公投第１４案,宜蘭縣,宜蘭市,梅洲里,71,1160,201,367,568,44,612
公投第１４案,宜蘭縣,宜蘭市,梅洲里,72,1015,163,391,554,50,604
公投第１４案,宜蘭縣,宜蘭市,南門里,73,424,91,157,248,13,261
公投第１４案,宜蘭縣,宜蘭市,南門里,74,964,170,361,531,38,569
公投第１４案,宜蘭縣,宜蘭市,中山里,75,959,163,306,469,47,516
公投第１４案,宜蘭縣,宜蘭市,西門里,76,814,140,329,469,42,511
公投第１４案,宜蘭縣,宜蘭市,西門里,77,885,143,350,493,33,526
公投第１４案,宜蘭縣,宜蘭市,北門里,78,1162,226,360,586,58,644
公投第１４案,宜蘭縣,羅東鎮,開明里,79,689,143,235,378,30,408
公投第１４案,宜蘭縣,羅東鎮,開明里,80,718,118,255,373,27,400
公投第１４案,宜蘭縣,羅東鎮,大新里,81,1475,257,497,754,65,819
公投第１４案,宜蘭縣,羅東鎮,東安里,82,1466,271,466,737,61,798
公投第１４案,宜蘭縣,羅東鎮,東安里,83,1075,189,391,580,24,604
公投第１４案,宜蘭縣,羅東鎮,東安里,84,963,174,330,504,33,537
公投第１４案,宜蘭縣,羅東鎮,新群里,85,1511,251,482,733,82,815
公投第１４案,宜蘭縣,羅東鎮,新群里,86,1166,196,409,605,28,633
公投第１４案,宜蘭縣,羅東鎮,羅莊里,87,1273,241,441,682,54,736
公投第１４案,宜蘭縣,羅東鎮,羅莊里,88,1735,320,567,887,29,916
公投第１４案,宜蘭縣,羅東鎮,南昌里,89,1487,261,551,812,37,849
公投第１４案,宜蘭縣,羅東鎮,南昌里,90,837,178,286,464,40,504
公投第１４案,宜蘭縣,羅東鎮,南豪里,91,1312,249,484,733,53,786
公投第１４案,宜蘭縣,羅東鎮,成功里,92,1502,239,505,744,37,781
公投第１４案,宜蘭縣,羅東鎮,仁德里,93,1138,212,367,579,25,604
公投第１４案,宜蘭縣,羅東鎮,仁和里,94,1010,183,332,515,47,562
公投第１４案,宜蘭縣,羅東鎮,中山里,95,1373,232,487,719,74,793
公投第１４案,宜蘭縣,羅東鎮,漢民里,96,1089,209,377,586,31,617
公投第１４案,宜蘭縣,羅東鎮,漢民里,97,1304,218,454,672,38,710
公投第１４案,宜蘭縣,羅東鎮,漢民里,98,1288,226,415,641,55,696
公投第１４案,宜蘭縣,羅東鎮,維揚里,99,1036,211,378,589,53,642
公投第１４案,宜蘭縣,羅東鎮,維揚里,100,969,190,388,578,40,618
公投第１４案,宜蘭縣,羅東鎮,維揚里,101,985,193,356,549,41,590
公投第１４案,宜蘭縣,羅東鎮,西安里,102,1420,255,514,769,67,836
公投第１４案,宜蘭縣,羅東鎮,西安里,103,1430,253,526,779,40,819
公投第１４案,宜蘭縣,羅東鎮,北成里,104,1075,197,371,568,62,630
公投第１４案,宜蘭縣,羅東鎮,北成里,105,879,189,309,498,31,529
公投第１４案,宜蘭縣,羅東鎮,北成里,106,850,173,289,462,14,476
公投第１４案,宜蘭縣,羅東鎮,國華里,107,1111,253,387,640,25,665
公投第１４案,宜蘭縣,羅東鎮,國華里,108,1139,230,455,685,29,714
公投第１４案,宜蘭縣,羅東鎮,國華里,109,1130,241,418,659,38,697
公投第１４案,宜蘭縣,羅東鎮,國華里,110,980,191,361,552,28,580
公投第１４案,宜蘭縣,羅東鎮,賢文里,111,1431,264,500,764,42,806
公投第１４案,宜蘭縣,羅東鎮,賢文里,112,1109,211,391,602,30,632
公投第１４案,宜蘭縣,羅東鎮,賢文里,113,1083,189,394,583,27,610
公投第１４案,宜蘭縣,羅東鎮,公正里,114,1404,266,500,766,48,814
公投第１４案,宜蘭縣,羅東鎮,公正里,115,1288,248,446,694,48,742
公投第１４案,宜蘭縣,羅東鎮,集祥里,116,1183,176,336,512,34,546
公投第１４案,宜蘭縣,羅東鎮,信義里,117,1105,202,421,623,36,659
公投第１４案,宜蘭縣,羅東鎮,信義里,118,987,202,369,571,34,605
公投第１４案,宜蘭縣,羅東鎮,信義里,119,773,147,293,440,34,474
公投第１４案,宜蘭縣,羅東鎮,樹林里,120,1366,293,540,833,34,867
公投第１４案,宜蘭縣,羅東鎮,樹林里,121,907,187,371,558,28,586
公投第１４案,宜蘭縣,羅東鎮,樹林里,122,1158,216,467,683,36,719
公投第１４案,宜蘭縣,羅東鎮,竹林里,123,977,202,319,521,46,567
公投第１４案,宜蘭縣,羅東鎮,竹林里,124,972,176,311,487,45,532
公投第１４案,宜蘭縣,羅東鎮,竹林里,125,977,188,356,544,37,581
公投第１４案,宜蘭縣,羅東鎮,仁愛里,126,1398,274,505,779,46,825
公投第１４案,宜蘭縣,羅東鎮,仁愛里,127,1022,197,351,548,28,576
公投第１４案,宜蘭縣,羅東鎮,仁愛里,128,1131,196,465,661,33,694
公投第１４案,宜蘭縣,蘇澳鎮,龍德里,129,1194,202,415,617,56,673
公投第１４案,宜蘭縣,蘇澳鎮,龍德里,130,1128,182,387,569,39,608
公投第１４案,宜蘭縣,蘇澳鎮,龍德里,131,1042,236,364,600,44,644
公投第１４案,宜蘭縣,蘇澳鎮,頂寮里,132,997,224,332,556,32,588
公投第１４案,宜蘭縣,蘇澳鎮,永榮里,133,1303,234,441,675,59,734
公投第１４案,宜蘭縣,蘇澳鎮,永榮里,134,1260,240,448,688,59,747
公投第１４案,宜蘭縣,蘇澳鎮,永榮里,135,1130,185,376,561,54,615
公投第１４案,宜蘭縣,蘇澳鎮,存仁里,136,559,91,187,278,39,317
公投第１４案,宜蘭縣,蘇澳鎮,存仁里,137,351,56,111,167,20,187
公投第１４案,宜蘭縣,蘇澳鎮,港邊里,138,889,149,292,441,54,495
公投第１４案,宜蘭縣,蘇澳鎮,港邊里,139,434,74,152,226,17,243
公投第１４案,宜蘭縣,蘇澳鎮,隘丁里,140,835,151,329,480,26,506
公投第１４案,宜蘭縣,蘇澳鎮,隘丁里,141,975,185,333,518,42,560
公投第１４案,宜蘭縣,蘇澳鎮,隘丁里,142,1135,160,450,610,65,675
公投第１４案,宜蘭縣,蘇澳鎮,新城里,143,788,181,298,479,35,514
公投第１４案,宜蘭縣,蘇澳鎮,新城里,144,469,78,152,230,25,255
公投第１４案,宜蘭縣,蘇澳鎮,聖愛里,145,811,127,273,400,39,439
公投第１４案,宜蘭縣,蘇澳鎮,聖愛里,146,867,131,328,459,17,476
公投第１４案,宜蘭縣,蘇澳鎮,聖愛里,147,1139,187,412,599,44,643
公投第１４案,宜蘭縣,蘇澳鎮,聖湖里,148,1146,171,393,564,39,603
公投第１４案,宜蘭縣,蘇澳鎮,聖湖里,149,1154,177,425,602,49,651
公投第１４案,宜蘭縣,蘇澳鎮,蘇西里,150,908,157,283,440,17,457
公投第１４案,宜蘭縣,蘇澳鎮,蘇西里,151,656,92,243,335,28,363
公投第１４案,宜蘭縣,蘇澳鎮,蘇西里,152,834,158,328,486,37,523
公投第１４案,宜蘭縣,蘇澳鎮,蘇北里,153,1025,169,406,575,39,614
公投第１４案,宜蘭縣,蘇澳鎮,蘇南里,154,455,96,154,250,14,264
公投第１４案,宜蘭縣,蘇澳鎮,蘇東里,155,535,101,184,285,28,313
公投第１４案,宜蘭縣,蘇澳鎮,長安里,156,536,98,217,315,28,343
公投第１４案,宜蘭縣,蘇澳鎮,永光里,157,451,82,175,257,17,274
公投第１４案,宜蘭縣,蘇澳鎮,永春里,158,593,111,186,297,36,333
公投第１４案,宜蘭縣,蘇澳鎮,永樂里,159,441,64,170,234,22,256
公投第１４案,宜蘭縣,蘇澳鎮,南安里,160,954,140,370,510,47,557
公投第１４案,宜蘭縣,蘇澳鎮,南正里,161,952,149,330,479,39,518
公投第１４案,宜蘭縣,蘇澳鎮,南成里,162,1125,160,357,517,75,592
公投第１４案,宜蘭縣,蘇澳鎮,南興里,163,763,108,257,365,65,430
公投第１４案,宜蘭縣,蘇澳鎮,南興里,164,706,125,166,291,31,322
公投第１４案,宜蘭縣,蘇澳鎮,南寧里,165,1068,131,326,457,62,519
公投第１４案,宜蘭縣,蘇澳鎮,南建里,166,666,106,236,342,46,388
公投第１４案,宜蘭縣,蘇澳鎮,南建里,167,574,82,186,268,61,329
公投第１４案,宜蘭縣,蘇澳鎮,東澳里,168,351,52,94,146,8,154
公投第１４案,宜蘭縣,蘇澳鎮,南強里,169,717,113,247,360,45,405
公投第１４案,宜蘭縣,蘇澳鎮,朝陽里,170,373,36,104,140,13,153
公投第１４案,宜蘭縣,蘇澳鎮,朝陽里,171,223,35,50,85,9,94
公投第１４案,宜蘭縣,頭城鎮,石城里,172,292,30,65,95,10,105
公投第１４案,宜蘭縣,頭城鎮,大里里,173,688,109,230,339,33,372
公投第１４案,宜蘭縣,頭城鎮,龜山里,174,688,108,252,360,36,396
公投第１４案,宜蘭縣,頭城鎮,大溪里,175,879,128,278,406,44,450
公投第１４案,宜蘭縣,頭城鎮,合興里,176,335,59,123,182,22,204
公投第１４案,宜蘭縣,頭城鎮,更新里,177,624,107,249,356,37,393
公投第１４案,宜蘭縣,頭城鎮,更新里,178,732,109,207,316,27,343
公投第１４案,宜蘭縣,頭城鎮,外澳里,179,892,136,253,389,31,420
公投第１４案,宜蘭縣,頭城鎮,港口里,180,690,110,170,280,33,313
公投第１４案,宜蘭縣,頭城鎮,武營里,181,842,136,292,428,24,452
公投第１４案,宜蘭縣,頭城鎮,武營里,182,736,134,243,377,34,411
公投第１４案,宜蘭縣,頭城鎮,大坑里,183,788,127,246,373,28,401
公投第１４案,宜蘭縣,頭城鎮,大坑里,184,560,91,178,269,16,285
公投第１４案,宜蘭縣,頭城鎮,城東里,185,712,132,259,391,33,424
公投第１４案,宜蘭縣,頭城鎮,城北里,186,502,94,207,301,21,322
公投第１４案,宜蘭縣,頭城鎮,城西里,187,569,116,217,333,26,359
公投第１４案,宜蘭縣,頭城鎮,城南里,188,633,99,232,331,30,361
公投第１４案,宜蘭縣,頭城鎮,竹安里,189,1132,172,322,494,41,535
公投第１４案,宜蘭縣,頭城鎮,竹安里,190,1035,146,315,461,35,496
公投第１４案,宜蘭縣,頭城鎮,新建里,191,847,148,317,465,39,504
公投第１４案,宜蘭縣,頭城鎮,新建里,192,1172,237,383,620,39,659
公投第１４案,宜蘭縣,頭城鎮,拔雅里,193,896,164,282,446,25,471
公投第１４案,宜蘭縣,頭城鎮,拔雅里,194,1075,198,407,605,19,624
公投第１４案,宜蘭縣,頭城鎮,福成里,195,931,158,330,488,58,546
公投第１４案,宜蘭縣,頭城鎮,金面里,196,1021,160,363,523,39,562
公投第１４案,宜蘭縣,頭城鎮,金面里,197,709,97,221,318,33,351
公投第１４案,宜蘭縣,頭城鎮,金盈里,198,689,102,301,403,39,442
公投第１４案,宜蘭縣,頭城鎮,頂埔里,199,615,112,245,357,28,385
公投第１４案,宜蘭縣,頭城鎮,頂埔里,200,759,117,260,377,38,415
公投第１４案,宜蘭縣,頭城鎮,下埔里,201,917,149,366,515,49,564
公投第１４案,宜蘭縣,頭城鎮,中崙里,202,1045,169,374,543,59,602
公投第１４案,宜蘭縣,頭城鎮,二城里,203,1130,190,392,582,52,634
公投第１４案,宜蘭縣,礁溪鄉,白雲村,204,1122,145,353,498,45,543
公投第１４案,宜蘭縣,礁溪鄉,白雲村,205,505,79,161,240,28,268
公投第１４案,宜蘭縣,礁溪鄉,玉石村,206,988,142,341,483,28,511
公投第１４案,宜蘭縣,礁溪鄉,玉石村,207,971,151,337,488,33,521
公投第１４案,宜蘭縣,礁溪鄉,德陽村,208,1246,188,399,587,33,620
公投第１４案,宜蘭縣,礁溪鄉,德陽村,209,1655,248,503,751,28,779
公投第１４案,宜蘭縣,礁溪鄉,德陽村,210,1132,157,322,479,31,510
公投第１４案,宜蘭縣,礁溪鄉,大忠村,211,783,144,274,418,24,442
公投第１４案,宜蘭縣,礁溪鄉,大忠村,212,928,156,323,479,19,498
公投第１４案,宜蘭縣,礁溪鄉,大忠村,213,848,116,306,422,34,456
公投第１４案,宜蘭縣,礁溪鄉,大義村,214,663,131,255,386,27,413
公投第１４案,宜蘭縣,礁溪鄉,六結村,215,608,99,223,322,17,339
公投第１４案,宜蘭縣,礁溪鄉,六結村,216,833,144,300,444,28,472
公投第１４案,宜蘭縣,礁溪鄉,二龍村,217,1233,198,377,575,14,589
公投第１４案,宜蘭縣,礁溪鄉,時潮村,218,854,198,246,444,36,480
公投第１４案,宜蘭縣,礁溪鄉,時潮村,219,575,104,203,307,17,324
公投第１４案,宜蘭縣,礁溪鄉,玉田村,220,835,138,294,432,37,469
公投第１４案,宜蘭縣,礁溪鄉,玉田村,221,1305,237,459,696,53,749
公投第１４案,宜蘭縣,礁溪鄉,三民村,222,830,146,277,423,39,462
公投第１４案,宜蘭縣,礁溪鄉,三民村,223,649,138,248,386,41,427
公投第１４案,宜蘭縣,礁溪鄉,三民村,224,923,119,291,410,50,460
公投第１４案,宜蘭縣,礁溪鄉,林美村,225,1177,153,353,506,39,545
公投第１４案,宜蘭縣,礁溪鄉,白鵝村,226,840,131,296,427,34,461
公投第１４案,宜蘭縣,礁溪鄉,玉光村,227,1051,185,372,557,32,589
公投第１４案,宜蘭縣,礁溪鄉,光武村,228,1339,200,431,631,34,665
公投第１４案,宜蘭縣,礁溪鄉,吳沙村,229,1194,182,479,661,48,709
公投第１４案,宜蘭縣,礁溪鄉,吳沙村,230,1314,217,489,706,68,774
公投第１４案,宜蘭縣,礁溪鄉,龍潭村,231,1125,228,383,611,28,639
公投第１４案,宜蘭縣,礁溪鄉,龍潭村,232,1207,233,427,660,60,720
公投第１４案,宜蘭縣,礁溪鄉,龍潭村,233,979,170,317,487,62,549
公投第１４案,宜蘭縣,礁溪鄉,匏崙村,234,954,171,361,532,52,584
公投第１４案,宜蘭縣,礁溪鄉,二結村,235,418,66,160,226,9,235
公投第１４案,宜蘭縣,壯圍鄉,吉祥村,236,1435,295,500,795,80,875
公投第１４案,宜蘭縣,壯圍鄉,吉祥村,237,1049,388,193,581,48,629
公投第１４案,宜蘭縣,壯圍鄉,古結村,238,1068,197,410,607,48,655
公投第１４案,宜蘭縣,壯圍鄉,美福村,239,868,137,281,418,82,500
公投第１４案,宜蘭縣,壯圍鄉,美福村,240,967,155,337,492,33,525
公投第１４案,宜蘭縣,壯圍鄉,新南村,241,940,185,331,516,58,574
公投第１４案,宜蘭縣,壯圍鄉,東港村,242,975,155,292,447,26,473
公投第１４案,宜蘭縣,壯圍鄉,復興村,243,797,136,306,442,58,500
公投第１４案,宜蘭縣,壯圍鄉,復興村,244,808,119,296,415,52,467
公投第１４案,宜蘭縣,壯圍鄉,過嶺村,245,911,183,287,470,75,545
公投第１４案,宜蘭縣,壯圍鄉,過嶺村,246,612,86,198,284,32,316
公投第１４案,宜蘭縣,壯圍鄉,永鎮村,247,790,139,319,458,46,504
公投第１４案,宜蘭縣,壯圍鄉,忠孝村,248,878,146,322,468,56,524
公投第１４案,宜蘭縣,壯圍鄉,忠孝村,249,723,154,285,439,37,476
公投第１４案,宜蘭縣,壯圍鄉,忠孝村,250,737,124,238,362,24,386
公投第１４案,宜蘭縣,壯圍鄉,古亭村,251,686,127,237,364,49,413
公投第１４案,宜蘭縣,壯圍鄉,古亭村,252,895,153,298,451,11,462
公投第１４案,宜蘭縣,壯圍鄉,功勞村,253,1237,212,477,689,67,756
公投第１４案,宜蘭縣,壯圍鄉,美城村,254,1134,206,385,591,60,651
公投第１４案,宜蘭縣,壯圍鄉,美城村,255,1107,189,377,566,48,614
公投第１４案,宜蘭縣,壯圍鄉,新社村,256,1057,181,401,582,41,623
公投第１４案,宜蘭縣,壯圍鄉,大福村,257,1051,159,345,504,37,541
公投第１４案,宜蘭縣,壯圍鄉,大福村,258,722,140,214,354,48,402
公投第１４案,宜蘭縣,員山鄉,員山村,259,1393,228,452,680,36,716
公投第１４案,宜蘭縣,員山鄉,員山村,260,895,180,263,443,21,464
公投第１４案,宜蘭縣,員山鄉,員山村,261,1231,319,275,594,52,646
公投第１４案,宜蘭縣,員山鄉,員山村,262,1098,170,373,543,22,565
公投第１４案,宜蘭縣,員山鄉,員山村,263,1031,167,339,506,31,537
公投第１４案,宜蘭縣,員山鄉,尚德村,264,1030,151,342,493,63,556
公投第１４案,宜蘭縣,員山鄉,尚德村,265,1168,164,352,516,39,555
公投第１４案,宜蘭縣,員山鄉,惠好村,266,809,126,292,418,44,462
公投第１４案,宜蘭縣,員山鄉,惠好村,267,778,142,272,414,34,448
公投第１４案,宜蘭縣,員山鄉,七賢村,268,1465,255,532,787,58,845
公投第１４案,宜蘭縣,員山鄉,深溝村,269,979,176,347,523,58,581
公投第１４案,宜蘭縣,員山鄉,深溝村,270,860,131,311,442,37,479
公投第１４案,宜蘭縣,員山鄉,蓁巷村,271,1205,164,377,541,59,600
公投第１４案,宜蘭縣,員山鄉,內城村,272,1082,187,361,548,63,611
公投第１４案,宜蘭縣,員山鄉,內城村,273,412,71,143,214,30,244
公投第１４案,宜蘭縣,員山鄉,中華村,274,403,56,117,173,19,192
公投第１４案,宜蘭縣,員山鄉,中華村,275,232,18,74,92,12,104
公投第１４案,宜蘭縣,員山鄉,永和村,276,944,166,305,471,41,512
公投第１４案,宜蘭縣,員山鄉,永和村,277,894,172,287,459,41,500
公投第１４案,宜蘭縣,員山鄉,頭分村,278,1356,200,510,710,49,759
公投第１４案,宜蘭縣,員山鄉,枕山村,279,780,123,287,410,44,454
公投第１４案,宜蘭縣,員山鄉,枕山村,280,932,175,351,526,61,587
公投第１４案,宜蘭縣,員山鄉,枕山村,281,583,93,170,263,38,301
公投第１４案,宜蘭縣,員山鄉,同樂村,282,900,122,322,444,54,498
公投第１４案,宜蘭縣,員山鄉,同樂村,283,747,117,259,376,29,405
公投第１４案,宜蘭縣,員山鄉,同樂村,284,788,127,256,383,48,431
公投第１４案,宜蘭縣,員山鄉,湖東村,285,884,145,274,419,34,453
公投第１４案,宜蘭縣,員山鄉,逸仙村,286,857,123,290,413,27,440
公投第１４案,宜蘭縣,員山鄉,湖北村,287,1016,177,313,490,28,518
公投第１４案,宜蘭縣,員山鄉,湖西村,288,690,91,191,282,27,309
公投第１４案,宜蘭縣,員山鄉,湖西村,289,689,124,184,308,57,365
公投第１４案,宜蘭縣,冬山鄉,珍珠村,290,807,165,270,435,51,486
公投第１４案,宜蘭縣,冬山鄉,珍珠村,291,817,179,283,462,16,478
公投第１４案,宜蘭縣,冬山鄉,補城村,292,1156,217,403,620,40,660
公投第１４案,宜蘭縣,冬山鄉,三奇村,293,892,134,316,450,34,484
公投第１４案,宜蘭縣,冬山鄉,大興村,294,897,154,329,483,45,528
公投第１４案,宜蘭縣,冬山鄉,東城村,295,1392,245,543,788,52,840
公投第１４案,宜蘭縣,冬山鄉,香和村,296,1471,351,453,804,35,839
公投第１４案,宜蘭縣,冬山鄉,香和村,297,1435,198,445,643,34,677
公投第１４案,宜蘭縣,冬山鄉,南興村,298,1519,242,500,742,39,781
公投第１４案,宜蘭縣,冬山鄉,南興村,299,1456,280,535,815,22,837
公投第１４案,宜蘭縣,冬山鄉,安平村,300,711,127,270,397,37,434
公投第１４案,宜蘭縣,冬山鄉,冬山村,301,694,117,267,384,20,404
公投第１４案,宜蘭縣,冬山鄉,太和村,302,1526,274,622,896,64,960
公投第１４案,宜蘭縣,冬山鄉,八寶村,303,884,141,318,459,33,492
公投第１４案,宜蘭縣,冬山鄉,丸山村,304,1465,250,420,670,58,728
公投第１４案,宜蘭縣,冬山鄉,中山村,305,488,78,178,256,22,278
公投第１４案,宜蘭縣,冬山鄉,順安村,306,1218,181,417,598,52,650
公投第１４案,宜蘭縣,冬山鄉,順安村,307,1291,198,414,612,49,661
公投第１４案,宜蘭縣,冬山鄉,順安村,308,1324,198,437,635,28,663
公投第１４案,宜蘭縣,冬山鄉,順安村,309,1160,160,376,536,37,573
公投第１４案,宜蘭縣,冬山鄉,永美村,310,1246,188,436,624,46,670
公投第１４案,宜蘭縣,冬山鄉,永美村,311,1754,297,563,860,40,900
公投第１４案,宜蘭縣,冬山鄉,武淵村,312,1217,195,408,603,44,647
公投第１４案,宜蘭縣,冬山鄉,群英村,313,1495,217,453,670,50,720
公投第１４案,宜蘭縣,冬山鄉,群英村,314,937,167,303,470,41,511
公投第１４案,宜蘭縣,冬山鄉,群英村,315,1101,187,347,534,33,567
公投第１４案,宜蘭縣,冬山鄉,群英村,316,1118,178,359,537,47,584
公投第１４案,宜蘭縣,冬山鄉,清溝村,317,1301,230,489,719,30,749
公投第１４案,宜蘭縣,冬山鄉,清溝村,318,1225,212,410,622,33,655
公投第１４案,宜蘭縣,冬山鄉,清溝村,319,1206,229,444,673,35,708
公投第１４案,宜蘭縣,冬山鄉,鹿埔村,320,1278,181,424,605,31,636
公投第１４案,宜蘭縣,冬山鄉,鹿埔村,321,1151,170,398,568,33,601
公投第１４案,宜蘭縣,冬山鄉,得安村,322,1094,141,359,500,37,537
公投第１４案,宜蘭縣,冬山鄉,廣興村,323,1247,242,425,667,37,704
公投第１４案,宜蘭縣,冬山鄉,廣興村,324,1247,181,412,593,37,630
公投第１４案,宜蘭縣,冬山鄉,廣安村,325,979,171,335,506,32,538
公投第１４案,宜蘭縣,冬山鄉,廣安村,326,698,128,277,405,16,421
公投第１４案,宜蘭縣,冬山鄉,柯林村,327,1726,289,583,872,37,909
公投第１４案,宜蘭縣,冬山鄉,大進村,328,782,107,226,333,18,351
公投第１４案,宜蘭縣,五結鄉,三興村,329,1076,158,335,493,50,543
公投第１４案,宜蘭縣,五結鄉,三興村,330,944,167,304,471,27,498
公投第１４案,宜蘭縣,五結鄉,二結村,331,836,144,316,460,20,480
公投第１４案,宜蘭縣,五結鄉,二結村,332,937,175,317,492,33,525
公投第１４案,宜蘭縣,五結鄉,鎮安村,333,1255,207,417,624,35,659
公投第１４案,宜蘭縣,五結鄉,鎮安村,334,1270,221,401,622,63,685
公投第１４案,宜蘭縣,五結鄉,上四村,335,801,106,274,380,25,405
公投第１４案,宜蘭縣,五結鄉,上四村,336,802,136,249,385,33,418
公投第１４案,宜蘭縣,五結鄉,中興村,337,1306,205,411,616,34,650
公投第１４案,宜蘭縣,五結鄉,四結村,338,1190,218,371,589,38,627
公投第１４案,宜蘭縣,五結鄉,四結村,339,1316,225,452,677,19,696
公投第１４案,宜蘭縣,五結鄉,福興村,340,965,171,343,514,23,537
公投第１４案,宜蘭縣,五結鄉,福興村,341,814,130,282,412,27,439
公投第１４案,宜蘭縣,五結鄉,五結村,342,1254,191,430,621,34,655
公投第１４案,宜蘭縣,五結鄉,五結村,343,1060,170,396,566,40,606
公投第１４案,宜蘭縣,五結鄉,五結村,344,1323,250,456,706,27,733
公投第１４案,宜蘭縣,五結鄉,協和村,345,1120,182,405,587,52,639
公投第１４案,宜蘭縣,五結鄉,協和村,346,893,146,316,462,20,482
公投第１４案,宜蘭縣,五結鄉,協和村,347,1220,208,398,606,38,644
公投第１４案,宜蘭縣,五結鄉,大吉村,348,924,162,347,509,27,536
公投第１４案,宜蘭縣,五結鄉,大吉村,349,933,168,350,518,45,563
公投第１４案,宜蘭縣,五結鄉,大吉村,350,986,152,346,498,30,528
公投第１４案,宜蘭縣,五結鄉,大吉村,351,748,127,243,370,38,408
公投第１４案,宜蘭縣,五結鄉,孝威村,352,1550,286,489,775,62,837
公投第１４案,宜蘭縣,五結鄉,錦眾村,353,629,91,247,338,27,365
公投第１４案,宜蘭縣,五結鄉,錦眾村,354,806,142,261,403,37,440
公投第１４案,宜蘭縣,五結鄉,利澤村,355,956,185,264,449,52,501
公投第１４案,宜蘭縣,五結鄉,利澤村,356,1066,150,380,530,37,567
公投第１４案,宜蘭縣,五結鄉,成興村,357,1513,234,458,692,58,750
公投第１４案,宜蘭縣,五結鄉,成興村,358,1566,232,540,772,53,825
公投第１４案,宜蘭縣,五結鄉,季新村,359,894,162,280,442,54,496
公投第１４案,宜蘭縣,五結鄉,季新村,360,1235,198,334,532,50,582
公投第１４案,宜蘭縣,五結鄉,季新村,361,704,106,249,355,44,399
公投第１４案,宜蘭縣,三星鄉,員山村,362,215,28,72,100,17,117
公投第１４案,宜蘭縣,三星鄉,天山村,363,523,74,137,211,29,240
公投第１４案,宜蘭縣,三星鄉,天福村,364,745,134,213,347,43,390
公投第１４案,宜蘭縣,三星鄉,萬德村,365,617,85,205,290,27,317
公投第１４案,宜蘭縣,三星鄉,貴林村,366,497,70,165,235,30,265
公投第１４案,宜蘭縣,三星鄉,萬富村,367,735,116,244,360,51,411
公投第１４案,宜蘭縣,三星鄉,雙賢村,368,583,87,204,291,35,326
公投第１４案,宜蘭縣,三星鄉,人和村,369,436,49,160,209,26,235
公投第１４案,宜蘭縣,三星鄉,義德村,370,1224,179,398,577,60,637
公投第１４案,宜蘭縣,三星鄉,集慶村,371,1151,190,305,495,61,556
公投第１４案,宜蘭縣,三星鄉,月眉村,372,870,135,317,452,30,482
公投第１４案,宜蘭縣,三星鄉,拱照村,373,1284,140,356,496,38,534
公投第１４案,宜蘭縣,三星鄉,行健村,374,897,157,330,487,44,531
公投第１４案,宜蘭縣,三星鄉,大隱村,375,1439,213,515,728,51,779
公投第１４案,宜蘭縣,三星鄉,大隱村,376,1445,226,455,681,55,736
公投第１４案,宜蘭縣,三星鄉,大隱村,377,1402,189,510,699,39,738
公投第１４案,宜蘭縣,三星鄉,大義村,378,1230,225,384,609,39,648
公投第１４案,宜蘭縣,三星鄉,尚武村,379,774,101,285,386,46,432
公投第１４案,宜蘭縣,三星鄉,大洲村,380,827,145,296,441,39,480
公投第１４案,宜蘭縣,三星鄉,大洲村,381,736,137,235,372,22,394
公投第１４案,宜蘭縣,三星鄉,尾塹村,382,1421,225,449,674,66,740
公投第１４案,宜蘭縣,大同鄉,寒溪村,383,893,108,292,400,43,443
公投第１４案,宜蘭縣,大同鄉,崙埤村,384,632,82,345,427,34,461
公投第１４案,宜蘭縣,大同鄉,松羅村,385,684,89,330,419,17,436
公投第１４案,宜蘭縣,大同鄉,復興村,386,264,43,112,155,20,175
公投第１４案,宜蘭縣,大同鄉,英士村,387,337,29,141,170,6,176
公投第１４案,宜蘭縣,大同鄉,樂水村,388,404,35,197,232,8,240
公投第１４案,宜蘭縣,大同鄉,太平村,389,55,4,21,25,2,27
公投第１４案,宜蘭縣,大同鄉,茂安村,390,199,24,115,139,15,154
公投第１４案,宜蘭縣,大同鄉,四季村,391,787,79,241,320,12,332
公投第１４案,宜蘭縣,大同鄉,南山村,392,680,63,347,410,35,445
公投第１４案,宜蘭縣,南澳鄉,東岳村,393,444,65,174,239,8,247
公投第１４案,宜蘭縣,南澳鄉,南澳村,394,1210,125,481,606,20,626
公投第１４案,宜蘭縣,南澳鄉,碧候村,395,962,72,514,586,61,647
公投第１４案,宜蘭縣,南澳鄉,金岳村,396,411,36,152,188,6,194
公投第１４案,宜蘭縣,南澳鄉,武塔村,397,447,56,232,288,21,309
公投第１４案,宜蘭縣,南澳鄉,金洋村,398,475,64,279,343,29,372
公投第１４案,宜蘭縣,南澳鄉,澳花村,399,695,68,319,387,30,417
公投第１４案,新竹縣,竹北市,鹿場里,1,1319,277,556,833,20,853
公投第１４案,新竹縣,竹北市,鹿場里,2,1321,298,490,788,18,806
公投第１４案,新竹縣,竹北市,鹿場里,3,1272,264,512,776,22,798
公投第１４案,新竹縣,竹北市,鹿場里,4,1467,290,539,829,20,849
公投第１４案,新竹縣,竹北市,鹿場里,5,1226,264,434,698,17,715
公投第１４案,新竹縣,竹北市,鹿場里,6,1412,303,488,791,15,806
公投第１４案,新竹縣,竹北市,鹿場里,7,1400,351,528,879,11,890
公投第１４案,新竹縣,竹北市,東平里,8,1415,367,483,850,28,878
公投第１４案,新竹縣,竹北市,東平里,9,1361,314,468,782,19,801
公投第１４案,新竹縣,竹北市,東平里,10,1515,389,439,828,13,841
公投第１４案,新竹縣,竹北市,東平里,11,1495,370,508,878,23,901
公投第１４案,新竹縣,竹北市,東平里,12,1417,458,364,822,20,842
公投第１４案,新竹縣,竹北市,東平里,13,1548,396,471,867,22,889
公投第１４案,新竹縣,竹北市,東平里,14,1434,382,402,784,14,798
公投第１４案,新竹縣,竹北市,中興里,15,1385,300,486,786,30,816
公投第１４案,新竹縣,竹北市,中興里,16,1247,311,478,789,7,796
公投第１４案,新竹縣,竹北市,中興里,17,1373,309,456,765,30,795
公投第１４案,新竹縣,竹北市,中興里,18,1345,367,478,845,15,860
公投第１４案,新竹縣,竹北市,中興里,19,1165,203,446,649,24,673
公投第１４案,新竹縣,竹北市,隘口里,20,1164,291,435,726,25,751
公投第１４案,新竹縣,竹北市,隘口里,21,1212,294,436,730,26,756
公投第１４案,新竹縣,竹北市,東海里,22,1507,199,545,744,17,761
公投第１４案,新竹縣,竹北市,東海里,23,1576,215,582,797,34,831
公投第１４案,新竹縣,竹北市,東興里,24,1464,295,507,802,26,828
公投第１４案,新竹縣,竹北市,東興里,25,1428,332,461,793,23,816
公投第１４案,新竹縣,竹北市,東興里,26,1442,370,342,712,18,730
公投第１４案,新竹縣,竹北市,東興里,27,1415,282,513,795,49,844
公投第１４案,新竹縣,竹北市,北興里,28,1666,351,468,819,13,832
公投第１４案,新竹縣,竹北市,北興里,29,1751,375,547,922,19,941
公投第１４案,新竹縣,竹北市,十興里,30,1196,270,456,726,14,740
公投第１４案,新竹縣,竹北市,十興里,31,1235,258,461,719,24,743
公投第１４案,新竹縣,竹北市,十興里,32,1204,260,412,672,14,686
公投第１４案,新竹縣,竹北市,十興里,33,1308,264,510,774,29,803
公投第１４案,新竹縣,竹北市,十興里,34,1233,271,431,702,15,717
公投第１４案,新竹縣,竹北市,興安里,35,1129,233,428,661,14,675
公投第１４案,新竹縣,竹北市,興安里,36,1069,227,414,641,19,660
公投第１４案,新竹縣,竹北市,興安里,37,1114,242,445,687,23,710
公投第１４案,新竹縣,竹北市,文化里,38,1103,239,429,668,24,692
公投第１４案,新竹縣,竹北市,文化里,39,1029,234,417,651,17,668
公投第１４案,新竹縣,竹北市,文化里,40,1133,258,451,709,19,728
公投第１４案,新竹縣,竹北市,斗崙里,41,1301,272,472,744,13,757
公投第１４案,新竹縣,竹北市,斗崙里,42,1798,408,609,1017,27,1044
公投第１４案,新竹縣,竹北市,斗崙里,43,1427,280,538,818,34,852
公投第１４案,新竹縣,竹北市,斗崙里,44,1462,305,577,882,28,910
公投第１４案,新竹縣,竹北市,中崙里,45,1342,278,553,831,14,845
公投第１４案,新竹縣,竹北市,中崙里,46,1480,421,453,874,25,899
公投第１４案,新竹縣,竹北市,中崙里,47,1645,346,560,906,24,930
公投第１４案,新竹縣,竹北市,中崙里,48,1256,262,517,779,25,804
公投第１４案,新竹縣,竹北市,北崙里,49,1181,242,454,696,26,722
公投第１４案,新竹縣,竹北市,北崙里,50,1329,236,601,837,23,860
公投第１４案,新竹縣,竹北市,北崙里,51,1228,240,531,771,25,796
公投第１４案,新竹縣,竹北市,新崙里,52,1552,340,512,852,24,876
公投第１４案,新竹縣,竹北市,新崙里,53,1480,260,611,871,21,892
公投第１４案,新竹縣,竹北市,新崙里,54,1487,266,538,804,14,818
公投第１４案,新竹縣,竹北市,新崙里,55,1470,239,536,775,33,808
公投第１４案,新竹縣,竹北市,竹北里,56,1477,228,537,765,23,788
公投第１４案,新竹縣,竹北市,竹北里,57,1611,325,616,941,40,981
公投第１４案,新竹縣,竹北市,竹北里,58,1555,290,579,869,39,908
公投第１４案,新竹縣,竹北市,竹北里,59,1468,251,520,771,31,802
公投第１４案,新竹縣,竹北市,竹仁里,60,1509,268,610,878,23,901
公投第１４案,新竹縣,竹北市,竹仁里,61,1602,260,602,862,28,890
公投第１４案,新竹縣,竹北市,竹仁里,62,1448,257,571,828,41,869
公投第１４案,新竹縣,竹北市,竹仁里,63,1318,233,536,769,30,799
公投第１４案,新竹縣,竹北市,竹仁里,64,1634,328,645,973,36,1009
公投第１４案,新竹縣,竹北市,竹仁里,65,1345,198,519,717,58,775
公投第１４案,新竹縣,竹北市,福德里,66,958,183,417,600,18,618
公投第１４案,新竹縣,竹北市,福德里,67,1112,194,482,676,29,705
公投第１４案,新竹縣,竹北市,福德里,68,1134,180,451,631,40,671
公投第１４案,新竹縣,竹北市,竹義里,69,1483,263,564,827,33,860
公投第１４案,新竹縣,竹北市,竹義里,70,1332,231,470,701,48,749
公投第１４案,新竹縣,竹北市,竹義里,71,1482,232,507,739,28,767
公投第１４案,新竹縣,竹北市,竹義里,72,1449,196,405,601,20,621
公投第１４案,新竹縣,竹北市,泰和里,73,1319,223,480,703,17,720
公投第１４案,新竹縣,竹北市,泰和里,74,1332,213,486,699,30,729
公投第１４案,新竹縣,竹北市,泰和里,75,1412,251,470,721,28,749
公投第１４案,新竹縣,竹北市,泰和里,76,1640,249,598,847,37,884
公投第１４案,新竹縣,竹北市,新社里,77,1323,228,522,750,31,781
公投第１４案,新竹縣,竹北市,新社里,78,1428,274,529,803,45,848
公投第１４案,新竹縣,竹北市,新社里,79,1533,263,594,857,35,892
公投第１４案,新竹縣,竹北市,新社里,80,1346,238,455,693,23,716
公投第１４案,新竹縣,竹北市,新社里,81,1219,163,472,635,34,669
公投第１４案,新竹縣,竹北市,新國里,82,1466,267,580,847,50,897
公投第１４案,新竹縣,竹北市,新國里,83,1147,223,377,600,32,632
公投第１４案,新竹縣,竹北市,新國里,84,1529,246,464,710,39,749
公投第１４案,新竹縣,竹北市,新國里,85,1522,242,601,843,36,879
公投第１４案,新竹縣,竹北市,聯興里,86,1383,224,555,779,52,831
公投第１４案,新竹縣,竹北市,聯興里,87,1569,278,597,875,38,913
公投第１４案,新竹縣,竹北市,聯興里,88,1506,242,547,789,18,807
公投第１４案,新竹縣,竹北市,麻園里,89,877,128,347,475,31,506
公投第１４案,新竹縣,竹北市,麻園里,90,1074,196,403,599,28,627
公投第１４案,新竹縣,竹北市,溪州里,91,1089,201,464,665,40,705
公投第１４案,新竹縣,竹北市,溪州里,92,1336,232,509,741,52,793
公投第１４案,新竹縣,竹北市,新庄里,93,1058,185,384,569,35,604
公投第１４案,新竹縣,竹北市,白地里,94,937,191,400,591,34,625
公投第１４案,新竹縣,竹北市,白地里,95,1206,186,460,646,43,689
公投第１４案,新竹縣,竹北市,新港里,96,1205,206,457,663,40,703
公投第１４案,新竹縣,竹北市,大眉里,97,1718,315,642,957,72,1029
公投第１４案,新竹縣,竹北市,大義里,98,917,143,340,483,44,527
公投第１４案,新竹縣,竹北市,大義里,99,668,123,257,380,24,404
公投第１４案,新竹縣,竹北市,尚義里,100,824,133,300,433,28,461
公投第１４案,新竹縣,竹北市,尚義里,101,782,244,163,407,58,465
公投第１４案,新竹縣,竹北市,崇義里,102,977,164,378,542,60,602
公投第１４案,新竹縣,竹北市,崇義里,103,937,137,326,463,19,482
公投第１４案,新竹縣,竹東鎮,上坪里,104,309,27,115,142,14,156
公投第１４案,新竹縣,竹東鎮,瑞峰里,105,416,62,130,192,23,215
公投第１４案,新竹縣,竹東鎮,軟橋里,106,386,54,137,191,7,198
公投第１４案,新竹縣,竹東鎮,員崠里,107,950,124,328,452,27,479
公投第１４案,新竹縣,竹東鎮,員崠里,108,1275,187,481,668,12,680
公投第１４案,新竹縣,竹東鎮,上舘里,109,1213,168,456,624,33,657
公投第１４案,新竹縣,竹東鎮,上舘里,110,1548,250,589,839,33,872
公投第１４案,新竹縣,竹東鎮,上舘里,111,1246,189,414,603,28,631
公投第１４案,新竹縣,竹東鎮,上舘里,112,1252,143,402,545,31,576
公投第１４案,新竹縣,竹東鎮,上舘里,113,1359,163,521,684,36,720
公投第１４案,新竹縣,竹東鎮,上舘里,114,1255,186,453,639,35,674
公投第１４案,新竹縣,竹東鎮,上舘里,115,1304,207,520,727,23,750
公投第１４案,新竹縣,竹東鎮,東寧里,116,1292,212,472,684,44,728
公投第１４案,新竹縣,竹東鎮,東寧里,117,1111,133,417,550,18,568
公投第１４案,新竹縣,竹東鎮,東寧里,118,880,127,355,482,43,525
公投第１４案,新竹縣,竹東鎮,中正里,119,670,114,261,375,19,394
公投第１４案,新竹縣,竹東鎮,中正里,120,1244,188,499,687,38,725
公投第１４案,新竹縣,竹東鎮,大鄉里,121,1126,144,422,566,45,611
公投第１４案,新竹縣,竹東鎮,大鄉里,122,1073,157,407,564,26,590
公投第１４案,新竹縣,竹東鎮,大鄉里,123,1215,194,475,669,26,695
公投第１４案,新竹縣,竹東鎮,大鄉里,124,1155,181,467,648,14,662
公投第１４案,新竹縣,竹東鎮,中山里,125,852,135,318,453,35,488
公投第１４案,新竹縣,竹東鎮,中山里,126,875,158,345,503,23,526
公投第１４案,新竹縣,竹東鎮,南華里,127,1070,144,476,620,32,652
公投第１４案,新竹縣,竹東鎮,東華里,128,704,121,247,368,21,389
公投第１４案,新竹縣,竹東鎮,商華里,129,951,81,274,355,27,382
公投第１４案,新竹縣,竹東鎮,商華里,130,984,187,356,543,18,561
公投第１４案,新竹縣,竹東鎮,商華里,131,1113,180,301,481,10,491
公投第１４案,新竹縣,竹東鎮,竹東里,132,595,84,253,337,20,357
公投第１４案,新竹縣,竹東鎮,竹東里,133,762,120,312,432,37,469
公投第１４案,新竹縣,竹東鎮,忠孝里,134,763,140,270,410,20,430
公投第１４案,新竹縣,竹東鎮,忠孝里,135,813,124,271,395,24,419
公投第１４案,新竹縣,竹東鎮,鷄林里,136,1310,158,466,624,20,644
公投第１４案,新竹縣,竹東鎮,鷄林里,137,1434,193,472,665,40,705
公投第１４案,新竹縣,竹東鎮,鷄林里,138,1131,190,424,614,23,637
公投第１４案,新竹縣,竹東鎮,仁愛里,139,967,161,352,513,19,532
公投第１４案,新竹縣,竹東鎮,仁愛里,140,1196,162,419,581,31,612
公投第１４案,新竹縣,竹東鎮,仁愛里,141,1154,179,448,627,27,654
公投第１４案,新竹縣,竹東鎮,榮樂里,142,715,126,277,403,36,439
公投第１４案,新竹縣,竹東鎮,榮樂里,143,685,108,281,389,12,401
公投第１４案,新竹縣,竹東鎮,榮華里,144,1352,210,470,680,39,719
公投第１４案,新竹縣,竹東鎮,榮華里,145,1407,206,565,771,35,806
公投第１４案,新竹縣,竹東鎮,榮華里,146,1362,194,532,726,21,747
公投第１４案,新竹縣,竹東鎮,榮華里,147,1330,204,533,737,27,764
公投第１４案,新竹縣,竹東鎮,榮華里,148,1441,221,519,740,42,782
公投第１４案,新竹縣,竹東鎮,五豐里,149,1248,208,426,634,12,646
公投第１４案,新竹縣,竹東鎮,五豐里,150,1263,204,348,552,18,570
公投第１４案,新竹縣,竹東鎮,五豐里,151,1232,161,430,591,25,616
公投第１４案,新竹縣,竹東鎮,五豐里,152,1143,151,368,519,25,544
公投第１４案,新竹縣,竹東鎮,五豐里,153,1529,249,561,810,26,836
公投第１４案,新竹縣,竹東鎮,五豐里,154,1140,183,421,604,24,628
公投第１４案,新竹縣,竹東鎮,陸豐里,155,570,99,244,343,23,366
公投第１４案,新竹縣,竹東鎮,三重里,156,1345,198,430,628,28,656
公投第１４案,新竹縣,竹東鎮,三重里,157,1381,251,436,687,48,735
公投第１４案,新竹縣,竹東鎮,三重里,158,1379,245,477,722,43,765
公投第１４案,新竹縣,竹東鎮,三重里,159,1033,168,397,565,40,605
公投第１４案,新竹縣,竹東鎮,三重里,160,1066,165,395,560,25,585
公投第１４案,新竹縣,竹東鎮,二重里,161,938,146,370,516,40,556
公投第１４案,新竹縣,竹東鎮,二重里,162,952,165,384,549,38,587
公投第１４案,新竹縣,竹東鎮,二重里,163,1468,285,554,839,44,883
公投第１４案,新竹縣,竹東鎮,二重里,164,1915,454,501,955,24,979
公投第１４案,新竹縣,竹東鎮,二重里,165,1220,186,409,595,43,638
公投第１４案,新竹縣,竹東鎮,二重里,166,1166,162,356,518,14,532
公投第１４案,新竹縣,竹東鎮,二重里,167,1492,208,507,715,20,735
公投第１４案,新竹縣,竹東鎮,二重里,168,1245,195,439,634,24,658
公投第１４案,新竹縣,竹東鎮,頭重里,169,1083,187,398,585,40,625
公投第１４案,新竹縣,竹東鎮,頭重里,170,1102,194,386,580,26,606
公投第１４案,新竹縣,竹東鎮,頭重里,171,1068,178,393,571,26,597
公投第１４案,新竹縣,竹東鎮,頭重里,172,1097,192,406,598,28,626
公投第１４案,新竹縣,竹東鎮,員山里,173,962,125,366,491,22,513
公投第１４案,新竹縣,竹東鎮,員山里,174,909,138,362,500,25,525
公投第１４案,新竹縣,竹東鎮,柯湖里,175,603,82,196,278,25,303
公投第１４案,新竹縣,新埔鎮,新埔里,176,983,151,415,566,22,588
公投第１４案,新竹縣,新埔鎮,新生里,177,597,137,210,347,22,369
公投第１４案,新竹縣,新埔鎮,新民里,178,1070,163,412,575,24,599
公投第１４案,新竹縣,新埔鎮,田新里,179,935,132,363,495,27,522
公投第１４案,新竹縣,新埔鎮,田新里,180,753,108,308,416,19,435
公投第１４案,新竹縣,新埔鎮,田新里,181,838,142,386,528,23,551
公投第１４案,新竹縣,新埔鎮,旱坑里,182,924,129,389,518,23,541
公投第１４案,新竹縣,新埔鎮,旱坑里,183,905,134,304,438,21,459
公投第１４案,新竹縣,新埔鎮,五埔里,184,948,128,385,513,25,538
公投第１４案,新竹縣,新埔鎮,五埔里,185,1017,133,418,551,45,596
公投第１４案,新竹縣,新埔鎮,四座里,186,1176,209,479,688,28,716
公投第１４案,新竹縣,新埔鎮,四座里,187,1122,195,465,660,39,699
公投第１４案,新竹縣,新埔鎮,四座里,188,1022,140,324,464,15,479
公投第１４案,新竹縣,新埔鎮,照門里,189,1429,189,487,676,37,713
公投第１４案,新竹縣,新埔鎮,清水里,190,451,68,204,272,33,305
公投第１４案,新竹縣,新埔鎮,鹿鳴里,191,724,109,279,388,25,413
公投第１４案,新竹縣,新埔鎮,新北里,192,617,79,287,366,28,394
公投第１４案,新竹縣,新埔鎮,巨埔里,193,1144,167,463,630,49,679
公投第１４案,新竹縣,新埔鎮,內立里,194,1139,162,459,621,38,659
公投第１４案,新竹縣,新埔鎮,寶石里,195,861,108,364,472,24,496
公投第１４案,新竹縣,新埔鎮,文山里,196,1093,147,386,533,24,557
公投第１４案,新竹縣,新埔鎮,文山里,197,978,131,349,480,27,507
公投第１４案,新竹縣,新埔鎮,文山里,198,1040,136,360,496,17,513
公投第１４案,新竹縣,新埔鎮,文山里,199,1160,184,405,589,32,621
公投第１４案,新竹縣,新埔鎮,上寮里,200,950,172,367,539,37,576
公投第１４案,新竹縣,新埔鎮,上寮里,201,882,117,357,474,25,499
公投第１４案,新竹縣,新埔鎮,下寮里,202,1281,226,468,694,46,740
公投第１４案,新竹縣,新埔鎮,下寮里,203,1212,187,427,614,37,651
公投第１４案,新竹縣,新埔鎮,南平里,204,1013,127,323,450,35,485
公投第１４案,新竹縣,新埔鎮,北平里,205,630,113,266,379,23,402
公投第１４案,新竹縣,關西鎮,東興里,206,480,64,229,293,16,309
公投第１４案,新竹縣,關西鎮,西安里,207,903,160,353,513,27,540
公投第１４案,新竹縣,關西鎮,西安里,208,1020,152,406,558,36,594
公投第１４案,新竹縣,關西鎮,南雄里,209,705,110,279,389,17,406
公投第１４案,新竹縣,關西鎮,北斗里,210,1056,136,419,555,26,581
公投第１４案,新竹縣,關西鎮,北斗里,211,1275,181,479,660,39,699
公投第１４案,新竹縣,關西鎮,北斗里,212,1287,195,524,719,47,766
公投第１４案,新竹縣,關西鎮,北山里,213,771,108,322,430,36,466
公投第１４案,新竹縣,關西鎮,仁安里,214,1046,250,276,526,47,573
公投第１４案,新竹縣,關西鎮,南山里,215,1030,148,414,562,41,603
公投第１４案,新竹縣,關西鎮,東安里,216,1208,184,469,653,31,684
公投第１４案,新竹縣,關西鎮,東安里,217,1095,135,382,517,15,532
公投第１４案,新竹縣,關西鎮,東安里,218,1350,190,474,664,48,712
公投第１４案,新竹縣,關西鎮,東山里,219,846,150,360,510,26,536
公投第１４案,新竹縣,關西鎮,東光里,220,1362,186,521,707,41,748
公投第１４案,新竹縣,關西鎮,南新里,221,903,92,337,429,25,454
公投第１４案,新竹縣,關西鎮,新富里,222,551,69,179,248,19,267
公投第１４案,新竹縣,關西鎮,玉山里,223,461,53,123,176,15,191
公投第１４案,新竹縣,關西鎮,金山里,224,572,69,223,292,27,319
公投第１４案,新竹縣,關西鎮,錦山里,225,943,94,382,476,30,506
公投第１４案,新竹縣,關西鎮,大同里,226,808,130,305,435,36,471
公投第１４案,新竹縣,關西鎮,石光里,227,923,148,412,560,23,583
公投第１４案,新竹縣,關西鎮,石光里,228,903,135,374,509,26,535
公投第１４案,新竹縣,關西鎮,東平里,229,977,132,424,556,23,579
公投第１４案,新竹縣,關西鎮,上林里,230,824,132,358,490,24,514
公投第１４案,新竹縣,關西鎮,新力里,231,559,80,268,348,14,362
公投第１４案,新竹縣,關西鎮,南和里,232,854,140,363,503,31,534
公投第１４案,新竹縣,湖口鄉,和興村,233,1393,205,487,692,31,723
公投第１４案,新竹縣,湖口鄉,和興村,234,1505,240,591,831,40,871
公投第１４案,新竹縣,湖口鄉,東興村,235,1188,206,530,736,29,765
公投第１４案,新竹縣,湖口鄉,東興村,236,1267,165,531,696,34,730
公投第１４案,新竹縣,湖口鄉,東興村,237,1668,253,658,911,41,952
公投第１４案,新竹縣,湖口鄉,德盛村,238,1719,280,669,949,48,997
公投第１４案,新竹縣,湖口鄉,德盛村,239,1162,191,486,677,39,716
公投第１４案,新竹縣,湖口鄉,德盛村,240,1833,227,673,900,42,942
公投第１４案,新竹縣,湖口鄉,愛勢村,241,1444,252,532,784,37,821
公投第１４案,新竹縣,湖口鄉,愛勢村,242,1347,216,578,794,41,835
公投第１４案,新竹縣,湖口鄉,愛勢村,243,1202,192,519,711,21,732
公投第１４案,新竹縣,湖口鄉,仁勢村,244,851,138,342,480,47,527
公投第１４案,新竹縣,湖口鄉,孝勢村,245,1272,218,521,739,35,774
公投第１４案,新竹縣,湖口鄉,中勢村,246,1275,187,515,702,37,739
公投第１４案,新竹縣,湖口鄉,中勢村,247,1560,250,669,919,50,969
公投第１４案,新竹縣,湖口鄉,中正村,248,1147,192,479,671,64,735
公投第１４案,新竹縣,湖口鄉,中正村,249,1729,240,703,943,37,980
公投第１４案,新竹縣,湖口鄉,信勢村,250,1402,239,473,712,43,755
公投第１４案,新竹縣,湖口鄉,信勢村,251,1183,183,484,667,40,707
公投第１４案,新竹縣,湖口鄉,信勢村,252,1282,245,400,645,33,678
公投第１４案,新竹縣,湖口鄉,信勢村,253,1335,224,540,764,39,803
公投第１４案,新竹縣,湖口鄉,信義村,254,1493,248,649,897,34,931
公投第１４案,新竹縣,湖口鄉,信義村,255,1877,255,733,988,23,1011
公投第１４案,新竹縣,湖口鄉,波羅村,256,1082,160,469,629,43,672
公投第１４案,新竹縣,湖口鄉,波羅村,257,1115,172,464,636,49,685
公投第１４案,新竹縣,湖口鄉,長嶺村,258,1193,166,422,588,31,619
公投第１４案,新竹縣,湖口鄉,長嶺村,259,1947,245,764,1009,38,1047
公投第１４案,新竹縣,湖口鄉,長安村,260,1125,165,452,617,56,673
公投第１４案,新竹縣,湖口鄉,湖口村,261,1050,140,438,578,34,612
公投第１４案,新竹縣,湖口鄉,湖口村,262,1733,283,681,964,38,1002
公投第１４案,新竹縣,湖口鄉,湖鏡村,263,1284,208,518,726,32,758
公投第１４案,新竹縣,湖口鄉,湖鏡村,264,1062,161,439,600,33,633
公投第１４案,新竹縣,湖口鄉,湖南村,265,1547,210,586,796,55,851
公投第１４案,新竹縣,湖口鄉,中興村,266,1494,202,516,718,33,751
公投第１４案,新竹縣,湖口鄉,中興村,267,1634,215,535,750,36,786
公投第１４案,新竹縣,湖口鄉,中興村,268,1444,207,449,656,26,682
公投第１４案,新竹縣,湖口鄉,中興村,269,1324,219,464,683,20,703
公投第１４案,新竹縣,湖口鄉,鳳凰村,270,1058,162,413,575,26,601
公投第１４案,新竹縣,湖口鄉,鳳凰村,271,1220,360,155,515,19,534
公投第１４案,新竹縣,湖口鄉,鳳凰村,272,1333,232,489,721,30,751
公投第１４案,新竹縣,湖口鄉,鳳凰村,273,1461,193,528,721,45,766
公投第１４案,新竹縣,湖口鄉,勝利村,274,1429,209,557,766,22,788
公投第１４案,新竹縣,湖口鄉,勝利村,275,1506,199,489,688,27,715
公投第１４案,新竹縣,湖口鄉,勝利村,276,1103,168,467,635,45,680
公投第１４案,新竹縣,湖口鄉,鳳山村,277,1495,200,507,707,35,742
公投第１４案,新竹縣,湖口鄉,鳳山村,278,752,101,299,400,34,434
公投第１４案,新竹縣,湖口鄉,鳳山村,279,986,144,380,524,20,544
公投第１４案,新竹縣,新豐鄉,福興村,280,1080,148,392,540,44,584
公投第１４案,新竹縣,新豐鄉,青埔村,281,887,131,314,445,23,468
公投第１４案,新竹縣,新豐鄉,青埔村,282,954,149,361,510,29,539
公投第１４案,新竹縣,新豐鄉,中崙村,283,1003,166,371,537,36,573
公投第１４案,新竹縣,新豐鄉,中崙村,284,1106,147,419,566,38,604
公投第１４案,新竹縣,新豐鄉,中崙村,285,1123,183,437,620,39,659
公投第１４案,新竹縣,新豐鄉,瑞興村,286,891,141,344,485,42,527
公投第１４案,新竹縣,新豐鄉,瑞興村,287,874,117,301,418,22,440
公投第１４案,新竹縣,新豐鄉,後湖村,288,824,132,299,431,30,461
公投第１４案,新竹縣,新豐鄉,後湖村,289,975,130,332,462,28,490
公投第１４案,新竹縣,新豐鄉,坡頭村,290,847,140,294,434,40,474
公投第１４案,新竹縣,新豐鄉,埔和村,291,1477,223,555,778,52,830
公投第１４案,新竹縣,新豐鄉,埔和村,292,1266,214,407,621,47,668
公投第１４案,新竹縣,新豐鄉,新豐村,293,1029,133,371,504,57,561
公投第１４案,新竹縣,新豐鄉,新豐村,294,1063,148,385,533,43,576
公投第１４案,新竹縣,新豐鄉,員山村,295,1055,160,412,572,16,588
公投第１４案,新竹縣,新豐鄉,員山村,296,1445,227,556,783,28,811
公投第１４案,新竹縣,新豐鄉,忠孝村,297,1413,261,585,846,22,868
公投第１４案,新竹縣,新豐鄉,忠孝村,298,971,179,421,600,20,620
公投第１４案,新竹縣,新豐鄉,忠孝村,299,1135,185,473,658,22,680
公投第１４案,新竹縣,新豐鄉,山崎村,300,1269,201,447,648,35,683
公投第１４案,新竹縣,新豐鄉,山崎村,301,1257,179,496,675,37,712
公投第１４案,新竹縣,新豐鄉,山崎村,302,1662,284,634,918,33,951
公投第１４案,新竹縣,新豐鄉,上坑村,303,1486,225,538,763,18,781
公投第１４案,新竹縣,新豐鄉,鳳坑村,304,1067,162,462,624,45,669
公投第１４案,新竹縣,新豐鄉,重興村,305,1302,207,551,758,30,788
公投第１４案,新竹縣,新豐鄉,重興村,306,1410,200,559,759,33,792
公投第１４案,新竹縣,新豐鄉,重興村,307,1267,189,477,666,28,694
公投第１４案,新竹縣,新豐鄉,重興村,308,1258,189,404,593,37,630
公投第１４案,新竹縣,新豐鄉,崎頂村,309,1217,180,415,595,17,612
公投第１４案,新竹縣,新豐鄉,崎頂村,310,1456,197,582,779,25,804
公投第１４案,新竹縣,新豐鄉,松林村,311,1157,189,465,654,25,679
公投第１４案,新竹縣,新豐鄉,松林村,312,1089,153,396,549,26,575
公投第１４案,新竹縣,新豐鄉,松林村,313,1160,188,466,654,8,662
公投第１４案,新竹縣,新豐鄉,松林村,314,976,168,429,597,16,613
公投第１４案,新竹縣,新豐鄉,松柏村,315,1443,245,535,780,33,813
公投第１４案,新竹縣,新豐鄉,松柏村,316,1247,188,428,616,22,638
公投第１４案,新竹縣,新豐鄉,松柏村,317,1411,230,546,776,16,792
公投第１４案,新竹縣,新豐鄉,松柏村,318,1238,204,495,699,37,736
公投第１４案,新竹縣,芎林鄉,華龍村,319,417,61,167,228,14,242
公投第１４案,新竹縣,芎林鄉,五龍村,320,534,99,263,362,19,381
公投第１４案,新竹縣,芎林鄉,秀湖村,321,963,163,377,540,25,565
公投第１４案,新竹縣,芎林鄉,永興村,322,418,83,170,253,17,270
公投第１４案,新竹縣,芎林鄉,石潭村,323,1312,174,509,683,39,722
公投第１４案,新竹縣,芎林鄉,石潭村,324,1354,207,444,651,31,682
公投第１４案,新竹縣,芎林鄉,新鳳村,325,785,143,301,444,31,475
公投第１４案,新竹縣,芎林鄉,新鳳村,326,797,112,321,433,56,489
公投第１４案,新竹縣,芎林鄉,中坑村,327,623,84,292,376,19,395
公投第１４案,新竹縣,芎林鄉,水坑村,328,759,108,297,405,37,442
公投第１４案,新竹縣,芎林鄉,文林村,329,1272,188,421,609,39,648
公投第１４案,新竹縣,芎林鄉,文林村,330,1129,168,479,647,26,673
公投第１４案,新竹縣,芎林鄉,芎林村,331,713,115,302,417,27,444
公投第１４案,新竹縣,芎林鄉,芎林村,332,839,148,345,493,31,524
公投第１４案,新竹縣,芎林鄉,上山村,333,1123,190,520,710,29,739
公投第１４案,新竹縣,芎林鄉,上山村,334,981,165,407,572,18,590
公投第１４案,新竹縣,芎林鄉,上山村,335,1078,232,386,618,41,659
公投第１４案,新竹縣,芎林鄉,上山村,336,1094,161,413,574,24,598
公投第１４案,新竹縣,芎林鄉,下山村,337,1102,166,441,607,48,655
公投第１４案,新竹縣,橫山鄉,橫山村,338,1231,197,506,703,48,751
公投第１４案,新竹縣,橫山鄉,橫山村,339,1041,157,425,582,47,629
公投第１４案,新竹縣,橫山鄉,橫山村,340,1132,158,494,652,35,687
公投第１４案,新竹縣,橫山鄉,田寮村,341,859,132,346,478,41,519
公投第１４案,新竹縣,橫山鄉,南昌村,342,204,18,83,101,16,117
公投第１４案,新竹縣,橫山鄉,豐鄉村,343,222,24,68,92,9,101
公投第１４案,新竹縣,橫山鄉,豐田村,344,338,52,129,181,37,218
公投第１４案,新竹縣,橫山鄉,內灣村,345,916,110,363,473,19,492
公投第１４案,新竹縣,橫山鄉,力行村,346,573,64,159,223,17,240
公投第１４案,新竹縣,橫山鄉,力行村,347,275,48,131,179,10,189
公投第１４案,新竹縣,橫山鄉,福興村,348,463,56,161,217,14,231
公投第１４案,新竹縣,橫山鄉,沙坑村,349,690,98,296,394,48,442
公投第１４案,新竹縣,橫山鄉,沙坑村,350,288,37,102,139,10,149
公投第１４案,新竹縣,橫山鄉,新興村,351,685,119,289,408,33,441
公投第１４案,新竹縣,橫山鄉,新興村,352,868,135,369,504,34,538
公投第１４案,新竹縣,橫山鄉,大肚村,353,1561,219,687,906,61,967
公投第１４案,新竹縣,北埔鄉,北埔村,354,1158,182,406,588,17,605
公投第１４案,新竹縣,北埔鄉,南興村,355,1238,225,465,690,50,740
公投第１４案,新竹縣,北埔鄉,大湖村,356,580,85,232,317,23,340
公投第１４案,新竹縣,北埔鄉,埔尾村,357,931,142,379,521,24,545
公投第１４案,新竹縣,北埔鄉,埔尾村,358,1653,242,635,877,57,934
公投第１４案,新竹縣,北埔鄉,水磜村,359,845,116,342,458,27,485
公投第１４案,新竹縣,北埔鄉,南埔村,360,384,50,152,202,12,214
公投第１４案,新竹縣,北埔鄉,大林村,361,763,109,312,421,15,436
公投第１４案,新竹縣,北埔鄉,南坑村,362,333,52,115,167,16,183
公投第１４案,新竹縣,北埔鄉,外坪村,363,295,26,127,153,7,160
公投第１４案,新竹縣,寶山鄉,雙溪村,364,1158,205,401,606,14,620
公投第１４案,新竹縣,寶山鄉,雙溪村,365,1437,281,519,800,17,817
公投第１４案,新竹縣,寶山鄉,雙新村,366,1470,246,550,796,43,839
公投第１４案,新竹縣,寶山鄉,雙新村,367,1170,226,442,668,46,714
公投第１４案,新竹縣,寶山鄉,大崎村,368,1900,379,679,1058,43,1101
公投第１４案,新竹縣,寶山鄉,三峰村,369,1056,175,347,522,19,541
公投第１４案,新竹縣,寶山鄉,新城村,370,1205,176,527,703,53,756
公投第１４案,新竹縣,寶山鄉,寶斗村,371,766,97,317,414,30,444
公投第１４案,新竹縣,寶山鄉,深井村,372,846,127,365,492,28,520
公投第１４案,新竹縣,寶山鄉,寶山村,373,804,135,324,459,29,488
公投第１４案,新竹縣,寶山鄉,油田村,374,607,103,255,358,13,371
公投第１４案,新竹縣,寶山鄉,山湖村,375,554,112,234,346,12,358
公投第１４案,新竹縣,峨眉鄉,峨眉村,376,879,131,387,518,49,567
公投第１４案,新竹縣,峨眉鄉,中盛村,377,683,110,276,386,45,431
公投第１４案,新竹縣,峨眉鄉,石井村,378,604,91,245,336,31,367
公投第１４案,新竹縣,峨眉鄉,七星村,379,339,39,140,179,19,198
公投第１４案,新竹縣,峨眉鄉,七星村,380,276,21,92,113,6,119
公投第１４案,新竹縣,峨眉鄉,富興村,381,1406,188,610,798,60,858
公投第１４案,新竹縣,峨眉鄉,湖光村,382,462,56,207,263,26,289
公投第１４案,新竹縣,峨眉鄉,湖光村,383,419,53,157,210,17,227
公投第１４案,新竹縣,尖石鄉,嘉樂村,384,474,48,171,219,6,225
公投第１４案,新竹縣,尖石鄉,嘉樂村,385,357,50,137,187,4,191
公投第１４案,新竹縣,尖石鄉,義興村,386,225,20,75,95,16,111
公投第１４案,新竹縣,尖石鄉,義興村,387,374,31,142,173,15,188
公投第１４案,新竹縣,尖石鄉,新樂村,388,773,73,258,331,6,337
公投第１４案,新竹縣,尖石鄉,新樂村,389,490,38,225,263,16,279
公投第１４案,新竹縣,尖石鄉,錦屏村,390,531,43,180,223,4,227
公投第１４案,新竹縣,尖石鄉,錦屏村,391,660,43,302,345,17,362
公投第１４案,新竹縣,尖石鄉,梅花村,392,613,62,311,373,43,416
公投第１４案,新竹縣,尖石鄉,玉峰村,393,593,68,220,288,4,292
公投第１４案,新竹縣,尖石鄉,玉峰村,394,575,37,270,307,19,326
公投第１４案,新竹縣,尖石鄉,玉峰村,395,126,11,68,79,5,84
公投第１４案,新竹縣,尖石鄉,秀巒村,396,499,38,190,228,9,237
公投第１４案,新竹縣,尖石鄉,秀巒村,397,785,69,220,289,23,312
公投第１４案,新竹縣,尖石鄉,秀巒村,398,289,50,120,170,11,181
公投第１４案,新竹縣,五峰鄉,大隘村,399,672,63,313,376,21,397
公投第１４案,新竹縣,五峰鄉,大隘村,400,713,75,231,306,13,319
公投第１４案,新竹縣,五峰鄉,桃山村,401,594,46,193,239,4,243
公投第１４案,新竹縣,五峰鄉,桃山村,402,896,87,357,444,22,466
公投第１４案,新竹縣,五峰鄉,花園村,403,727,79,294,373,9,382
公投第１４案,新竹縣,五峰鄉,竹林村,404,395,43,125,168,9,177
公投第１４案,苗栗縣,苗栗市,中苗里,1,1087,160,440,600,29,629
公投第１４案,苗栗縣,苗栗市,青苗里,2,1018,152,395,547,23,570
公投第１４案,苗栗縣,苗栗市,維祥里,3,1156,182,440,622,20,642
公投第１４案,苗栗縣,苗栗市,維祥里,4,1118,149,435,584,29,613
公投第１４案,苗栗縣,苗栗市,維祥里,5,1084,179,420,599,41,640
公投第１４案,苗栗縣,苗栗市,維新里,6,1203,197,495,692,29,721
公投第１４案,苗栗縣,苗栗市,維新里,7,1306,191,543,734,43,777
公投第１４案,苗栗縣,苗栗市,維新里,8,1193,183,491,674,38,712
公投第１４案,苗栗縣,苗栗市,玉清里,9,1115,169,472,641,19,660
公投第１４案,苗栗縣,苗栗市,玉清里,10,1119,159,498,657,32,689
公投第１４案,苗栗縣,苗栗市,玉華里,11,1132,185,466,651,46,697
公投第１４案,苗栗縣,苗栗市,玉華里,12,1289,193,504,697,42,739
公投第１４案,苗栗縣,苗栗市,玉華里,13,1264,202,521,723,35,758
公投第１４案,苗栗縣,苗栗市,綠苗里,14,870,115,358,473,20,493
公投第１４案,苗栗縣,苗栗市,高苗里,15,1008,132,345,477,39,516
公投第１４案,苗栗縣,苗栗市,高苗里,16,1078,172,370,542,31,573
公投第１４案,苗栗縣,苗栗市,高苗里,17,1077,170,454,624,26,650
公投第１４案,苗栗縣,苗栗市,新苗里,18,880,134,358,492,18,510
公投第１４案,苗栗縣,苗栗市,玉苗里,19,894,125,340,465,38,503
公投第１４案,苗栗縣,苗栗市,大同里,20,522,71,215,286,19,305
公投第１４案,苗栗縣,苗栗市,恭敬里,21,1376,250,570,820,52,872
公投第１４案,苗栗縣,苗栗市,水源里,22,1391,197,529,726,33,759
公投第１４案,苗栗縣,苗栗市,水源里,23,1081,173,429,602,46,648
公投第１４案,苗栗縣,苗栗市,勝利里,24,1272,199,470,669,41,710
公投第１４案,苗栗縣,苗栗市,勝利里,25,1112,190,473,663,54,717
公投第１４案,苗栗縣,苗栗市,勝利里,26,813,147,382,529,17,546
公投第１４案,苗栗縣,苗栗市,勝利里,27,767,115,296,411,27,438
公投第１４案,苗栗縣,苗栗市,清華里,28,1010,161,401,562,20,582
公投第１４案,苗栗縣,苗栗市,清華里,29,1182,174,482,656,13,669
公投第１４案,苗栗縣,苗栗市,清華里,30,965,132,402,534,17,551
公投第１４案,苗栗縣,苗栗市,上苗里,31,607,95,258,353,14,367
公投第１４案,苗栗縣,苗栗市,上苗里,32,990,193,395,588,27,615
公投第１４案,苗栗縣,苗栗市,北苗里,33,1230,178,418,596,72,668
公投第１４案,苗栗縣,苗栗市,北苗里,34,1372,217,549,766,30,796
公投第１４案,苗栗縣,苗栗市,北苗里,35,1213,207,472,679,26,705
公投第１４案,苗栗縣,苗栗市,北苗里,36,1272,205,482,687,38,725
公投第１４案,苗栗縣,苗栗市,嘉盛里,37,1221,194,516,710,34,744
公投第１４案,苗栗縣,苗栗市,嘉盛里,38,1104,187,427,614,30,644
公投第１４案,苗栗縣,苗栗市,嘉盛里,39,1171,164,453,617,11,628
公投第１４案,苗栗縣,苗栗市,福星里,40,1392,201,553,754,29,783
公投第１４案,苗栗縣,苗栗市,福星里,41,1356,207,557,764,33,797
公投第１４案,苗栗縣,苗栗市,福星里,42,1387,235,524,759,43,802
公投第１４案,苗栗縣,苗栗市,福安里,43,1206,198,445,643,34,677
公投第１４案,苗栗縣,苗栗市,福安里,44,1004,171,444,615,25,640
公投第１４案,苗栗縣,苗栗市,福安里,45,1202,196,447,643,31,674
公投第１４案,苗栗縣,苗栗市,嘉新里,46,1052,194,416,610,31,641
公投第１４案,苗栗縣,苗栗市,嘉新里,47,873,144,376,520,22,542
公投第１４案,苗栗縣,苗栗市,嘉新里,48,975,159,462,621,32,653
公投第１４案,苗栗縣,苗栗市,建功里,49,1003,171,443,614,27,641
公投第１４案,苗栗縣,苗栗市,建功里,50,1000,179,384,563,20,583
公投第１４案,苗栗縣,苗栗市,建功里,51,1047,161,409,570,22,592
公投第１４案,苗栗縣,苗栗市,建功里,52,1025,166,434,600,29,629
公投第１４案,苗栗縣,苗栗市,福麗里,53,1130,147,442,589,22,611
公投第１４案,苗栗縣,苗栗市,福麗里,54,1146,187,439,626,27,653
公投第１４案,苗栗縣,苗栗市,福麗里,55,1432,240,559,799,35,834
公投第１４案,苗栗縣,苗栗市,福麗里,56,1492,156,525,681,30,711
公投第１４案,苗栗縣,苗栗市,文山里,57,1125,178,479,657,33,690
公投第１４案,苗栗縣,苗栗市,文山里,58,1241,198,470,668,27,695
公投第１４案,苗栗縣,苗栗市,文山里,59,1278,231,503,734,38,772
公投第１４案,苗栗縣,苗栗市,文聖里,60,1293,187,513,700,23,723
公投第１４案,苗栗縣,苗栗市,文聖里,61,1342,200,485,685,25,710
公投第１４案,苗栗縣,苗栗市,文聖里,62,857,122,327,449,29,478
公投第１４案,苗栗縣,苗栗市,新川里,63,1180,147,464,611,36,647
公投第１４案,苗栗縣,苗栗市,南勢里,64,1072,176,435,611,25,636
公投第１４案,苗栗縣,苗栗市,南勢里,65,912,108,364,472,32,504
公投第１４案,苗栗縣,苗栗市,新英里,66,796,96,306,402,24,426
公投第１４案,苗栗縣,苗栗市,新英里,67,869,146,280,426,16,442
公投第１４案,苗栗縣,公館鄉,館中村,68,789,130,352,482,42,524
公投第１４案,苗栗縣,公館鄉,館中村,69,792,136,358,494,29,523
公投第１４案,苗栗縣,公館鄉,館東村,70,1117,169,485,654,61,715
公投第１４案,苗栗縣,公館鄉,館東村,71,1255,202,534,736,52,788
公投第１４案,苗栗縣,公館鄉,館南村,72,1141,174,476,650,33,683
公投第１４案,苗栗縣,公館鄉,館南村,73,1172,205,437,642,45,687
公投第１４案,苗栗縣,公館鄉,館南村,74,1100,173,480,653,42,695
公投第１４案,苗栗縣,公館鄉,中義村,75,1232,166,456,622,29,651
公投第１４案,苗栗縣,公館鄉,中義村,76,1081,145,377,522,47,569
公投第１４案,苗栗縣,公館鄉,玉泉村,77,1250,210,525,735,42,777
公投第１４案,苗栗縣,公館鄉,玉泉村,78,1081,160,437,597,34,631
公投第１４案,苗栗縣,公館鄉,大坑村,79,964,127,370,497,56,553
公投第１４案,苗栗縣,公館鄉,福基村,80,1038,158,418,576,54,630
公投第１４案,苗栗縣,公館鄉,福德村,81,360,65,143,208,18,226
公投第１４案,苗栗縣,公館鄉,福星村,82,865,117,344,461,36,497
公投第１４案,苗栗縣,公館鄉,福星村,83,1166,196,419,615,38,653
公投第１４案,苗栗縣,公館鄉,石墻村,84,719,97,303,400,28,428
公投第１４案,苗栗縣,公館鄉,石墻村,85,788,123,278,401,34,435
公投第１４案,苗栗縣,公館鄉,開礦村,86,303,43,140,183,20,203
公投第１４案,苗栗縣,公館鄉,五谷村,87,1322,217,532,749,46,795
公投第１４案,苗栗縣,公館鄉,五谷村,88,933,112,389,501,35,536
公投第１４案,苗栗縣,公館鄉,玉谷村,89,1455,188,530,718,73,791
公投第１４案,苗栗縣,公館鄉,鶴岡村,90,1615,266,644,910,88,998
公投第１４案,苗栗縣,公館鄉,鶴山村,91,1451,191,559,750,53,803
公投第１４案,苗栗縣,公館鄉,尖山村,92,1462,225,604,829,53,882
公投第１４案,苗栗縣,公館鄉,仁安村,93,1317,175,505,680,57,737
公投第１４案,苗栗縣,公館鄉,南河村,94,221,26,97,123,8,131
公投第１４案,苗栗縣,公館鄉,北河村,95,329,39,120,159,16,175
公投第１４案,苗栗縣,頭屋鄉,頭屋村,96,1335,331,503,834,58,892
公投第１４案,苗栗縣,頭屋鄉,頭屋村,97,1168,190,575,765,63,828
公投第１４案,苗栗縣,頭屋鄉,獅潭村,98,792,127,364,491,29,520
公投第１４案,苗栗縣,頭屋鄉,獅潭村,99,918,194,431,625,33,658
公投第１４案,苗栗縣,頭屋鄉,北坑村,100,725,96,342,438,26,464
公投第１４案,苗栗縣,頭屋鄉,曲洞村,101,899,131,393,524,31,555
公投第１４案,苗栗縣,頭屋鄉,飛鳳村,102,369,43,133,176,6,182
公投第１４案,苗栗縣,頭屋鄉,象山村,103,844,149,331,480,24,504
公投第１４案,苗栗縣,頭屋鄉,象山村,104,1007,191,401,592,32,624
公投第１４案,苗栗縣,頭屋鄉,明德村,105,794,51,434,485,16,501
公投第１４案,苗栗縣,頭屋鄉,明德村,106,211,36,106,142,14,156
公投第１４案,苗栗縣,頭屋鄉,鳴鳳村,107,328,47,174,221,17,238
公投第１４案,苗栗縣,銅鑼鄉,銅鑼村,108,887,125,390,515,33,548
公投第１４案,苗栗縣,銅鑼鄉,銅鑼村,109,1052,151,448,599,33,632
公投第１４案,苗栗縣,銅鑼鄉,銅鑼村,110,1347,253,538,791,34,825
公投第１４案,苗栗縣,銅鑼鄉,銅鑼村,111,1177,166,474,640,33,673
公投第１４案,苗栗縣,銅鑼鄉,樟樹村,112,1268,200,459,659,23,682
公投第１４案,苗栗縣,銅鑼鄉,九湖村,113,1185,168,387,555,30,585
公投第１４案,苗栗縣,銅鑼鄉,福興村,114,1029,151,423,574,23,597
公投第１４案,苗栗縣,銅鑼鄉,朝陽村,115,905,113,382,495,30,525
公投第１４案,苗栗縣,銅鑼鄉,朝陽村,116,750,125,322,447,21,468
公投第１４案,苗栗縣,銅鑼鄉,竹森村,117,1080,122,394,516,38,554
公投第１４案,苗栗縣,銅鑼鄉,中平村,118,1108,145,409,554,48,602
公投第１４案,苗栗縣,銅鑼鄉,中平村,119,862,100,326,426,30,456
公投第１４案,苗栗縣,銅鑼鄉,中平村,120,1216,174,439,613,34,647
公投第１４案,苗栗縣,銅鑼鄉,興隆村,121,588,63,213,276,28,304
公投第１４案,苗栗縣,銅鑼鄉,盛隆村,122,429,54,152,206,29,235
公投第１４案,苗栗縣,銅鑼鄉,新隆村,123,541,78,220,298,19,317
公投第１４案,苗栗縣,三義鄉,廣盛村,124,853,75,429,504,18,522
公投第１４案,苗栗縣,三義鄉,廣盛村,125,983,147,440,587,24,611
公投第１４案,苗栗縣,三義鄉,廣盛村,126,1080,158,453,611,37,648
公投第１４案,苗栗縣,三義鄉,廣盛村,127,1216,177,457,634,17,651
公投第１４案,苗栗縣,三義鄉,勝興村,128,1017,143,432,575,29,604
公投第１４案,苗栗縣,三義鄉,勝興村,129,1180,167,442,609,23,632
公投第１４案,苗栗縣,三義鄉,勝興村,130,1198,174,489,663,21,684
公投第１４案,苗栗縣,三義鄉,龍騰村,131,417,51,181,232,10,242
公投第１４案,苗栗縣,三義鄉,双湖村,132,991,114,383,497,26,523
公投第１４案,苗栗縣,三義鄉,双湖村,133,834,107,361,468,19,487
公投第１４案,苗栗縣,三義鄉,双潭村,134,622,94,254,348,19,367
公投第１４案,苗栗縣,三義鄉,双潭村,135,749,111,312,423,36,459
公投第１４案,苗栗縣,三義鄉,西湖村,136,692,113,327,440,20,460
公投第１４案,苗栗縣,三義鄉,西湖村,137,759,145,355,500,35,535
公投第１４案,苗栗縣,三義鄉,鯉魚潭村,138,629,82,232,314,22,336
公投第１４案,苗栗縣,三義鄉,鯉魚潭村,139,669,113,249,362,25,387
公投第１４案,苗栗縣,西湖鄉,高埔村,140,601,94,218,312,19,331
公投第１４案,苗栗縣,西湖鄉,下埔村,141,566,80,239,319,22,341
公投第１４案,苗栗縣,西湖鄉,五湖村,142,843,122,324,446,45,491
公投第１４案,苗栗縣,西湖鄉,四湖村,143,648,95,232,327,17,344
公投第１４案,苗栗縣,西湖鄉,三湖村,144,936,149,297,446,27,473
公投第１４案,苗栗縣,西湖鄉,龍洞村,145,461,64,169,233,15,248
公投第１４案,苗栗縣,西湖鄉,金獅村,146,515,77,196,273,21,294
公投第１４案,苗栗縣,西湖鄉,湖東村,147,1141,142,432,574,41,615
公投第１４案,苗栗縣,西湖鄉,二湖村,148,671,104,270,374,23,397
公投第１４案,苗栗縣,通霄鎮,通東里,149,1142,191,410,601,63,664
公投第１４案,苗栗縣,通霄鎮,通西里,150,884,187,337,524,53,577
公投第１４案,苗栗縣,通霄鎮,通西里,151,1068,140,410,550,55,605
公投第１４案,苗栗縣,通霄鎮,平元里,152,1009,177,375,552,38,590
公投第１４案,苗栗縣,通霄鎮,平元里,153,859,166,354,520,41,561
公投第１４案,苗栗縣,通霄鎮,平安里,154,1040,201,371,572,37,609
公投第１４案,苗栗縣,通霄鎮,平安里,155,1008,113,302,415,25,440
公投第１４案,苗栗縣,通霄鎮,圳頭里,156,686,95,255,350,58,408
公投第１４案,苗栗縣,通霄鎮,梅南里,157,761,133,330,463,46,509
公投第１４案,苗栗縣,通霄鎮,梅南里,158,790,102,270,372,30,402
公投第１４案,苗栗縣,通霄鎮,通南里,159,966,133,356,489,45,534
公投第１４案,苗栗縣,通霄鎮,通南里,160,972,132,309,441,63,504
公投第１４案,苗栗縣,通霄鎮,通南里,161,771,110,284,394,34,428
公投第１４案,苗栗縣,通霄鎮,內湖里,162,758,103,230,333,22,355
公投第１４案,苗栗縣,通霄鎮,內湖里,163,1078,164,372,536,48,584
公投第１４案,苗栗縣,通霄鎮,楓樹里,164,459,40,137,177,23,200
公投第１４案,苗栗縣,通霄鎮,烏眉里,165,894,102,304,406,43,449
公投第１４案,苗栗縣,通霄鎮,福龍里,166,402,43,108,151,8,159
公投第１４案,苗栗縣,通霄鎮,福源里,167,802,103,297,400,33,433
公投第１４案,苗栗縣,通霄鎮,城北里,168,684,108,229,337,12,349
公投第１４案,苗栗縣,通霄鎮,城南里,169,943,112,301,413,31,444
公投第１４案,苗栗縣,通霄鎮,南和里,170,790,114,319,433,47,480
公投第１４案,苗栗縣,通霄鎮,福興里,171,673,65,211,276,14,290
公投第１４案,苗栗縣,通霄鎮,坪頂里,172,1232,162,448,610,45,655
公投第１４案,苗栗縣,通霄鎮,五南里,173,1286,163,538,701,55,756
公投第１４案,苗栗縣,通霄鎮,五北里,174,649,102,247,349,38,387
公投第１４案,苗栗縣,通霄鎮,五北里,175,769,115,245,360,26,386
公投第１４案,苗栗縣,通霄鎮,通灣里,176,1148,172,394,566,64,630
公投第１４案,苗栗縣,通霄鎮,通灣里,177,1138,158,344,502,74,576
公投第１４案,苗栗縣,通霄鎮,新埔里,178,1121,159,362,521,49,570
公投第１４案,苗栗縣,通霄鎮,內島里,179,769,113,287,400,27,427
公投第１４案,苗栗縣,通霄鎮,白東里,180,616,92,194,286,17,303
公投第１４案,苗栗縣,通霄鎮,白東里,181,799,140,254,394,41,435
公投第１４案,苗栗縣,通霄鎮,白西里,182,743,107,243,350,31,381
公投第１４案,苗栗縣,苑裡鎮,苑東里,183,873,124,358,482,41,523
公投第１４案,苗栗縣,苑裡鎮,苑東里,184,1346,213,533,746,46,792
公投第１４案,苗栗縣,苑裡鎮,苑南里,185,951,177,419,596,38,634
公投第１４案,苗栗縣,苑裡鎮,苑南里,186,615,85,257,342,8,350
公投第１４案,苗栗縣,苑裡鎮,苑北里,187,878,137,357,494,57,551
公投第１４案,苗栗縣,苑裡鎮,西平里,188,767,138,297,435,39,474
公投第１４案,苗栗縣,苑裡鎮,西平里,189,776,122,291,413,31,444
公投第１４案,苗栗縣,苑裡鎮,苑港里,190,1231,165,439,604,55,659
公投第１４案,苗栗縣,苑裡鎮,西勢里,191,1145,180,455,635,47,682
公投第１４案,苗栗縣,苑裡鎮,西勢里,192,850,122,319,441,34,475
公投第１４案,苗栗縣,苑裡鎮,海岸里,193,1052,143,379,522,61,583
公投第１４案,苗栗縣,苑裡鎮,房裡里,194,1114,164,427,591,48,639
公投第１４案,苗栗縣,苑裡鎮,房裡里,195,1136,199,425,624,51,675
公投第１４案,苗栗縣,苑裡鎮,客庄里,196,1194,166,474,640,38,678
公投第１４案,苗栗縣,苑裡鎮,客庄里,197,1579,256,604,860,43,903
公投第１４案,苗栗縣,苑裡鎮,客庄里,198,1149,217,451,668,48,716
公投第１４案,苗栗縣,苑裡鎮,中正里,199,1057,176,411,587,55,642
公投第１４案,苗栗縣,苑裡鎮,中正里,200,1101,148,412,560,20,580
公投第１４案,苗栗縣,苑裡鎮,苑坑里,201,912,118,297,415,39,454
公投第１４案,苗栗縣,苑裡鎮,水坡里,202,652,83,246,329,38,367
公投第１４案,苗栗縣,苑裡鎮,新復里,203,1348,194,524,718,69,787
公投第１４案,苗栗縣,苑裡鎮,山脚里,204,733,113,236,349,22,371
公投第１４案,苗栗縣,苑裡鎮,山脚里,205,662,87,242,329,12,341
公投第１４案,苗栗縣,苑裡鎮,舊社里,206,893,136,347,483,36,519
公投第１４案,苗栗縣,苑裡鎮,舊社里,207,910,149,351,500,46,546
公投第１４案,苗栗縣,苑裡鎮,福田里,208,1270,172,475,647,54,701
公投第１４案,苗栗縣,苑裡鎮,石鎮里,209,545,64,205,269,25,294
公投第１４案,苗栗縣,苑裡鎮,蕉埔里,210,792,100,350,450,51,501
公投第１４案,苗栗縣,苑裡鎮,南勢里,211,726,118,271,389,28,417
公投第１４案,苗栗縣,苑裡鎮,泰田里,212,827,93,256,349,14,363
公投第１４案,苗栗縣,苑裡鎮,泰田里,213,782,130,296,426,44,470
公投第１４案,苗栗縣,苑裡鎮,上舘里,214,788,107,280,387,44,431
公投第１４案,苗栗縣,苑裡鎮,上舘里,215,846,111,315,426,37,463
公投第１４案,苗栗縣,苑裡鎮,玉田里,216,828,126,345,471,34,505
公投第１４案,苗栗縣,苑裡鎮,玉田里,217,943,107,397,504,47,551
公投第１４案,苗栗縣,苑裡鎮,社苓里,218,1082,149,470,619,28,647
公投第１４案,苗栗縣,苑裡鎮,社苓里,219,1234,187,510,697,51,748
公投第１４案,苗栗縣,苑裡鎮,山柑里,220,1434,183,560,743,47,790
公投第１４案,苗栗縣,苑裡鎮,田心里,221,987,150,384,534,36,570
公投第１４案,苗栗縣,苑裡鎮,田心里,222,882,149,367,516,48,564
公投第１４案,苗栗縣,後龍鎮,南龍里,223,590,99,217,316,28,344
公投第１４案,苗栗縣,後龍鎮,南龍里,224,883,161,352,513,46,559
公投第１４案,苗栗縣,後龍鎮,中龍里,225,793,146,314,460,37,497
公投第１４案,苗栗縣,後龍鎮,北龍里,226,732,131,284,415,26,441
公投第１４案,苗栗縣,後龍鎮,北龍里,227,592,100,239,339,23,362
公投第１４案,苗栗縣,後龍鎮,大庄里,228,1113,282,336,618,47,665
公投第１４案,苗栗縣,後龍鎮,大庄里,229,1195,217,425,642,35,677
公投第１４案,苗栗縣,後龍鎮,大庄里,230,997,168,415,583,45,628
公投第１４案,苗栗縣,後龍鎮,大庄里,231,913,125,310,435,20,455
公投第１４案,苗栗縣,後龍鎮,東明里,232,641,85,226,311,26,337
公投第１４案,苗栗縣,後龍鎮,東明里,233,848,138,286,424,27,451
公投第１４案,苗栗縣,後龍鎮,灣寶里,234,1264,176,454,630,70,700
公投第１４案,苗栗縣,後龍鎮,海寶里,235,965,137,331,468,35,503
公投第１４案,苗栗縣,後龍鎮,豐富里,236,1216,198,602,800,52,852
公投第１４案,苗栗縣,後龍鎮,校椅里,237,977,132,363,495,38,533
公投第１４案,苗栗縣,後龍鎮,埔頂里,238,943,119,323,442,33,475
公投第１４案,苗栗縣,後龍鎮,埔頂里,239,910,129,332,461,61,522
公投第１４案,苗栗縣,後龍鎮,埔頂里,240,851,112,321,433,41,474
公投第１４案,苗栗縣,後龍鎮,新民里,241,725,160,278,438,21,459
公投第１４案,苗栗縣,後龍鎮,新民里,242,650,121,231,352,36,388
公投第１４案,苗栗縣,後龍鎮,復興里,243,706,106,219,325,42,367
公投第１４案,苗栗縣,後龍鎮,大山里,244,748,112,290,402,34,436
公投第１４案,苗栗縣,後龍鎮,大山里,245,801,103,245,348,31,379
公投第１４案,苗栗縣,後龍鎮,溪洲里,246,1107,146,445,591,36,627
公投第１４案,苗栗縣,後龍鎮,溪洲里,247,1197,174,421,595,63,658
公投第１４案,苗栗縣,後龍鎮,外埔里,248,1036,118,358,476,52,528
公投第１４案,苗栗縣,後龍鎮,海埔里,249,913,112,281,393,33,426
公投第１４案,苗栗縣,後龍鎮,秀水里,250,719,110,291,401,39,440
公投第１４案,苗栗縣,後龍鎮,水尾里,251,1037,136,395,531,68,599
公投第１４案,苗栗縣,後龍鎮,龍津里,252,601,93,195,288,19,307
公投第１４案,苗栗縣,後龍鎮,龍坑里,253,1269,162,384,546,34,580
公投第１４案,苗栗縣,後龍鎮,福寧里,254,735,93,244,337,28,365
公投第１４案,苗栗縣,後龍鎮,中和里,255,422,33,102,135,10,145
公投第１４案,苗栗縣,後龍鎮,中和里,256,625,83,256,339,20,359
公投第１４案,苗栗縣,後龍鎮,南港里,257,1234,107,408,515,60,575
公投第１４案,苗栗縣,造橋鄉,造橋村,258,1171,206,511,717,49,766
公投第１４案,苗栗縣,造橋鄉,造橋村,259,889,104,388,492,36,528
公投第１４案,苗栗縣,造橋鄉,平興村,260,479,60,161,221,16,237
公投第１４案,苗栗縣,造橋鄉,豐湖村,261,1024,142,420,562,40,602
公投第１４案,苗栗縣,造橋鄉,大西村,262,1214,179,417,596,61,657
公投第１４案,苗栗縣,造橋鄉,大西村,263,1071,142,378,520,40,560
公投第１４案,苗栗縣,造橋鄉,大西村,264,1157,155,396,551,56,607
公投第１４案,苗栗縣,造橋鄉,錦水村,265,512,79,201,280,21,301
公投第１４案,苗栗縣,造橋鄉,大龍村,266,491,76,216,292,18,310
公投第１４案,苗栗縣,造橋鄉,朝陽村,267,1272,188,529,717,49,766
公投第１４案,苗栗縣,造橋鄉,談文村,268,785,113,298,411,40,451
公投第１４案,苗栗縣,造橋鄉,龍昇村,269,962,169,388,557,77,634
公投第１４案,苗栗縣,竹南鎮,竹南里,270,1086,218,414,632,23,655
公投第１４案,苗栗縣,竹南鎮,竹南里,271,826,124,334,458,32,490
公投第１４案,苗栗縣,竹南鎮,照南里,272,1051,195,331,526,31,557
公投第１４案,苗栗縣,竹南鎮,照南里,273,1235,200,495,695,36,731
公投第１４案,苗栗縣,竹南鎮,照南里,274,1016,186,371,557,60,617
公投第１４案,苗栗縣,竹南鎮,正南里,275,1472,258,490,748,49,797
公投第１４案,苗栗縣,竹南鎮,正南里,276,1301,207,414,621,18,639
公投第１４案,苗栗縣,竹南鎮,新南里,277,1544,269,483,752,30,782
公投第１４案,苗栗縣,竹南鎮,新南里,278,1512,250,554,804,27,831
公投第１４案,苗栗縣,竹南鎮,新南里,279,1463,250,494,744,36,780
公投第１４案,苗栗縣,竹南鎮,大厝里,280,1073,164,274,438,27,465
公投第１４案,苗栗縣,竹南鎮,大厝里,281,1453,243,563,806,28,834
公投第１４案,苗栗縣,竹南鎮,大厝里,282,1245,228,499,727,28,755
公投第１４案,苗栗縣,竹南鎮,大厝里,283,1487,236,633,869,20,889
公投第１４案,苗栗縣,竹南鎮,營盤里,284,1018,177,395,572,33,605
公投第１４案,苗栗縣,竹南鎮,營盤里,285,1105,212,424,636,20,656
公投第１４案,苗栗縣,竹南鎮,營盤里,286,1322,217,449,666,34,700
公投第１４案,苗栗縣,竹南鎮,聖福里,287,1140,171,469,640,23,663
公投第１４案,苗栗縣,竹南鎮,聖福里,288,1067,184,440,624,31,655
公投第１４案,苗栗縣,竹南鎮,聖福里,289,1136,194,482,676,41,717
公投第１４案,苗栗縣,竹南鎮,竹興里,290,1253,172,453,625,28,653
公投第１４案,苗栗縣,竹南鎮,竹興里,291,963,150,322,472,42,514
公投第１４案,苗栗縣,竹南鎮,竹興里,292,1021,173,347,520,37,557
公投第１４案,苗栗縣,竹南鎮,龍山里,293,1154,214,450,664,32,696
公投第１４案,苗栗縣,竹南鎮,龍山里,294,1042,195,377,572,27,599
公投第１４案,苗栗縣,竹南鎮,天文里,295,1293,201,510,711,33,744
公投第１４案,苗栗縣,竹南鎮,天文里,296,816,139,339,478,12,490
公投第１４案,苗栗縣,竹南鎮,龍鳳里,297,989,157,355,512,51,563
公投第１４案,苗栗縣,竹南鎮,龍鳳里,298,1122,172,473,645,35,680
公投第１４案,苗栗縣,竹南鎮,山佳里,299,1111,153,347,500,28,528
公投第１４案,苗栗縣,竹南鎮,山佳里,300,1036,149,424,573,41,614
公投第１４案,苗栗縣,竹南鎮,山佳里,301,1112,142,394,536,24,560
公投第１４案,苗栗縣,竹南鎮,山佳里,302,1348,214,471,685,20,705
公投第１４案,苗栗縣,竹南鎮,佳興里,303,1114,207,424,631,26,657
公投第１４案,苗栗縣,竹南鎮,佳興里,304,1119,209,426,635,38,673
公投第１４案,苗栗縣,竹南鎮,佳興里,305,878,114,360,474,23,497
公投第１４案,苗栗縣,竹南鎮,中港里,306,1059,183,424,607,44,651
公投第１４案,苗栗縣,竹南鎮,中華里,307,869,162,330,492,34,526
公投第１４案,苗栗縣,竹南鎮,中華里,308,800,118,298,416,29,445
公投第１４案,苗栗縣,竹南鎮,中華里,309,1165,215,464,679,34,713
公投第１４案,苗栗縣,竹南鎮,中英里,310,791,132,297,429,35,464
公投第１４案,苗栗縣,竹南鎮,中英里,311,677,103,257,360,23,383
公投第１４案,苗栗縣,竹南鎮,中美里,312,797,140,334,474,43,517
公投第１４案,苗栗縣,竹南鎮,中美里,313,1191,176,453,629,33,662
公投第１４案,苗栗縣,竹南鎮,開元里,314,1027,164,362,526,14,540
公投第１４案,苗栗縣,竹南鎮,海口里,315,1341,228,515,743,46,789
公投第１４案,苗栗縣,竹南鎮,海口里,316,1378,202,453,655,48,703
公投第１４案,苗栗縣,竹南鎮,海口里,317,1216,207,447,654,30,684
公投第１４案,苗栗縣,竹南鎮,港墘里,318,1570,222,579,801,33,834
公投第１４案,苗栗縣,竹南鎮,港墘里,319,538,97,207,304,26,330
公投第１４案,苗栗縣,竹南鎮,公舘里,320,1166,132,386,518,33,551
公投第１４案,苗栗縣,竹南鎮,大埔里,321,1488,276,477,753,31,784
公投第１４案,苗栗縣,竹南鎮,大埔里,322,1449,210,491,701,31,732
公投第１４案,苗栗縣,竹南鎮,大埔里,323,1182,185,433,618,45,663
公投第１４案,苗栗縣,竹南鎮,頂埔里,324,1175,166,431,597,71,668
公投第１４案,苗栗縣,竹南鎮,頂埔里,325,983,153,381,534,36,570
公投第１４案,苗栗縣,竹南鎮,崎頂里,326,492,71,223,294,15,309
公投第１４案,苗栗縣,竹南鎮,崎頂里,327,1074,214,389,603,19,622
公投第１４案,苗栗縣,竹南鎮,崎頂里,328,852,129,307,436,34,470
公投第１４案,苗栗縣,竹南鎮,崎頂里,329,1297,220,426,646,31,677
公投第１４案,苗栗縣,竹南鎮,公義里,330,1028,146,375,521,38,559
公投第１４案,苗栗縣,頭份市,流東里,331,915,114,345,459,41,500
公投第１４案,苗栗縣,頭份市,流東里,332,1292,165,514,679,56,735
公投第１４案,苗栗縣,頭份市,珊湖里,333,928,129,390,519,34,553
公投第１４案,苗栗縣,頭份市,珊湖里,334,835,106,310,416,11,427
公投第１４案,苗栗縣,頭份市,斗煥里,335,1070,143,409,552,37,589
公投第１４案,苗栗縣,頭份市,斗煥里,336,879,109,332,441,17,458
公投第１４案,苗栗縣,頭份市,斗煥里,337,1039,181,327,508,31,539
公投第１４案,苗栗縣,頭份市,新華里,338,1129,161,444,605,51,656
公投第１４案,苗栗縣,頭份市,新華里,339,1041,151,382,533,39,572
公投第１４案,苗栗縣,頭份市,新華里,340,1546,191,560,751,46,797
公投第１４案,苗栗縣,頭份市,興隆里,341,935,146,409,555,32,587
公投第１４案,苗栗縣,頭份市,興隆里,342,1180,175,407,582,35,617
公投第１４案,苗栗縣,頭份市,興隆里,343,1499,215,534,749,21,770
公投第１４案,苗栗縣,頭份市,興隆里,344,747,143,249,392,13,405
公投第１４案,苗栗縣,頭份市,上埔里,345,1406,196,537,733,28,761
公投第１４案,苗栗縣,頭份市,上埔里,346,1193,162,459,621,52,673
公投第１４案,苗栗縣,頭份市,土牛里,347,948,162,360,522,35,557
公投第１４案,苗栗縣,頭份市,頭份里,348,869,114,339,453,16,469
公投第１４案,苗栗縣,頭份市,頭份里,349,1142,175,461,636,29,665
公投第１４案,苗栗縣,頭份市,頭份里,350,1286,214,472,686,23,709
公投第１４案,苗栗縣,頭份市,忠孝里,351,903,148,366,514,26,540
公投第１４案,苗栗縣,頭份市,忠孝里,352,1186,190,515,705,30,735
公投第１４案,苗栗縣,頭份市,忠孝里,353,1016,166,417,583,17,600
公投第１４案,苗栗縣,頭份市,自強里,354,985,150,374,524,35,559
公投第１４案,苗栗縣,頭份市,自強里,355,1037,135,406,541,20,561
公投第１４案,苗栗縣,頭份市,信義里,356,947,128,315,443,21,464
公投第１４案,苗栗縣,頭份市,仁愛里,357,890,145,351,496,21,517
公投第１４案,苗栗縣,頭份市,仁愛里,358,646,127,256,383,25,408
公投第１４案,苗栗縣,頭份市,上興里,359,975,150,395,545,39,584
公投第１４案,苗栗縣,頭份市,上興里,360,1015,102,281,383,14,397
公投第１４案,苗栗縣,頭份市,下興里,361,1399,237,571,808,55,863
公投第１４案,苗栗縣,頭份市,下興里,362,1143,176,464,640,49,689
公投第１４案,苗栗縣,頭份市,和平里,363,1030,156,471,627,43,670
公投第１４案,苗栗縣,頭份市,山下里,364,1338,222,515,737,34,771
公投第１４案,苗栗縣,頭份市,山下里,365,1450,237,527,764,21,785
公投第１４案,苗栗縣,頭份市,山下里,366,1042,169,427,596,14,610
公投第１４案,苗栗縣,頭份市,後庄里,367,1326,230,540,770,25,795
公投第１４案,苗栗縣,頭份市,後庄里,368,1270,228,540,768,34,802
公投第１４案,苗栗縣,頭份市,後庄里,369,1288,205,486,691,34,725
公投第１４案,苗栗縣,頭份市,合興里,370,1243,237,487,724,21,745
公投第１４案,苗栗縣,頭份市,合興里,371,1280,193,541,734,22,756
公投第１４案,苗栗縣,頭份市,文化里,372,1618,266,601,867,46,913
公投第１４案,苗栗縣,頭份市,文化里,373,1759,281,631,912,35,947
公投第１４案,苗栗縣,頭份市,中興里,374,1264,206,515,721,34,755
公投第１４案,苗栗縣,頭份市,中興里,375,1326,240,503,743,25,768
公投第１４案,苗栗縣,頭份市,蟠桃里,376,1551,250,614,864,25,889
公投第１４案,苗栗縣,頭份市,蟠桃里,377,1574,223,549,772,41,813
公投第１４案,苗栗縣,頭份市,建國里,378,1262,208,480,688,43,731
公投第１４案,苗栗縣,頭份市,建國里,379,1171,179,471,650,37,687
公投第１４案,苗栗縣,頭份市,建國里,380,1074,204,460,664,32,696
公投第１４案,苗栗縣,頭份市,成功里,381,1141,188,474,662,28,690
公投第１４案,苗栗縣,頭份市,成功里,382,1259,205,496,701,31,732
公投第１４案,苗栗縣,頭份市,成功里,383,1186,190,448,638,20,658
公投第１４案,苗栗縣,頭份市,民族里,384,1121,139,425,564,19,583
公投第１４案,苗栗縣,頭份市,民族里,385,847,121,343,464,22,486
公投第１４案,苗栗縣,頭份市,民權里,386,993,187,383,570,29,599
公投第１４案,苗栗縣,頭份市,民權里,387,1055,166,382,548,24,572
公投第１４案,苗栗縣,頭份市,東庄里,388,1655,203,592,795,38,833
公投第１４案,苗栗縣,頭份市,東庄里,389,1799,238,696,934,55,989
公投第１４案,苗栗縣,頭份市,田寮里,390,1141,182,449,631,31,662
公投第１４案,苗栗縣,頭份市,田寮里,391,1431,239,497,736,45,781
公投第１４案,苗栗縣,頭份市,田寮里,392,1412,177,471,648,16,664
公投第１４案,苗栗縣,頭份市,民生里,393,1074,140,406,546,21,567
公投第１４案,苗栗縣,頭份市,民生里,394,1245,196,512,708,34,742
公投第１４案,苗栗縣,頭份市,蘆竹里,395,1344,224,532,756,53,809
公投第１４案,苗栗縣,頭份市,尖山里,396,1363,223,562,785,58,843
公投第１４案,苗栗縣,頭份市,廣興里,397,898,137,411,548,25,573
公投第１４案,苗栗縣,頭份市,尖下里,398,1182,194,456,650,63,713
公投第１４案,苗栗縣,頭份市,尖下里,399,1413,191,552,743,37,780
公投第１４案,苗栗縣,頭份市,濫坑里,400,991,159,421,580,36,616
公投第１４案,苗栗縣,頭份市,濫坑里,401,1180,183,470,653,43,696
公投第１４案,苗栗縣,三灣鄉,三灣村,402,996,145,436,581,15,596
公投第１４案,苗栗縣,三灣鄉,三灣村,403,1205,187,456,643,46,689
公投第１４案,苗栗縣,三灣鄉,內灣村,404,635,86,264,350,35,385
公投第１４案,苗栗縣,三灣鄉,銅鏡村,405,862,114,349,463,35,498
公投第１４案,苗栗縣,三灣鄉,頂寮村,406,238,19,86,105,13,118
公投第１４案,苗栗縣,三灣鄉,北埔村,407,541,69,203,272,22,294
公投第１４案,苗栗縣,三灣鄉,大河村,408,578,73,204,277,21,298
公投第１４案,苗栗縣,三灣鄉,大坪村,409,405,62,187,249,30,279
公投第１４案,苗栗縣,三灣鄉,永和村,410,392,45,160,205,19,224
公投第１４案,苗栗縣,南庄鄉,東村,411,1155,159,432,591,53,644
公投第１４案,苗栗縣,南庄鄉,西村,412,650,95,258,353,18,371
公投第１４案,苗栗縣,南庄鄉,南江村,413,1353,161,482,643,56,699
公投第１４案,苗栗縣,南庄鄉,田美村,414,813,84,249,333,22,355
公投第１４案,苗栗縣,南庄鄉,獅山村,415,837,78,247,325,34,359
公投第１４案,苗栗縣,南庄鄉,南富村,416,1093,142,398,540,32,572
公投第１４案,苗栗縣,南庄鄉,員林村,417,1048,156,376,532,41,573
公投第１４案,苗栗縣,南庄鄉,蓬萊村,418,872,130,290,420,26,446
公投第１４案,苗栗縣,南庄鄉,東河村,419,963,83,224,307,13,320
公投第１４案,苗栗縣,大湖鄉,大湖村,420,744,113,263,376,32,408
公投第１４案,苗栗縣,大湖鄉,大湖村,421,881,129,328,457,30,487
公投第１４案,苗栗縣,大湖鄉,明湖村,422,596,88,223,311,29,340
公投第１４案,苗栗縣,大湖鄉,大寮村,423,1260,179,427,606,49,655
公投第１４案,苗栗縣,大湖鄉,靜湖村,424,867,105,317,422,32,454
公投第１４案,苗栗縣,大湖鄉,靜湖村,425,923,116,363,479,34,513
公投第１４案,苗栗縣,大湖鄉,富興村,426,1395,172,498,670,66,736
公投第１４案,苗栗縣,大湖鄉,大南村,427,561,63,132,195,21,216
公投第１４案,苗栗縣,大湖鄉,南湖村,428,638,85,271,356,17,373
公投第１４案,苗栗縣,大湖鄉,東興村,429,754,101,268,369,31,400
公投第１４案,苗栗縣,大湖鄉,武榮村,430,501,41,195,236,12,248
公投第１４案,苗栗縣,大湖鄉,義和村,431,652,108,217,325,34,359
公投第１４案,苗栗縣,大湖鄉,義和村,432,843,102,284,386,30,416
公投第１４案,苗栗縣,大湖鄉,栗林村,433,1020,149,377,526,55,581
公投第１４案,苗栗縣,大湖鄉,新開村,434,1018,128,410,538,41,579
公投第１４案,苗栗縣,獅潭鄉,百壽村,435,328,21,102,123,7,130
公投第１４案,苗栗縣,獅潭鄉,永興村,436,565,49,175,224,28,252
公投第１４案,苗栗縣,獅潭鄉,新店村,437,911,123,344,467,56,523
公投第１４案,苗栗縣,獅潭鄉,和興村,438,568,66,179,245,23,268
公投第１４案,苗栗縣,獅潭鄉,豐林村,439,580,60,251,311,31,342
公投第１４案,苗栗縣,獅潭鄉,新豐村,440,333,42,115,157,12,169
公投第１４案,苗栗縣,獅潭鄉,竹木村,441,683,75,255,330,26,356
公投第１４案,苗栗縣,卓蘭鎮,老庄里,442,961,152,394,546,42,588
公投第１４案,苗栗縣,卓蘭鎮,老庄里,443,1017,164,370,534,44,578
公投第１４案,苗栗縣,卓蘭鎮,新榮里,444,1095,195,459,654,51,705
公投第１４案,苗栗縣,卓蘭鎮,中街里,445,745,114,321,435,25,460
公投第１４案,苗栗縣,卓蘭鎮,新厝里,446,783,102,302,404,27,431
公投第１４案,苗栗縣,卓蘭鎮,新厝里,447,745,108,259,367,10,377
公投第１４案,苗栗縣,卓蘭鎮,豐田里,448,999,137,362,499,25,524
公投第１４案,苗栗縣,卓蘭鎮,西坪里,449,671,104,279,383,35,418
公投第１４案,苗栗縣,卓蘭鎮,苗豐里,450,734,117,309,426,57,483
公投第１４案,苗栗縣,卓蘭鎮,上新里,451,865,134,365,499,38,537
公投第１４案,苗栗縣,卓蘭鎮,上新里,452,828,116,360,476,46,522
公投第１４案,苗栗縣,卓蘭鎮,上新里,453,386,53,167,220,24,244
公投第１４案,苗栗縣,卓蘭鎮,內灣里,454,688,119,292,411,33,444
公投第１４案,苗栗縣,卓蘭鎮,內灣里,455,792,148,313,461,31,492
公投第１４案,苗栗縣,卓蘭鎮,內灣里,456,729,115,298,413,21,434
公投第１４案,苗栗縣,卓蘭鎮,坪林里,457,1093,164,338,502,24,526
公投第１４案,苗栗縣,卓蘭鎮,坪林里,458,615,79,259,338,18,356
公投第１４案,苗栗縣,卓蘭鎮,西坪里,459,86,4,43,47,2,49
公投第１４案,苗栗縣,卓蘭鎮,景山里,460,940,122,383,505,14,519
公投第１４案,苗栗縣,泰安鄉,八卦村,461,325,31,118,149,6,155
公投第１４案,苗栗縣,泰安鄉,錦水村,462,484,57,209,266,23,289
公投第１４案,苗栗縣,泰安鄉,錦水村,463,666,104,351,455,35,490
公投第１４案,苗栗縣,泰安鄉,清安村,464,574,71,280,351,39,390
公投第１４案,苗栗縣,泰安鄉,清安村,465,333,38,127,165,10,175
公投第１４案,苗栗縣,泰安鄉,大興村,466,495,71,265,336,11,347
公投第１４案,苗栗縣,泰安鄉,中興村,467,544,121,246,367,27,394
公投第１４案,苗栗縣,泰安鄉,梅園村,468,500,62,221,283,16,299
公投第１４案,苗栗縣,泰安鄉,象鼻村,469,670,100,352,452,28,480
公投第１４案,苗栗縣,泰安鄉,士林村,470,589,72,373,445,5,450
公投第１４案,彰化縣,彰化市,桃源里,1,871,154,348,502,29,531
公投第１４案,彰化縣,彰化市,桃源里,2,751,92,243,335,31,366
公投第１４案,彰化縣,彰化市,桃源里,3,923,210,368,578,32,610
公投第１４案,彰化縣,彰化市,東興里,4,779,159,288,447,38,485
公投第１４案,彰化縣,彰化市,東興里,5,779,145,293,438,33,471
公投第１４案,彰化縣,彰化市,華北里,6,720,136,283,419,17,436
公投第１４案,彰化縣,彰化市,華北里,7,749,138,289,427,21,448
公投第１４案,彰化縣,彰化市,華陽里,8,767,142,330,472,32,504
公投第１４案,彰化縣,彰化市,華陽里,9,1047,167,438,605,55,660
公投第１４案,彰化縣,彰化市,大同里,10,1027,187,372,559,30,589
公投第１４案,彰化縣,彰化市,永生里,11,1249,202,464,666,50,716
公投第１４案,彰化縣,彰化市,建寶里,12,1136,446,207,653,25,678
公投第１４案,彰化縣,彰化市,建寶里,13,1169,199,485,684,41,725
公投第１４案,彰化縣,彰化市,光南里,14,766,160,309,469,19,488
公投第１４案,彰化縣,彰化市,光南里,15,643,89,279,368,20,388
公投第１４案,彰化縣,彰化市,介壽里,16,1251,207,493,700,45,745
公投第１４案,彰化縣,彰化市,介壽里,17,1301,173,315,488,24,512
公投第１４案,彰化縣,彰化市,延平里,18,1280,231,514,745,27,772
公投第１４案,彰化縣,彰化市,延平里,19,1179,203,495,698,29,727
公投第１４案,彰化縣,彰化市,延平里,20,1168,206,467,673,16,689
公投第１４案,彰化縣,彰化市,延平里,21,1218,180,502,682,36,718
公投第１４案,彰化縣,彰化市,延平里,22,1351,258,603,861,20,881
公投第１４案,彰化縣,彰化市,延平里,23,1204,233,406,639,27,666
公投第１４案,彰化縣,彰化市,延平里,24,1189,220,480,700,17,717
公投第１４案,彰化縣,彰化市,延和里,25,1207,204,459,663,36,699
公投第１４案,彰化縣,彰化市,延和里,26,1161,195,469,664,30,694
公投第１４案,彰化縣,彰化市,延和里,27,1166,251,390,641,25,666
公投第１４案,彰化縣,彰化市,延和里,28,1362,264,530,794,40,834
公投第１４案,彰化縣,彰化市,南興里,29,1236,247,491,738,36,774
公投第１４案,彰化縣,彰化市,南興里,30,1065,206,403,609,33,642
公投第１４案,彰化縣,彰化市,南興里,31,1199,242,448,690,32,722
公投第１４案,彰化縣,彰化市,南興里,32,1233,251,465,716,30,746
公投第１４案,彰化縣,彰化市,南興里,33,1245,211,481,692,29,721
公投第１４案,彰化縣,彰化市,南興里,34,1153,226,468,694,24,718
公投第１４案,彰化縣,彰化市,南瑤里,35,1045,226,378,604,29,633
公投第１４案,彰化縣,彰化市,南瑤里,36,1097,227,404,631,15,646
公投第１４案,彰化縣,彰化市,南瑤里,37,1190,217,446,663,30,693
公投第１４案,彰化縣,彰化市,南瑤里,38,1106,227,431,658,36,694
公投第１４案,彰化縣,彰化市,南瑤里,39,1097,190,452,642,21,663
公投第１４案,彰化縣,彰化市,南瑤里,40,1048,199,409,608,33,641
公投第１４案,彰化縣,彰化市,南瑤里,41,980,190,389,579,33,612
公投第１４案,彰化縣,彰化市,成功里,42,707,139,294,433,15,448
公投第１４案,彰化縣,彰化市,成功里,43,809,160,306,466,25,491
公投第１４案,彰化縣,彰化市,福安里,44,1008,209,379,588,45,633
公投第１４案,彰化縣,彰化市,西安里,45,901,166,308,474,42,516
公投第１４案,彰化縣,彰化市,西安里,46,951,152,373,525,25,550
公投第１４案,彰化縣,彰化市,西安里,47,1076,225,391,616,31,647
公投第１４案,彰化縣,彰化市,彰安里,48,1022,179,364,543,23,566
公投第１４案,彰化縣,彰化市,彰安里,49,894,183,337,520,26,546
公投第１４案,彰化縣,彰化市,彰安里,50,1016,180,416,596,39,635
公投第１４案,彰化縣,彰化市,中央里,51,771,149,323,472,26,498
公投第１４案,彰化縣,彰化市,富貴里,52,868,170,334,504,31,535
公投第１４案,彰化縣,彰化市,民權里,53,1135,203,434,637,50,687
公投第１４案,彰化縣,彰化市,萬壽里,54,910,175,339,514,49,563
公投第１４案,彰化縣,彰化市,長樂里,55,1004,215,398,613,22,635
公投第１４案,彰化縣,彰化市,西興里,56,1077,420,213,633,40,673
公投第１４案,彰化縣,彰化市,西興里,57,1258,235,542,777,50,827
公投第１４案,彰化縣,彰化市,西興里,58,1025,194,440,634,21,655
公投第１４案,彰化縣,彰化市,西勢里,59,1177,222,477,699,47,746
公投第１４案,彰化縣,彰化市,西勢里,60,1262,209,486,695,27,722
公投第１４案,彰化縣,彰化市,西勢里,61,1209,205,510,715,37,752
公投第１４案,彰化縣,彰化市,忠權里,62,1041,206,417,623,38,661
公投第１４案,彰化縣,彰化市,忠權里,63,1075,166,487,653,28,681
公投第１４案,彰化縣,彰化市,忠權里,64,1029,158,393,551,38,589
公投第１４案,彰化縣,彰化市,忠孝里,65,1203,196,472,668,37,705
公投第１４案,彰化縣,彰化市,五權里,66,1014,164,395,559,33,592
公投第１４案,彰化縣,彰化市,五權里,67,1069,190,429,619,27,646
公投第１４案,彰化縣,彰化市,五權里,68,969,155,350,505,20,525
公投第１４案,彰化縣,彰化市,五權里,69,1105,162,413,575,21,596
公投第１４案,彰化縣,彰化市,平和里,70,981,166,430,596,36,632
公投第１４案,彰化縣,彰化市,平和里,71,1095,217,434,651,43,694
公投第１４案,彰化縣,彰化市,平和里,72,1087,175,479,654,25,679
公投第１４案,彰化縣,彰化市,平和里,73,1050,208,418,626,19,645
公投第１４案,彰化縣,彰化市,崙平里,74,1252,236,496,732,38,770
公投第１４案,彰化縣,彰化市,崙平里,75,1113,196,408,604,26,630
公投第１４案,彰化縣,彰化市,崙平里,76,1009,206,403,609,25,634
公投第１４案,彰化縣,彰化市,崙平里,77,999,162,381,543,36,579
公投第１４案,彰化縣,彰化市,崙平里,78,997,190,385,575,16,591
公投第１４案,彰化縣,彰化市,向陽里,79,1145,243,476,719,27,746
公投第１４案,彰化縣,彰化市,向陽里,80,1227,225,492,717,21,738
公投第１４案,彰化縣,彰化市,向陽里,81,1208,249,476,725,27,752
公投第１４案,彰化縣,彰化市,向陽里,82,1598,281,631,912,17,929
公投第１４案,彰化縣,彰化市,莿桐里,83,890,151,368,519,30,549
公投第１４案,彰化縣,彰化市,莿桐里,84,1104,215,460,675,31,706
公投第１４案,彰化縣,彰化市,莿桐里,85,1097,196,414,610,20,630
公投第１４案,彰化縣,彰化市,南美里,86,799,114,330,444,28,472
公投第１４案,彰化縣,彰化市,南美里,87,1000,160,422,582,38,620
公投第１４案,彰化縣,彰化市,南安里,88,1153,172,454,626,57,683
公投第１４案,彰化縣,彰化市,南安里,89,977,178,380,558,49,607
公投第１４案,彰化縣,彰化市,東芳里,90,1201,230,422,652,44,696
公投第１４案,彰化縣,彰化市,東芳里,91,1057,220,399,619,45,664
公投第１４案,彰化縣,彰化市,東芳里,92,1238,183,484,667,61,728
公投第１４案,彰化縣,彰化市,磚磘里,93,1210,189,518,707,40,747
公投第１４案,彰化縣,彰化市,磚磘里,94,1026,182,420,602,34,636
公投第１４案,彰化縣,彰化市,磚磘里,95,1061,213,446,659,35,694
公投第１４案,彰化縣,彰化市,卦山里,96,1213,230,452,682,43,725
公投第１４案,彰化縣,彰化市,卦山里,97,1264,275,470,745,30,775
公投第１４案,彰化縣,彰化市,光復里,98,691,159,286,445,24,469
公投第１４案,彰化縣,彰化市,永福里,99,893,172,373,545,31,576
公投第１４案,彰化縣,彰化市,光華里,100,733,129,295,424,33,457
公投第１４案,彰化縣,彰化市,中正里,101,692,119,296,415,30,445
公投第１４案,彰化縣,彰化市,中正里,102,728,147,263,410,28,438
公投第１４案,彰化縣,彰化市,中山里,103,773,162,317,479,22,501
公投第１４案,彰化縣,彰化市,龍山里,104,975,153,370,523,11,534
公投第１４案,彰化縣,彰化市,龍山里,105,908,150,372,522,34,556
公投第１４案,彰化縣,彰化市,新興里,106,1156,209,500,709,7,716
公投第１４案,彰化縣,彰化市,新興里,107,1235,211,505,716,38,754
公投第１４案,彰化縣,彰化市,新興里,108,1376,235,501,736,47,783
公投第１４案,彰化縣,彰化市,新興里,109,1389,249,520,769,12,781
公投第１４案,彰化縣,彰化市,新華里,110,846,151,380,531,29,560
公投第１４案,彰化縣,彰化市,新華里,111,859,401,137,538,22,560
公投第１４案,彰化縣,彰化市,興北里,112,781,163,300,463,21,484
公投第１４案,彰化縣,彰化市,興北里,113,875,156,336,492,32,524
公投第１４案,彰化縣,彰化市,信義里,114,816,137,327,464,23,487
公投第１４案,彰化縣,彰化市,民生里,115,687,122,285,407,32,439
公投第１４案,彰化縣,彰化市,民生里,116,727,148,297,445,30,475
公投第１４案,彰化縣,彰化市,文化里,117,662,125,277,402,23,425
公投第１４案,彰化縣,彰化市,文化里,118,633,103,286,389,17,406
公投第１４案,彰化縣,彰化市,陽明里,119,906,180,380,560,30,590
公投第１４案,彰化縣,彰化市,陽明里,120,853,129,334,463,32,495
公投第１４案,彰化縣,彰化市,萬安里,121,1027,195,426,621,27,648
公投第１４案,彰化縣,彰化市,萬安里,122,993,165,441,606,31,637
公投第１４案,彰化縣,彰化市,萬安里,123,848,141,356,497,29,526
公投第１４案,彰化縣,彰化市,萬安里,124,1118,215,474,689,18,707
公投第１４案,彰化縣,彰化市,下廍里,125,1263,230,506,736,33,769
公投第１４案,彰化縣,彰化市,下廍里,126,1268,219,543,762,39,801
公投第１４案,彰化縣,彰化市,下廍里,127,1258,202,534,736,33,769
公投第１４案,彰化縣,彰化市,下廍里,128,1212,223,514,737,22,759
公投第１４案,彰化縣,彰化市,茄苳里,129,924,160,375,535,38,573
公投第１４案,彰化縣,彰化市,茄南里,130,939,179,395,574,24,598
公投第１４案,彰化縣,彰化市,茄南里,131,953,189,405,594,48,642
公投第１４案,彰化縣,彰化市,茄南里,132,981,186,439,625,25,650
公投第１４案,彰化縣,彰化市,寶廍里,133,1249,205,540,745,47,792
公投第１４案,彰化縣,彰化市,古夷里,134,817,132,341,473,41,514
公投第１４案,彰化縣,彰化市,古夷里,135,872,168,337,505,28,533
公投第１４案,彰化縣,彰化市,古夷里,136,689,119,263,382,26,408
公投第１４案,彰化縣,彰化市,阿夷里,137,1156,201,500,701,26,727
公投第１４案,彰化縣,彰化市,阿夷里,138,1291,217,506,723,20,743
公投第１４案,彰化縣,彰化市,阿夷里,139,1139,181,466,647,22,669
公投第１４案,彰化縣,彰化市,阿夷里,140,1125,195,466,661,38,699
公投第１４案,彰化縣,彰化市,阿夷里,141,1258,186,494,680,43,723
公投第１４案,彰化縣,彰化市,阿夷里,142,1123,179,461,640,27,667
公投第１４案,彰化縣,彰化市,阿夷里,143,1175,200,467,667,37,704
公投第１４案,彰化縣,彰化市,和調里,144,862,158,387,545,26,571
公投第１４案,彰化縣,彰化市,和調里,145,872,176,336,512,18,530
公投第１４案,彰化縣,彰化市,和調里,146,897,159,395,554,25,579
公投第１４案,彰化縣,彰化市,復興里,147,1003,167,385,552,20,572
公投第１４案,彰化縣,彰化市,復興里,148,915,149,355,504,19,523
公投第１４案,彰化縣,彰化市,復興里,149,1158,207,429,636,32,668
公投第１４案,彰化縣,彰化市,復興里,150,1084,189,457,646,38,684
公投第１４案,彰化縣,彰化市,中庄里,151,1372,231,503,734,44,778
公投第１４案,彰化縣,彰化市,中庄里,152,1113,159,485,644,34,678
公投第１４案,彰化縣,彰化市,竹中里,153,800,116,362,478,29,507
公投第１４案,彰化縣,彰化市,竹中里,154,885,244,263,507,32,539
公投第１４案,彰化縣,彰化市,香山里,155,1000,198,410,608,19,627
公投第１４案,彰化縣,彰化市,香山里,156,1159,212,419,631,23,654
公投第１４案,彰化縣,彰化市,香山里,157,1123,186,426,612,31,643
公投第１４案,彰化縣,彰化市,牛埔里,158,907,179,381,560,43,603
公投第１４案,彰化縣,彰化市,牛埔里,159,989,154,366,520,42,562
公投第１４案,彰化縣,彰化市,牛埔里,160,1012,415,177,592,37,629
公投第１４案,彰化縣,彰化市,台鳳里,161,1033,152,398,550,20,570
公投第１４案,彰化縣,彰化市,台鳳里,162,1116,198,453,651,30,681
公投第１４案,彰化縣,彰化市,台鳳里,163,1154,193,499,692,20,712
公投第１４案,彰化縣,彰化市,台鳳里,164,1064,206,429,635,27,662
公投第１４案,彰化縣,彰化市,國聖里,165,770,131,339,470,35,505
公投第１４案,彰化縣,彰化市,國聖里,166,889,184,341,525,32,557
公投第１４案,彰化縣,彰化市,國聖里,167,786,117,338,455,47,502
公投第１４案,彰化縣,彰化市,福山里,168,1120,172,407,579,42,621
公投第１４案,彰化縣,彰化市,福山里,169,1269,209,460,669,33,702
公投第１４案,彰化縣,彰化市,福山里,170,1159,187,461,648,56,704
公投第１４案,彰化縣,彰化市,福山里,171,1184,180,491,671,56,727
公投第１４案,彰化縣,彰化市,福山里,172,1089,192,405,597,37,634
公投第１４案,彰化縣,彰化市,福山里,173,968,158,400,558,45,603
公投第１４案,彰化縣,彰化市,安溪里,174,930,148,371,519,27,546
公投第１４案,彰化縣,彰化市,安溪里,175,973,161,416,577,20,597
公投第１４案,彰化縣,彰化市,三村里,176,1184,188,402,590,24,614
公投第１４案,彰化縣,彰化市,大竹里,177,1002,177,388,565,52,617
公投第１４案,彰化縣,彰化市,大竹里,178,1148,177,456,633,21,654
公投第１４案,彰化縣,彰化市,大竹里,179,1112,170,450,620,26,646
公投第１４案,彰化縣,彰化市,田中里,180,907,159,425,584,38,622
公投第１４案,彰化縣,彰化市,快官里,181,1112,184,443,627,51,678
公投第１４案,彰化縣,彰化市,竹巷里,182,823,134,291,425,27,452
公投第１４案,彰化縣,彰化市,福田里,183,1276,209,494,703,53,756
公投第１４案,彰化縣,彰化市,石牌里,184,1161,172,461,633,30,663
公投第１４案,彰化縣,花壇鄉,花壇村,185,901,144,374,518,32,550
公投第１４案,彰化縣,花壇鄉,花壇村,186,1042,206,417,623,30,653
公投第１４案,彰化縣,花壇鄉,花壇村,187,1314,226,478,704,14,718
公投第１４案,彰化縣,花壇鄉,金墩村,188,808,111,350,461,36,497
公投第１４案,彰化縣,花壇鄉,金墩村,189,1019,150,403,553,35,588
公投第１４案,彰化縣,花壇鄉,中庄村,190,1144,188,472,660,50,710
公投第１４案,彰化縣,花壇鄉,中庄村,191,1240,162,489,651,87,738
公投第１４案,彰化縣,花壇鄉,崙雅村,192,1425,192,634,826,54,880
公投第１４案,彰化縣,花壇鄉,劉厝村,193,1095,180,480,660,45,705
公投第１４案,彰化縣,花壇鄉,南口村,194,910,143,376,519,28,547
公投第１４案,彰化縣,花壇鄉,南口村,195,982,172,325,497,21,518
公投第１４案,彰化縣,花壇鄉,北口村,196,1070,185,410,595,18,613
公投第１４案,彰化縣,花壇鄉,北口村,197,700,122,243,365,19,384
公投第１４案,彰化縣,花壇鄉,中口村,198,764,148,330,478,28,506
公投第１４案,彰化縣,花壇鄉,文德村,199,953,166,402,568,37,605
公投第１４案,彰化縣,花壇鄉,文德村,200,974,159,380,539,18,557
公投第１４案,彰化縣,花壇鄉,文德村,201,1111,169,429,598,49,647
公投第１４案,彰化縣,花壇鄉,白沙村,202,1101,153,471,624,50,674
公投第１４案,彰化縣,花壇鄉,白沙村,203,1110,149,439,588,33,621
公投第１４案,彰化縣,花壇鄉,白沙村,204,1262,219,472,691,45,736
公投第１４案,彰化縣,花壇鄉,白沙村,205,1103,223,403,626,27,653
公投第１４案,彰化縣,花壇鄉,岩竹村,206,1347,191,469,660,47,707
公投第１４案,彰化縣,花壇鄉,長沙村,207,1169,153,438,591,43,634
公投第１４案,彰化縣,花壇鄉,長沙村,208,1274,201,531,732,36,768
公投第１４案,彰化縣,花壇鄉,長沙村,209,1280,180,576,756,30,786
公投第１４案,彰化縣,花壇鄉,長沙村,210,1244,174,524,698,32,730
公投第１４案,彰化縣,花壇鄉,橋頭村,211,1159,452,190,642,41,683
公投第１４案,彰化縣,花壇鄉,橋頭村,212,1042,181,441,622,36,658
公投第１４案,彰化縣,花壇鄉,橋頭村,213,1111,154,435,589,42,631
公投第１４案,彰化縣,花壇鄉,灣雅村,214,893,140,385,525,44,569
公投第１４案,彰化縣,花壇鄉,灣東村,215,953,147,367,514,53,567
公投第１４案,彰化縣,花壇鄉,三春村,216,987,169,340,509,30,539
公投第１４案,彰化縣,花壇鄉,三春村,217,925,163,396,559,45,604
公投第１４案,彰化縣,花壇鄉,永春村,218,951,110,411,521,31,552
公投第１４案,彰化縣,花壇鄉,永春村,219,955,138,380,518,27,545
公投第１４案,彰化縣,花壇鄉,長春村,220,895,134,368,502,16,518
公投第１４案,彰化縣,花壇鄉,長春村,221,711,102,301,403,18,421
公投第１４案,彰化縣,芬園鄉,舊社村,222,958,126,373,499,37,536
公投第１４案,彰化縣,芬園鄉,舊社村,223,794,134,289,423,36,459
公投第１４案,彰化縣,芬園鄉,大埔村,224,1415,275,398,673,74,747
公投第１４案,彰化縣,芬園鄉,竹林村,225,927,392,146,538,27,565
公投第１４案,彰化縣,芬園鄉,竹林村,226,831,110,331,441,33,474
公投第１４案,彰化縣,芬園鄉,楓坑村,227,570,96,219,315,17,332
公投第１４案,彰化縣,芬園鄉,社口村,228,1227,200,414,614,42,656
公投第１４案,彰化縣,芬園鄉,社口村,229,1238,161,471,632,51,683
公投第１４案,彰化縣,芬園鄉,茄荖村,230,1362,206,517,723,64,787
公投第１４案,彰化縣,芬園鄉,茄荖村,231,989,142,382,524,65,589
公投第１４案,彰化縣,芬園鄉,嘉興村,232,1054,209,454,663,8,671
公投第１４案,彰化縣,芬園鄉,嘉興村,233,607,97,276,373,25,398
公投第１４案,彰化縣,芬園鄉,芬園村,234,882,117,374,491,41,532
公投第１４案,彰化縣,芬園鄉,縣庄村,235,1143,141,389,530,31,561
公投第１４案,彰化縣,芬園鄉,圳墘村,236,661,78,237,315,13,328
公投第１４案,彰化縣,芬園鄉,溪頭村,237,838,102,314,416,7,423
公投第１４案,彰化縣,芬園鄉,溪頭村,238,847,128,294,422,24,446
公投第１４案,彰化縣,芬園鄉,進芬村,239,987,140,407,547,45,592
公投第１４案,彰化縣,芬園鄉,同安村,240,1217,173,420,593,50,643
公投第１４案,彰化縣,芬園鄉,中崙村,241,865,104,308,412,43,455
公投第１４案,彰化縣,芬園鄉,大竹村,242,996,144,328,472,42,514
公投第１４案,彰化縣,鹿港鎮,大有里,243,1140,219,455,674,44,718
公投第１４案,彰化縣,鹿港鎮,中興里,244,511,100,187,287,18,305
公投第１４案,彰化縣,鹿港鎮,洛津里,245,857,131,276,407,22,429
公投第１４案,彰化縣,鹿港鎮,順興里,246,946,162,402,564,43,607
公投第１４案,彰化縣,鹿港鎮,埔崙里,247,945,162,370,532,32,564
公投第１４案,彰化縣,鹿港鎮,埔崙里,248,1097,174,445,619,36,655
公投第１４案,彰化縣,鹿港鎮,埔崙里,249,1479,236,470,706,29,735
公投第１４案,彰化縣,鹿港鎮,埔崙里,250,1425,230,580,810,48,858
公投第１４案,彰化縣,鹿港鎮,新宮里,251,880,153,352,505,52,557
公投第１４案,彰化縣,鹿港鎮,玉順里,252,1183,186,443,629,40,669
公投第１４案,彰化縣,鹿港鎮,東石里,253,1047,167,431,598,45,643
公投第１４案,彰化縣,鹿港鎮,東石里,254,1097,173,416,589,21,610
公投第１４案,彰化縣,鹿港鎮,東石里,255,1030,155,388,543,50,593
公投第１４案,彰化縣,鹿港鎮,東石里,256,1161,172,464,636,37,673
公投第１４案,彰化縣,鹿港鎮,郭厝里,257,540,89,214,303,38,341
公投第１４案,彰化縣,鹿港鎮,永安里,258,1135,223,381,604,44,648
公投第１４案,彰化縣,鹿港鎮,永安里,259,1155,168,455,623,48,671
公投第１４案,彰化縣,鹿港鎮,永安里,260,1127,212,450,662,36,698
公投第１４案,彰化縣,鹿港鎮,永安里,261,1045,166,417,583,38,621
公投第１４案,彰化縣,鹿港鎮,景福里,262,1127,174,443,617,49,666
公投第１４案,彰化縣,鹿港鎮,泰興里,263,1178,219,501,720,37,757
公投第１４案,彰化縣,鹿港鎮,長興里,264,284,43,114,157,12,169
公投第１４案,彰化縣,鹿港鎮,興化里,265,584,101,220,321,26,347
公投第１４案,彰化縣,鹿港鎮,龍山里,266,659,114,291,405,30,435
公投第１４案,彰化縣,鹿港鎮,菜園里,267,915,276,251,527,20,547
公投第１４案,彰化縣,鹿港鎮,街尾里,268,1079,194,438,632,49,681
公投第１４案,彰化縣,鹿港鎮,街尾里,269,1129,207,468,675,57,732
公投第１４案,彰化縣,鹿港鎮,詔安里,270,1273,154,509,663,43,706
公投第１４案,彰化縣,鹿港鎮,詔安里,271,706,87,263,350,29,379
公投第１４案,彰化縣,鹿港鎮,海埔里,272,1137,191,361,552,79,631
公投第１４案,彰化縣,鹿港鎮,海埔里,273,1195,185,438,623,39,662
公投第１４案,彰化縣,鹿港鎮,海埔里,274,1225,173,437,610,52,662
公投第１４案,彰化縣,鹿港鎮,洋厝里,275,957,158,429,587,43,630
公投第１４案,彰化縣,鹿港鎮,洋厝里,276,758,84,276,360,48,408
公投第１４案,彰化縣,鹿港鎮,洋厝里,277,723,98,299,397,41,438
公投第１４案,彰化縣,鹿港鎮,草中里,278,984,142,379,521,26,547
公投第１４案,彰化縣,鹿港鎮,草中里,279,1018,139,447,586,33,619
公投第１４案,彰化縣,鹿港鎮,草中里,280,1165,175,435,610,35,645
公投第１４案,彰化縣,鹿港鎮,頭南里,281,1161,145,410,555,59,614
公投第１４案,彰化縣,鹿港鎮,頭南里,282,1020,141,373,514,46,560
公投第１４案,彰化縣,鹿港鎮,山崙里,283,1068,135,419,554,52,606
公投第１４案,彰化縣,鹿港鎮,山崙里,284,1024,153,442,595,30,625
公投第１４案,彰化縣,鹿港鎮,山崙里,285,974,155,384,539,64,603
公投第１４案,彰化縣,鹿港鎮,頂番里,286,1505,228,527,755,64,819
公投第１４案,彰化縣,鹿港鎮,頂番里,287,1092,158,397,555,50,605
公投第１４案,彰化縣,鹿港鎮,頂番里,288,1223,188,503,691,51,742
公投第１４案,彰化縣,鹿港鎮,頭崙里,289,1572,194,564,758,35,793
公投第１４案,彰化縣,鹿港鎮,頭崙里,290,1003,162,419,581,37,618
公投第１４案,彰化縣,鹿港鎮,溝墘里,291,933,138,390,528,31,559
公投第１４案,彰化縣,鹿港鎮,溝墘里,292,1093,173,451,624,39,663
公投第１４案,彰化縣,鹿港鎮,溝墘里,293,907,148,350,498,17,515
公投第１４案,彰化縣,鹿港鎮,溝墘里,294,1219,161,466,627,45,672
公投第１４案,彰化縣,鹿港鎮,廖厝里,295,1397,210,629,839,41,880
公投第１４案,彰化縣,鹿港鎮,廖厝里,296,1229,172,507,679,37,716
公投第１４案,彰化縣,鹿港鎮,廖厝里,297,1444,161,591,752,45,797
公投第１４案,彰化縣,鹿港鎮,東崎里,298,1227,184,509,693,43,736
公投第１４案,彰化縣,鹿港鎮,東崎里,299,1187,166,500,666,50,716
公投第１４案,彰化縣,鹿港鎮,東崎里,300,1296,184,496,680,34,714
公投第１４案,彰化縣,鹿港鎮,東崎里,301,1451,235,479,714,42,756
公投第１４案,彰化縣,鹿港鎮,頂厝里,302,1299,204,471,675,58,733
公投第１４案,彰化縣,鹿港鎮,頂厝里,303,1298,212,562,774,30,804
公投第１４案,彰化縣,鹿港鎮,頂厝里,304,1458,216,590,806,34,840
公投第１４案,彰化縣,鹿港鎮,頂厝里,305,1138,195,440,635,51,686
公投第１４案,彰化縣,鹿港鎮,頂厝里,306,1170,196,439,635,50,685
公投第１４案,彰化縣,鹿港鎮,頂厝里,307,1221,183,540,723,20,743
公投第１４案,彰化縣,福興鄉,三汴村,308,1363,256,439,695,50,745
公投第１４案,彰化縣,福興鄉,萬豐村,309,821,114,329,443,25,468
公投第１４案,彰化縣,福興鄉,元中村,310,1256,173,436,609,54,663
公投第１４案,彰化縣,福興鄉,外中村,311,1166,175,388,563,76,639
公投第１４案,彰化縣,福興鄉,外埔村,312,1464,190,523,713,50,763
公投第１４案,彰化縣,福興鄉,大崙村,313,1251,185,436,621,41,662
公投第１４案,彰化縣,福興鄉,番婆村,314,1465,212,514,726,53,779
公投第１４案,彰化縣,福興鄉,番婆村,315,960,125,328,453,27,480
公投第１４案,彰化縣,福興鄉,橋頭村,316,1323,218,440,658,59,717
公投第１４案,彰化縣,福興鄉,橋頭村,317,1365,211,500,711,43,754
公投第１４案,彰化縣,福興鄉,社尾村,318,1458,186,456,642,30,672
公投第１４案,彰化縣,福興鄉,番社村,319,1492,198,529,727,58,785
公投第１４案,彰化縣,福興鄉,西勢村,320,888,134,310,444,21,465
公投第１４案,彰化縣,福興鄉,西勢村,321,1054,183,398,581,53,634
公投第１４案,彰化縣,福興鄉,同安村,322,1043,140,341,481,39,520
公投第１４案,彰化縣,福興鄉,同安村,323,1340,182,499,681,63,744
公投第１４案,彰化縣,福興鄉,秀厝村,324,1085,182,349,531,44,575
公投第１４案,彰化縣,福興鄉,秀厝村,325,1392,195,508,703,37,740
公投第１４案,彰化縣,福興鄉,福興村,326,1316,188,524,712,63,775
公投第１４案,彰化縣,福興鄉,福興村,327,1255,185,532,717,36,753
公投第１４案,彰化縣,福興鄉,福興村,328,1101,169,473,642,34,676
公投第１４案,彰化縣,福興鄉,福南村,329,1167,154,445,599,57,656
公投第１４案,彰化縣,福興鄉,福南村,330,1393,188,495,683,53,736
公投第１４案,彰化縣,福興鄉,鎮平村,331,1216,175,483,658,39,697
公投第１４案,彰化縣,福興鄉,三和村,332,1063,143,393,536,37,573
公投第１４案,彰化縣,福興鄉,二港村,333,1306,194,477,671,35,706
公投第１４案,彰化縣,福興鄉,福寶村,334,1287,157,398,555,44,599
公投第１４案,彰化縣,福興鄉,頂粘村,335,994,134,390,524,35,559
公投第１４案,彰化縣,福興鄉,頂粘村,336,1311,177,506,683,61,744
公投第１４案,彰化縣,福興鄉,廈粘村,337,926,109,412,521,33,554
公投第１４案,彰化縣,福興鄉,廈粘村,338,995,146,339,485,36,521
公投第１４案,彰化縣,福興鄉,麥厝村,339,1079,151,453,604,66,670
公投第１４案,彰化縣,福興鄉,麥厝村,340,1150,141,400,541,65,606
公投第１４案,彰化縣,秀水鄉,秀水村,341,1066,163,445,608,62,670
公投第１４案,彰化縣,秀水鄉,秀水村,342,620,108,254,362,35,397
公投第１４案,彰化縣,秀水鄉,安溪村,343,876,131,304,435,12,447
公投第１４案,彰化縣,秀水鄉,安溪村,344,1196,208,499,707,30,737
公投第１４案,彰化縣,秀水鄉,莊雅村,345,1369,232,528,760,30,790
公投第１４案,彰化縣,秀水鄉,莊雅村,346,1273,197,516,713,44,757
公投第１４案,彰化縣,秀水鄉,陝西村,347,1433,200,567,767,36,803
公投第１４案,彰化縣,秀水鄉,金興村,348,967,173,379,552,24,576
公投第１４案,彰化縣,秀水鄉,金興村,349,921,149,377,526,20,546
公投第１４案,彰化縣,秀水鄉,安東村,350,689,111,300,411,23,434
公投第１４案,彰化縣,秀水鄉,安東村,351,688,209,176,385,34,419
公投第１４案,彰化縣,秀水鄉,安東村,352,1252,243,490,733,50,783
公投第１４案,彰化縣,秀水鄉,安東村,353,1281,216,460,676,32,708
公投第１４案,彰化縣,秀水鄉,鶴鳴村,354,754,107,291,398,28,426
公投第１４案,彰化縣,秀水鄉,鶴鳴村,355,1024,188,358,546,41,587
公投第１４案,彰化縣,秀水鄉,鶴鳴村,356,1433,206,549,755,28,783
公投第１４案,彰化縣,秀水鄉,馬興村,357,1366,230,598,828,55,883
公投第１４案,彰化縣,秀水鄉,馬興村,358,895,131,372,503,43,546
公投第１４案,彰化縣,秀水鄉,義興村,359,1386,214,497,711,44,755
公投第１４案,彰化縣,秀水鄉,福安村,360,896,146,340,486,59,545
公投第１４案,彰化縣,秀水鄉,福安村,361,804,151,358,509,26,535
公投第１４案,彰化縣,秀水鄉,福安村,362,827,123,379,502,20,522
公投第１４案,彰化縣,秀水鄉,福安村,363,996,173,382,555,39,594
公投第１４案,彰化縣,秀水鄉,福安村,364,931,165,407,572,48,620
公投第１４案,彰化縣,秀水鄉,埔崙村,365,715,119,259,378,28,406
公投第１４案,彰化縣,秀水鄉,埔崙村,366,1229,187,531,718,51,769
公投第１４案,彰化縣,秀水鄉,曾厝村,367,890,121,318,439,25,464
公投第１４案,彰化縣,秀水鄉,曾厝村,368,811,146,331,477,32,509
公投第１４案,彰化縣,秀水鄉,金陵村,369,786,124,332,456,31,487
公投第１４案,彰化縣,秀水鄉,金陵村,370,931,133,381,514,28,542
公投第１４案,彰化縣,秀水鄉,下崙村,371,1265,213,503,716,57,773
公投第１４案,彰化縣,秀水鄉,下崙村,372,824,122,299,421,42,463
公投第１４案,彰化縣,和美鎮,竹營里,373,1341,230,471,701,36,737
公投第１４案,彰化縣,和美鎮,竹營里,374,1480,263,462,725,47,772
公投第１４案,彰化縣,和美鎮,竹營里,375,1529,239,584,823,37,860
公投第１４案,彰化縣,和美鎮,竹營里,376,1711,264,599,863,15,878
公投第１４案,彰化縣,和美鎮,和東里,377,1057,184,400,584,32,616
公投第１４案,彰化縣,和美鎮,和東里,378,1032,227,365,592,28,620
公投第１４案,彰化縣,和美鎮,和東里,379,1015,160,429,589,34,623
公投第１４案,彰化縣,和美鎮,和東里,380,1209,214,477,691,33,724
公投第１４案,彰化縣,和美鎮,和南里,381,430,102,133,235,15,250
公投第１４案,彰化縣,和美鎮,和北里,382,856,142,329,471,13,484
公投第１４案,彰化縣,和美鎮,和北里,383,966,146,404,550,29,579
公投第１４案,彰化縣,和美鎮,和西里,384,1059,171,383,554,28,582
公投第１４案,彰化縣,和美鎮,和西里,385,1117,202,409,611,27,638
公投第１４案,彰化縣,和美鎮,和西里,386,1066,167,389,556,37,593
公投第１４案,彰化縣,和美鎮,四張里,387,1252,196,438,634,50,684
公投第１４案,彰化縣,和美鎮,四張里,388,1528,235,526,761,45,806
公投第１４案,彰化縣,和美鎮,頭前里,389,826,162,308,470,26,496
公投第１４案,彰化縣,和美鎮,頭前里,390,854,114,346,460,24,484
公投第１４案,彰化縣,和美鎮,面前里,391,1387,202,498,700,45,745
公投第１４案,彰化縣,和美鎮,面前里,392,765,117,351,468,12,480
公投第１４案,彰化縣,和美鎮,鎮平里,393,1438,193,520,713,41,754
公投第１４案,彰化縣,和美鎮,鎮平里,394,1396,227,555,782,49,831
公投第１４案,彰化縣,和美鎮,大霞里,395,658,101,271,372,15,387
公投第１４案,彰化縣,和美鎮,大霞里,396,809,140,352,492,23,515
公投第１４案,彰化縣,和美鎮,源埤里,397,932,151,334,485,13,498
公投第１４案,彰化縣,和美鎮,源埤里,398,888,137,324,461,26,487
公投第１４案,彰化縣,和美鎮,南佃里,399,1144,172,499,671,31,702
公投第１４案,彰化縣,和美鎮,南佃里,400,1077,158,430,588,27,615
公投第１４案,彰化縣,和美鎮,雅溝里,401,1349,217,443,660,50,710
公投第１４案,彰化縣,和美鎮,山犁里,402,1155,489,195,684,38,722
公投第１４案,彰化縣,和美鎮,山犁里,403,1253,181,483,664,34,698
公投第１４案,彰化縣,和美鎮,山犁里,404,1252,176,482,658,33,691
公投第１４案,彰化縣,和美鎮,山犁里,405,1474,239,532,771,30,801
公投第１４案,彰化縣,和美鎮,仁愛里,406,1396,203,491,694,21,715
公投第１４案,彰化縣,和美鎮,仁愛里,407,1348,210,495,705,29,734
公投第１４案,彰化縣,和美鎮,嘉犁里,408,999,148,453,601,22,623
公投第１４案,彰化縣,和美鎮,嘉犁里,409,911,138,370,508,35,543
公投第１４案,彰化縣,和美鎮,詔安里,410,1005,189,377,566,29,595
公投第１４案,彰化縣,和美鎮,詔安里,411,967,149,384,533,32,565
公投第１４案,彰化縣,和美鎮,鐵山里,412,1308,186,544,730,38,768
公投第１４案,彰化縣,和美鎮,鐵山里,413,1324,209,502,711,40,751
公投第１４案,彰化縣,和美鎮,柑井里,414,1102,187,425,612,46,658
公投第１４案,彰化縣,和美鎮,柑井里,415,1124,169,399,568,51,619
公投第１４案,彰化縣,和美鎮,柑井里,416,1211,266,401,667,38,705
公投第１４案,彰化縣,和美鎮,竹園里,417,884,152,402,554,39,593
公投第１４案,彰化縣,和美鎮,新庄里,418,1119,167,436,603,47,650
公投第１４案,彰化縣,和美鎮,新庄里,419,1300,226,479,705,30,735
公投第１４案,彰化縣,和美鎮,犁盛里,420,1104,165,413,578,26,604
公投第１４案,彰化縣,和美鎮,犁盛里,421,1213,201,503,704,37,741
公投第１４案,彰化縣,和美鎮,中寮里,422,1127,162,373,535,43,578
公投第１４案,彰化縣,和美鎮,中圍里,423,919,144,345,489,38,527
公投第１４案,彰化縣,和美鎮,中圍里,424,987,151,398,549,45,594
公投第１４案,彰化縣,和美鎮,中圍里,425,958,151,405,556,36,592
公投第１４案,彰化縣,和美鎮,糖友里,426,1362,214,548,762,33,795
公投第１４案,彰化縣,和美鎮,糖友里,427,1461,242,549,791,23,814
公投第１４案,彰化縣,和美鎮,糖友里,428,1405,242,545,787,23,810
公投第１４案,彰化縣,和美鎮,還社里,429,860,146,345,491,29,520
公投第１４案,彰化縣,和美鎮,塗厝里,430,875,119,355,474,19,493
公投第１４案,彰化縣,和美鎮,塗厝里,431,871,147,330,477,30,507
公投第１４案,彰化縣,和美鎮,地潭里,432,883,140,379,519,32,551
公投第１４案,彰化縣,和美鎮,湖內里,433,1224,218,418,636,52,688
公投第１４案,彰化縣,和美鎮,嘉寶里,434,1075,172,392,564,39,603
公投第１４案,彰化縣,和美鎮,嘉寶里,435,956,155,360,515,29,544
公投第１４案,彰化縣,和美鎮,月眉里,436,1037,162,381,543,38,581
公投第１４案,彰化縣,和美鎮,月眉里,437,1011,176,380,556,22,578
公投第１４案,彰化縣,和美鎮,月眉里,438,1023,177,366,543,37,580
公投第１４案,彰化縣,和美鎮,好修里,439,719,103,272,375,21,396
公投第１４案,彰化縣,和美鎮,好修里,440,913,136,344,480,36,516
公投第１４案,彰化縣,伸港鄉,大同村,441,1182,169,398,567,39,606
公投第１４案,彰化縣,伸港鄉,大同村,442,1166,191,497,688,32,720
公投第１４案,彰化縣,伸港鄉,海尾村,443,966,152,378,530,34,564
公投第１４案,彰化縣,伸港鄉,海尾村,444,873,142,316,458,32,490
公投第１４案,彰化縣,伸港鄉,全興村,445,812,119,339,458,34,492
公投第１４案,彰化縣,伸港鄉,全興村,446,875,118,338,456,35,491
公投第１４案,彰化縣,伸港鄉,溪底村,447,904,147,330,477,36,513
公投第１４案,彰化縣,伸港鄉,溪底村,448,1008,160,360,520,40,560
公投第１４案,彰化縣,伸港鄉,定興村,449,1154,191,451,642,43,685
公投第１４案,彰化縣,伸港鄉,定興村,450,1486,225,500,725,57,782
公投第１４案,彰化縣,伸港鄉,什股村,451,1095,145,426,571,39,610
公投第１４案,彰化縣,伸港鄉,什股村,452,1087,141,399,540,16,556
公投第１４案,彰化縣,伸港鄉,泉州村,453,1085,172,421,593,55,648
公投第１４案,彰化縣,伸港鄉,泉州村,454,908,158,358,516,27,543
公投第１４案,彰化縣,伸港鄉,泉厝村,455,1264,200,537,737,38,775
公投第１４案,彰化縣,伸港鄉,曾家村,456,854,127,302,429,46,475
公投第１４案,彰化縣,伸港鄉,曾家村,457,846,104,296,400,27,427
公投第１４案,彰化縣,伸港鄉,蚵寮村,458,1143,153,375,528,82,610
公投第１４案,彰化縣,伸港鄉,新港村,459,1357,237,498,735,28,763
公投第１４案,彰化縣,伸港鄉,新港村,460,1349,208,492,700,52,752
公投第１４案,彰化縣,伸港鄉,新港村,461,1154,175,457,632,47,679
公投第１４案,彰化縣,伸港鄉,新港村,462,1279,224,446,670,26,696
公投第１４案,彰化縣,伸港鄉,埤墘村,463,1317,230,492,722,52,774
公投第１４案,彰化縣,伸港鄉,七嘉村,464,990,162,407,569,38,607
公投第１４案,彰化縣,伸港鄉,七嘉村,465,852,152,324,476,32,508
公投第１４案,彰化縣,伸港鄉,七嘉村,466,1178,146,526,672,13,685
公投第１４案,彰化縣,伸港鄉,汴頭村,467,1088,141,411,552,67,619
公投第１４案,彰化縣,伸港鄉,汴頭村,468,1135,201,390,591,56,647
公投第１４案,彰化縣,線西鄉,線西村,469,1071,166,424,590,27,617
公投第１４案,彰化縣,線西鄉,線西村,470,1166,207,469,676,23,699
公投第１４案,彰化縣,線西鄉,頂庄村,471,1269,194,504,698,58,756
公投第１４案,彰化縣,線西鄉,寓埔村,472,1138,170,444,614,39,653
公投第１４案,彰化縣,線西鄉,寓埔村,473,1128,178,494,672,50,722
公投第１４案,彰化縣,線西鄉,塭仔村,474,1275,187,521,708,60,768
公投第１４案,彰化縣,線西鄉,溝內村,475,1187,203,460,663,45,708
公投第１４案,彰化縣,線西鄉,下犁村,476,991,140,409,549,54,603
公投第１４案,彰化縣,線西鄉,下犁村,477,938,148,368,516,48,564
公投第１４案,彰化縣,線西鄉,頂犁村,478,1276,175,464,639,49,688
公投第１４案,彰化縣,線西鄉,頂犁村,479,1285,181,527,708,51,759
公投第１４案,彰化縣,線西鄉,德興村,480,1341,591,200,791,57,848
公投第１４案,彰化縣,員林市,崙雅里,481,1087,118,430,548,23,571
公投第１４案,彰化縣,員林市,崙雅里,482,1353,200,487,687,22,709
公投第１４案,彰化縣,員林市,振興里,483,1313,203,454,657,46,703
公投第１４案,彰化縣,員林市,振興里,484,1328,161,457,618,22,640
公投第１４案,彰化縣,員林市,林厝里,485,1055,186,388,574,26,600
公投第１４案,彰化縣,員林市,林厝里,486,959,150,349,499,30,529
公投第１４案,彰化縣,員林市,林厝里,487,772,120,286,406,45,451
公投第１４案,彰化縣,員林市,出水里,488,831,132,339,471,38,509
公投第１４案,彰化縣,員林市,出水里,489,854,97,266,363,13,376
公投第１４案,彰化縣,員林市,湖水里,490,1190,130,381,511,33,544
公投第１４案,彰化縣,員林市,大峯里,491,726,93,286,379,19,398
公投第１４案,彰化縣,員林市,鎮興里,492,1124,100,505,605,29,634
公投第１４案,彰化縣,員林市,鎮興里,493,860,137,282,419,35,454
公投第１４案,彰化縣,員林市,浮圳里,494,1122,197,467,664,31,695
公投第１４案,彰化縣,員林市,浮圳里,495,1075,166,438,604,36,640
公投第１４案,彰化縣,員林市,西東里,496,993,125,379,504,46,550
公投第１４案,彰化縣,員林市,西東里,497,967,121,378,499,33,532
公投第１４案,彰化縣,員林市,南東里,498,1008,172,372,544,38,582
公投第１４案,彰化縣,員林市,南東里,499,804,120,300,420,38,458
公投第１４案,彰化縣,員林市,中東里,500,867,140,321,461,23,484
公投第１４案,彰化縣,員林市,中東里,501,885,134,337,471,16,487
公投第１４案,彰化縣,員林市,東北里,502,1097,147,368,515,16,531
公投第１４案,彰化縣,員林市,東北里,503,1255,207,452,659,25,684
公投第１４案,彰化縣,員林市,東和里,504,1063,179,408,587,31,618
公投第１４案,彰化縣,員林市,民生里,505,925,413,87,500,19,519
公投第１４案,彰化縣,員林市,民生里,506,947,152,374,526,33,559
公投第１４案,彰化縣,員林市,民生里,507,916,133,391,524,21,545
公投第１４案,彰化縣,員林市,黎明里,508,862,141,316,457,26,483
公投第１４案,彰化縣,員林市,黎明里,509,987,170,378,548,16,564
公投第１４案,彰化縣,員林市,惠來里,510,1085,135,403,538,39,577
公投第１４案,彰化縣,員林市,惠來里,511,1110,178,435,613,21,634
公投第１４案,彰化縣,員林市,惠來里,512,1095,166,387,553,25,578
公投第１４案,彰化縣,員林市,惠來里,513,1278,244,509,753,32,785
公投第１４案,彰化縣,員林市,惠來里,514,1109,169,450,619,36,655
公投第１４案,彰化縣,員林市,中央里,515,1055,144,407,551,52,603
公投第１４案,彰化縣,員林市,中央里,516,876,163,311,474,39,513
公投第１４案,彰化縣,員林市,溝皂里,517,1115,168,362,530,26,556
公投第１４案,彰化縣,員林市,溝皂里,518,1186,205,460,665,24,689
公投第１４案,彰化縣,員林市,大饒里,519,995,170,395,565,36,601
公投第１４案,彰化縣,員林市,大饒里,520,999,151,385,536,18,554
公投第１４案,彰化縣,員林市,大饒里,521,1201,186,453,639,23,662
公投第１４案,彰化縣,員林市,大明里,522,1342,188,514,702,33,735
公投第１４案,彰化縣,員林市,大明里,523,1086,171,393,564,27,591
公投第１４案,彰化縣,員林市,萬年里,524,854,117,306,423,31,454
公投第１４案,彰化縣,員林市,萬年里,525,1064,167,417,584,26,610
公投第１４案,彰化縣,員林市,萬年里,526,879,163,355,518,8,526
公投第１４案,彰化縣,員林市,萬年里,527,827,164,381,545,18,563
公投第１４案,彰化縣,員林市,中正里,528,867,140,330,470,13,483
公投第１４案,彰化縣,員林市,中正里,529,1201,192,461,653,28,681
公投第１４案,彰化縣,員林市,中正里,530,1106,192,425,617,28,645
公投第１４案,彰化縣,員林市,仁美里,531,845,132,344,476,31,507
公投第１４案,彰化縣,員林市,仁美里,532,894,168,331,499,28,527
公投第１４案,彰化縣,員林市,仁美里,533,849,149,330,479,25,504
公投第１４案,彰化縣,員林市,新興里,534,747,155,294,449,24,473
公投第１４案,彰化縣,員林市,和平里,535,884,179,342,521,29,550
公投第１４案,彰化縣,員林市,和平里,536,900,134,319,453,27,480
公投第１４案,彰化縣,員林市,和平里,537,1040,138,391,529,19,548
公投第１４案,彰化縣,員林市,光明里,538,831,147,291,438,18,456
公投第１４案,彰化縣,員林市,中山里,539,591,121,239,360,29,389
公投第１４案,彰化縣,員林市,三條里,540,1330,210,486,696,24,720
公投第１４案,彰化縣,員林市,三條里,541,1295,222,485,707,27,734
公投第１４案,彰化縣,員林市,忠孝里,542,1283,206,454,660,56,716
公投第１４案,彰化縣,員林市,忠孝里,543,943,158,394,552,22,574
公投第１４案,彰化縣,員林市,仁愛里,544,1388,277,544,821,42,863
公投第１４案,彰化縣,員林市,三和里,545,1176,195,464,659,29,688
公投第１４案,彰化縣,員林市,三和里,546,867,132,300,432,9,441
公投第１４案,彰化縣,員林市,三和里,547,1121,211,381,592,27,619
公投第１４案,彰化縣,員林市,三和里,548,1190,195,405,600,29,629
公投第１４案,彰化縣,員林市,三和里,549,945,130,401,531,34,565
公投第１４案,彰化縣,員林市,三和里,550,906,146,378,524,21,545
公投第１４案,彰化縣,員林市,三橋里,551,978,176,392,568,32,600
公投第１４案,彰化縣,員林市,三橋里,552,949,152,373,525,32,557
公投第１４案,彰化縣,員林市,三橋里,553,949,142,392,534,39,573
公投第１４案,彰化縣,員林市,三愛里,554,1006,162,389,551,24,575
公投第１４案,彰化縣,員林市,三愛里,555,889,165,330,495,33,528
公投第１４案,彰化縣,員林市,三愛里,556,923,173,380,553,17,570
公投第１４案,彰化縣,員林市,三信里,557,1209,215,493,708,38,746
公投第１４案,彰化縣,員林市,三信里,558,1075,170,450,620,29,649
公投第１４案,彰化縣,員林市,三多里,559,1342,254,537,791,36,827
公投第１４案,彰化縣,員林市,三多里,560,1039,236,427,663,30,693
公投第１４案,彰化縣,員林市,三義里,561,1131,173,399,572,60,632
公投第１４案,彰化縣,員林市,三義里,562,1356,214,465,679,25,704
公投第１４案,彰化縣,員林市,新生里,563,1370,249,486,735,45,780
公投第１４案,彰化縣,員林市,新生里,564,1090,202,398,600,34,634
公投第１４案,彰化縣,員林市,新生里,565,821,171,343,514,19,533
公投第１４案,彰化縣,員林市,新生里,566,910,352,165,517,26,543
公投第１４案,彰化縣,員林市,南平里,567,1203,182,479,661,22,683
公投第１４案,彰化縣,員林市,南平里,568,1378,248,494,742,30,772
公投第１４案,彰化縣,員林市,南平里,569,1352,193,542,735,38,773
公投第１４案,彰化縣,員林市,南平里,570,1060,191,438,629,29,658
公投第１４案,彰化縣,員林市,南興里,571,1317,224,452,676,44,720
公投第１４案,彰化縣,員林市,南興里,572,1120,169,419,588,26,614
公投第１４案,彰化縣,員林市,南興里,573,1025,97,431,528,25,553
公投第１４案,彰化縣,員林市,南興里,574,1097,156,436,592,42,634
公投第１４案,彰化縣,員林市,源潭里,575,859,151,337,488,41,529
公投第１４案,彰化縣,員林市,源潭里,576,837,140,326,466,24,490
公投第１４案,彰化縣,員林市,大埔里,577,1090,175,479,654,31,685
公投第１４案,彰化縣,員林市,大埔里,578,1073,172,392,564,52,616
公投第１４案,彰化縣,大村鄉,大村村,579,1426,236,618,854,50,904
公投第１４案,彰化縣,大村鄉,大村村,580,1726,279,737,1016,59,1075
公投第１４案,彰化縣,大村鄉,茄苳村,581,797,140,318,458,45,503
公投第１４案,彰化縣,大村鄉,茄苳村,582,745,126,306,432,19,451
公投第１４案,彰化縣,大村鄉,田洋村,583,1125,158,488,646,50,696
公投第１４案,彰化縣,大村鄉,貢旗村,584,1486,219,586,805,61,866
公投第１４案,彰化縣,大村鄉,南勢村,585,1426,230,569,799,35,834
公投第１４案,彰化縣,大村鄉,大橋村,586,824,128,366,494,30,524
公投第１４案,彰化縣,大村鄉,大橋村,587,1177,160,421,581,35,616
公投第１４案,彰化縣,大村鄉,加錫村,588,1478,223,603,826,55,881
公投第１４案,彰化縣,大村鄉,大崙村,589,779,108,295,403,21,424
公投第１４案,彰化縣,大村鄉,大崙村,590,812,142,339,481,39,520
公投第１４案,彰化縣,大村鄉,新興村,591,1161,158,457,615,32,647
公投第１４案,彰化縣,大村鄉,擺塘村,592,1238,168,475,643,30,673
公投第１４案,彰化縣,大村鄉,擺塘村,593,1259,190,493,683,44,727
公投第１４案,彰化縣,大村鄉,過溝村,594,1412,234,540,774,47,821
公投第１４案,彰化縣,大村鄉,過溝村,595,1401,223,547,770,27,797
公投第１４案,彰化縣,大村鄉,村上村,596,1395,194,585,779,60,839
公投第１４案,彰化縣,大村鄉,美港村,597,996,156,416,572,29,601
公投第１４案,彰化縣,大村鄉,美港村,598,1047,181,400,581,31,612
公投第１４案,彰化縣,大村鄉,美港村,599,985,141,424,565,30,595
公投第１４案,彰化縣,大村鄉,黃厝村,600,1054,192,424,616,43,659
公投第１４案,彰化縣,大村鄉,黃厝村,601,1200,163,526,689,29,718
公投第１４案,彰化縣,大村鄉,福興村,602,1003,147,413,560,58,618
公投第１４案,彰化縣,大村鄉,福興村,603,1046,159,372,531,42,573
公投第１４案,彰化縣,大村鄉,平和村,604,1189,198,478,676,37,713
公投第１４案,彰化縣,大村鄉,平和村,605,1305,173,460,633,44,677
公投第１４案,彰化縣,永靖鄉,浮圳村,606,1255,160,447,607,55,662
公投第１４案,彰化縣,永靖鄉,東寧村,607,889,146,361,507,42,549
公投第１４案,彰化縣,永靖鄉,東寧村,608,1026,149,399,548,30,578
公投第１４案,彰化縣,永靖鄉,光雲村,609,724,108,301,409,41,450
公投第１４案,彰化縣,永靖鄉,光雲村,610,924,511,0,511,43,554
公投第１４案,彰化縣,永靖鄉,五汴村,611,659,119,270,389,32,421
公投第１４案,彰化縣,永靖鄉,五汴村,612,734,143,272,415,19,434
公投第１４案,彰化縣,永靖鄉,永興村,613,758,114,253,367,7,374
公投第１４案,彰化縣,永靖鄉,永興村,614,848,132,383,515,36,551
公投第１４案,彰化縣,永靖鄉,崙子村,615,1404,192,491,683,78,761
公投第１４案,彰化縣,永靖鄉,永東村,616,792,159,360,519,29,548
公投第１４案,彰化縣,永靖鄉,永西村,617,695,148,270,418,28,446
公投第１４案,彰化縣,永靖鄉,永西村,618,821,134,354,488,21,509
公投第１４案,彰化縣,永靖鄉,永南村,619,1064,176,439,615,53,668
公投第１４案,彰化縣,永靖鄉,永南村,620,840,139,321,460,28,488
公投第１４案,彰化縣,永靖鄉,永北村,621,1079,174,458,632,33,665
公投第１４案,彰化縣,永靖鄉,永北村,622,1048,193,427,620,35,655
公投第１４案,彰化縣,永靖鄉,港西村,623,960,151,433,584,28,612
公投第１４案,彰化縣,永靖鄉,港西村,624,798,148,322,470,28,498
公投第１４案,彰化縣,永靖鄉,五福村,625,796,137,355,492,37,529
公投第１４案,彰化縣,永靖鄉,五福村,626,662,100,255,355,31,386
公投第１４案,彰化縣,永靖鄉,湳港村,627,1040,157,412,569,40,609
公投第１４案,彰化縣,永靖鄉,新莊村,628,1025,165,395,560,27,587
公投第１４案,彰化縣,永靖鄉,瑚璉村,629,1357,230,612,842,38,880
公投第１４案,彰化縣,永靖鄉,瑚璉村,630,1236,207,505,712,41,753
公投第１４案,彰化縣,永靖鄉,獨鰲村,631,871,142,351,493,30,523
公投第１４案,彰化縣,永靖鄉,敦厚村,632,706,89,265,354,33,387
公投第１４案,彰化縣,永靖鄉,崙美村,633,770,138,324,462,27,489
公投第１４案,彰化縣,永靖鄉,同安村,634,669,104,316,420,19,439
公投第１４案,彰化縣,永靖鄉,同仁村,635,862,107,340,447,50,497
公投第１４案,彰化縣,永靖鄉,湳墘村,636,847,118,333,451,26,477
公投第１４案,彰化縣,永靖鄉,四芳村,637,668,107,278,385,44,429
公投第１４案,彰化縣,永靖鄉,福興村,638,1073,138,413,551,24,575
公投第１４案,彰化縣,永靖鄉,竹子村,639,1339,177,445,622,50,672
公投第１４案,彰化縣,溪湖鎮,光平里,640,1221,206,436,642,36,678
公投第１４案,彰化縣,溪湖鎮,平和里,641,638,116,261,377,32,409
公投第１４案,彰化縣,溪湖鎮,太平里,642,817,134,316,450,35,485
公投第１４案,彰化縣,溪湖鎮,太平里,643,968,135,420,555,29,584
公投第１４案,彰化縣,溪湖鎮,光華里,644,448,88,192,280,15,295
公投第１４案,彰化縣,溪湖鎮,湖東里,645,1123,144,448,592,27,619
公投第１４案,彰化縣,溪湖鎮,湖東里,646,1166,188,444,632,30,662
公投第１４案,彰化縣,溪湖鎮,湖東里,647,1151,154,465,619,19,638
公投第１４案,彰化縣,溪湖鎮,湖東里,648,1249,199,498,697,26,723
公投第１４案,彰化縣,溪湖鎮,中山里,649,1146,179,469,648,31,679
公投第１４案,彰化縣,溪湖鎮,中山里,650,1199,168,492,660,55,715
公投第１４案,彰化縣,溪湖鎮,西溪里,651,895,142,341,483,39,522
公投第１４案,彰化縣,溪湖鎮,西溪里,652,964,137,427,564,14,578
公投第１４案,彰化縣,溪湖鎮,中竹里,653,851,178,301,479,25,504
公投第１４案,彰化縣,溪湖鎮,東寮里,654,1072,262,316,578,30,608
公投第１４案,彰化縣,溪湖鎮,東寮里,655,1113,175,458,633,36,669
公投第１４案,彰化縣,溪湖鎮,東寮里,656,1090,183,444,627,29,656
公投第１４案,彰化縣,溪湖鎮,西寮里,657,1193,182,505,687,32,719
公投第１４案,彰化縣,溪湖鎮,西寮里,658,952,122,437,559,34,593
公投第１４案,彰化縣,溪湖鎮,大突里,659,1172,157,479,636,39,675
公投第１４案,彰化縣,溪湖鎮,大突里,660,1027,181,380,561,31,592
公投第１４案,彰化縣,溪湖鎮,大突里,661,1188,206,507,713,33,746
公投第１４案,彰化縣,溪湖鎮,北勢里,662,1403,208,503,711,44,755
公投第１４案,彰化縣,溪湖鎮,汴頭里,663,1397,240,450,690,61,751
公投第１４案,彰化縣,溪湖鎮,汴頭里,664,1636,259,645,904,36,940
公投第１４案,彰化縣,溪湖鎮,大竹里,665,1298,218,503,721,56,777
公投第１４案,彰化縣,溪湖鎮,大竹里,666,1214,173,475,648,55,703
公投第１４案,彰化縣,溪湖鎮,湖西里,667,1297,214,523,737,38,775
公投第１４案,彰化縣,溪湖鎮,湖西里,668,968,170,406,576,29,605
公投第１４案,彰化縣,溪湖鎮,田中里,669,839,128,347,475,25,500
公投第１４案,彰化縣,溪湖鎮,河東里,670,907,158,351,509,40,549
公投第１４案,彰化縣,溪湖鎮,河東里,671,898,117,341,458,20,478
公投第１４案,彰化縣,溪湖鎮,頂庄里,672,650,125,296,421,28,449
公投第１４案,彰化縣,溪湖鎮,忠覺里,673,1279,171,504,675,62,737
公投第１４案,彰化縣,溪湖鎮,湳底里,674,730,118,315,433,37,470
公投第１４案,彰化縣,溪湖鎮,大庭里,675,1407,190,578,768,51,819
公投第１４案,彰化縣,溪湖鎮,媽厝里,676,1273,177,406,583,63,646
公投第１４案,彰化縣,溪湖鎮,番婆里,677,988,144,373,517,25,542
公投第１４案,彰化縣,溪湖鎮,番婆里,678,754,122,325,447,34,481
公投第１４案,彰化縣,溪湖鎮,西勢里,679,1052,129,357,486,41,527
公投第１４案,彰化縣,溪湖鎮,西勢里,680,1149,156,431,587,32,619
公投第１４案,彰化縣,溪湖鎮,東溪里,681,1365,245,549,794,70,864
公投第１４案,彰化縣,埔鹽鄉,埔鹽村,682,958,128,434,562,31,593
公投第１４案,彰化縣,埔鹽鄉,埔鹽村,683,754,115,354,469,24,493
公投第１４案,彰化縣,埔鹽鄉,埔南村,684,757,136,332,468,33,501
公投第１４案,彰化縣,埔鹽鄉,埔南村,685,806,122,357,479,26,505
公投第１４案,彰化縣,埔鹽鄉,廍子村,686,1280,169,553,722,35,757
公投第１４案,彰化縣,埔鹽鄉,出水村,687,928,122,386,508,37,545
公投第１４案,彰化縣,埔鹽鄉,南港村,688,895,157,387,544,46,590
公投第１４案,彰化縣,埔鹽鄉,南港村,689,815,125,365,490,38,528
公投第１４案,彰化縣,埔鹽鄉,打廉村,690,957,147,377,524,36,560
公投第１４案,彰化縣,埔鹽鄉,豐澤村,691,1338,175,516,691,102,793
公投第１４案,彰化縣,埔鹽鄉,崑崙村,692,1106,137,456,593,49,642
公投第１４案,彰化縣,埔鹽鄉,角樹村,693,690,122,330,452,23,475
公投第１４案,彰化縣,埔鹽鄉,瓦磘村,694,1230,100,563,663,41,704
公投第１４案,彰化縣,埔鹽鄉,好修村,695,847,128,350,478,25,503
公投第１４案,彰化縣,埔鹽鄉,好修村,696,897,132,398,530,33,563
公投第１４案,彰化縣,埔鹽鄉,西湖村,697,882,123,363,486,46,532
公投第１４案,彰化縣,埔鹽鄉,西湖村,698,1180,159,515,674,41,715
公投第１４案,彰化縣,埔鹽鄉,大有村,699,1215,176,464,640,65,705
公投第１４案,彰化縣,埔鹽鄉,新興村,700,422,53,210,263,18,281
公投第１４案,彰化縣,埔鹽鄉,永平村,701,1106,145,427,572,49,621
公投第１４案,彰化縣,埔鹽鄉,永樂村,702,874,123,400,523,46,569
公投第１４案,彰化縣,埔鹽鄉,石埤村,703,1445,249,536,785,73,858
公投第１４案,彰化縣,埔鹽鄉,天盛村,704,875,119,389,508,43,551
公投第１４案,彰化縣,埔鹽鄉,太平村,705,837,105,307,412,34,446
公投第１４案,彰化縣,埔鹽鄉,太平村,706,685,91,283,374,38,412
公投第１４案,彰化縣,埔鹽鄉,新水村,707,733,127,320,447,23,470
公投第１４案,彰化縣,埔鹽鄉,新水村,708,798,130,327,457,41,498
公投第１４案,彰化縣,埔鹽鄉,三省村,709,1381,167,581,748,49,797
公投第１４案,彰化縣,埔鹽鄉,南新村,710,1335,169,507,676,40,716
公投第１４案,彰化縣,埔心鄉,東門村,711,1139,186,468,654,58,712
公投第１４案,彰化縣,埔心鄉,東門村,712,1217,165,510,675,44,719
公投第１４案,彰化縣,埔心鄉,東門村,713,1248,191,547,738,39,777
公投第１４案,彰化縣,埔心鄉,埔心村,714,1248,217,527,744,60,804
公投第１４案,彰化縣,埔心鄉,義民村,715,916,163,373,536,31,567
公投第１４案,彰化縣,埔心鄉,義民村,716,625,134,256,390,22,412
公投第１４案,彰化縣,埔心鄉,油車村,717,1271,205,479,684,50,734
公投第１４案,彰化縣,埔心鄉,瓦北村,718,608,103,264,367,26,393
公投第１４案,彰化縣,埔心鄉,瓦北村,719,1132,181,492,673,59,732
公投第１４案,彰化縣,埔心鄉,瓦中村,720,1027,159,435,594,38,632
公投第１４案,彰化縣,埔心鄉,瓦中村,721,926,162,390,552,35,587
公投第１４案,彰化縣,埔心鄉,瓦南村,722,778,109,318,427,55,482
公投第１４案,彰化縣,埔心鄉,瓦南村,723,660,105,296,401,30,431
公投第１４案,彰化縣,埔心鄉,經口村,724,1330,204,574,778,40,818
公投第１４案,彰化縣,埔心鄉,經口村,725,991,179,386,565,24,589
公投第１４案,彰化縣,埔心鄉,太平村,726,985,172,406,578,33,611
公投第１４案,彰化縣,埔心鄉,太平村,727,1034,179,380,559,34,593
公投第１４案,彰化縣,埔心鄉,大華村,728,612,105,259,364,35,399
公投第１４案,彰化縣,埔心鄉,仁里村,729,1236,194,546,740,46,786
公投第１４案,彰化縣,埔心鄉,舊舘村,730,775,33,427,460,32,492
公投第１４案,彰化縣,埔心鄉,舊舘村,731,738,133,332,465,32,497
公投第１４案,彰化縣,埔心鄉,南舘村,732,1036,197,413,610,30,640
公投第１４案,彰化縣,埔心鄉,新舘村,733,975,160,359,519,44,563
公投第１４案,彰化縣,埔心鄉,芎蕉村,734,885,143,344,487,26,513
公投第１４案,彰化縣,埔心鄉,芎蕉村,735,939,164,382,546,47,593
公投第１４案,彰化縣,埔心鄉,羅厝村,736,689,70,324,394,13,407
公投第１４案,彰化縣,埔心鄉,羅厝村,737,659,88,295,383,26,409
公投第１４案,彰化縣,埔心鄉,梧鳳村,738,910,142,328,470,26,496
公投第１４案,彰化縣,埔心鄉,二重村,739,1352,245,588,833,60,893
公投第１４案,彰化縣,埔心鄉,埤霞村,740,759,131,281,412,30,442
公投第１４案,彰化縣,埔心鄉,埤脚村,741,942,352,176,528,41,569
公投第１４案,彰化縣,田中鎮,香山里,742,854,126,310,436,47,483
公投第１４案,彰化縣,田中鎮,碧峰里,743,963,32,418,450,42,492
公投第１４案,彰化縣,田中鎮,碧峰里,744,175,13,29,42,3,45
公投第１４案,彰化縣,田中鎮,東源里,745,739,86,277,363,31,394
公投第１４案,彰化縣,田中鎮,復興里,746,826,114,309,423,25,448
公投第１４案,彰化縣,田中鎮,復興里,747,741,120,294,414,33,447
公投第１４案,彰化縣,田中鎮,平和里,748,506,58,175,233,12,245
公投第１４案,彰化縣,田中鎮,平和里,749,1001,135,339,474,49,523
公投第１４案,彰化縣,田中鎮,頂潭里,750,1281,173,508,681,65,746
公投第１４案,彰化縣,田中鎮,新庄里,751,1035,148,411,559,33,592
公投第１４案,彰化縣,田中鎮,新庄里,752,1327,203,535,738,42,780
公投第１４案,彰化縣,田中鎮,中潭里,753,844,138,357,495,27,522
公投第１４案,彰化縣,田中鎮,中潭里,754,913,132,356,488,37,525
公投第１４案,彰化縣,田中鎮,龍潭里,755,613,92,277,369,37,406
公投第１４案,彰化縣,田中鎮,北路里,756,1382,203,560,763,55,818
公投第１４案,彰化縣,田中鎮,北路里,757,1034,178,459,637,37,674
公投第１４案,彰化縣,田中鎮,北路里,758,935,163,430,593,24,617
公投第１４案,彰化縣,田中鎮,西路里,759,1301,203,515,718,35,753
公投第１４案,彰化縣,田中鎮,西路里,760,1100,165,455,620,35,655
公投第１４案,彰化縣,田中鎮,東路里,761,1071,189,426,615,38,653
公投第１４案,彰化縣,田中鎮,南路里,762,1163,198,501,699,31,730
公投第１４案,彰化縣,田中鎮,中路里,763,809,134,363,497,38,535
公投第１４案,彰化縣,田中鎮,中路里,764,1155,196,479,675,40,715
公投第１４案,彰化縣,田中鎮,梅州里,765,1270,208,470,678,59,737
公投第１４案,彰化縣,田中鎮,三安里,766,870,137,321,458,29,487
公投第１４案,彰化縣,田中鎮,三安里,767,736,101,279,380,46,426
公投第１４案,彰化縣,田中鎮,大崙里,768,1335,164,489,653,45,698
公投第１４案,彰化縣,田中鎮,沙崙里,769,876,121,347,468,33,501
公投第１４案,彰化縣,田中鎮,沙崙里,770,898,140,315,455,47,502
公投第１４案,彰化縣,田中鎮,新民里,771,1298,208,531,739,23,762
公投第１４案,彰化縣,田中鎮,新民里,772,1451,219,527,746,63,809
公投第１４案,彰化縣,田中鎮,新民里,773,1475,235,550,785,48,833
公投第１４案,彰化縣,田中鎮,三民里,774,766,105,257,362,41,403
公投第１４案,彰化縣,田中鎮,三民里,775,810,91,327,418,22,440
公投第１４案,彰化縣,田中鎮,三光里,776,953,164,369,533,44,577
公投第１４案,彰化縣,田中鎮,大社里,777,885,141,364,505,54,559
公投第１４案,彰化縣,社頭鄉,社頭村,778,791,136,297,433,34,467
公投第１４案,彰化縣,社頭鄉,社頭村,779,984,146,386,532,32,564
公投第１４案,彰化縣,社頭鄉,社頭村,780,990,132,383,515,19,534
公投第１４案,彰化縣,社頭鄉,廣興村,781,1016,171,425,596,36,632
公投第１４案,彰化縣,社頭鄉,廣興村,782,1091,187,436,623,36,659
公投第１４案,彰化縣,社頭鄉,廣興村,783,1236,221,473,694,49,743
公投第１４案,彰化縣,社頭鄉,廣興村,784,1203,187,462,649,26,675
公投第１４案,彰化縣,社頭鄉,東興村,785,753,114,290,404,23,427
公投第１４案,彰化縣,社頭鄉,東興村,786,725,98,256,354,33,387
公投第１４案,彰化縣,社頭鄉,松竹村,787,1023,169,401,570,54,624
公投第１４案,彰化縣,社頭鄉,舊社村,788,562,131,233,364,20,384
公投第１４案,彰化縣,社頭鄉,舊社村,789,1049,147,410,557,32,589
公投第１４案,彰化縣,社頭鄉,廣福村,790,933,136,399,535,26,561
公投第１４案,彰化縣,社頭鄉,橋頭村,791,990,165,400,565,40,605
公投第１４案,彰化縣,社頭鄉,橋頭村,792,1076,149,401,550,32,582
公投第１４案,彰化縣,社頭鄉,新厝村,793,742,117,326,443,11,454
公投第１４案,彰化縣,社頭鄉,新厝村,794,672,91,264,355,21,376
公投第１４案,彰化縣,社頭鄉,張厝村,795,1235,148,445,593,35,628
公投第１４案,彰化縣,社頭鄉,湳底村,796,750,135,282,417,36,453
公投第１４案,彰化縣,社頭鄉,湳底村,797,895,134,324,458,29,487
公投第１４案,彰化縣,社頭鄉,仁雅村,798,688,114,275,389,16,405
公投第１４案,彰化縣,社頭鄉,仁雅村,799,870,124,337,461,29,490
公投第１４案,彰化縣,社頭鄉,仁雅村,800,1140,193,462,655,26,681
公投第１４案,彰化縣,社頭鄉,里仁村,801,985,141,403,544,38,582
公投第１４案,彰化縣,社頭鄉,美雅村,802,1266,186,556,742,47,789
公投第１４案,彰化縣,社頭鄉,崙雅村,803,937,152,377,529,26,555
公投第１４案,彰化縣,社頭鄉,清水村,804,1219,166,490,656,35,691
公投第１４案,彰化縣,社頭鄉,山湖村,805,1165,178,446,624,46,670
公投第１４案,彰化縣,社頭鄉,埤斗村,806,986,161,381,542,48,590
公投第１４案,彰化縣,社頭鄉,仁和村,807,724,115,316,431,27,458
公投第１４案,彰化縣,社頭鄉,平和村,808,1015,127,436,563,28,591
公投第１４案,彰化縣,社頭鄉,協和村,809,1116,153,392,545,27,572
公投第１４案,彰化縣,社頭鄉,協和村,810,1061,151,388,539,36,575
公投第１４案,彰化縣,社頭鄉,泰安村,811,992,164,396,560,40,600
公投第１４案,彰化縣,社頭鄉,朝興村,812,1092,180,414,594,22,616
公投第１４案,彰化縣,社頭鄉,龍井村,813,828,133,340,473,37,510
公投第１４案,彰化縣,社頭鄉,湳雅村,814,787,121,258,379,45,424
公投第１４案,彰化縣,社頭鄉,湳雅村,815,719,86,248,334,26,360
公投第１４案,彰化縣,二水鄉,復興村,816,1028,171,389,560,48,608
公投第１４案,彰化縣,二水鄉,十五村,817,689,90,299,389,44,433
公投第１４案,彰化縣,二水鄉,合和村,818,871,115,314,429,45,474
公投第１４案,彰化縣,二水鄉,上豊村,819,953,132,389,521,45,566
公投第１４案,彰化縣,二水鄉,過圳村,820,624,76,225,301,41,342
公投第１４案,彰化縣,二水鄉,五伯村,821,645,112,280,392,37,429
公投第１４案,彰化縣,二水鄉,文化村,822,986,139,461,600,45,645
公投第１４案,彰化縣,二水鄉,光化村,823,943,165,404,569,55,624
公投第１４案,彰化縣,二水鄉,聖化村,824,455,66,209,275,10,285
公投第１４案,彰化縣,二水鄉,二水村,825,831,152,385,537,21,558
公投第１４案,彰化縣,二水鄉,惠民村,826,831,125,349,474,36,510
公投第１４案,彰化縣,二水鄉,裕民村,827,1013,153,403,556,21,577
公投第１４案,彰化縣,二水鄉,大園村,828,796,129,325,454,51,505
公投第１４案,彰化縣,二水鄉,修仁村,829,781,306,98,404,52,456
公投第１４案,彰化縣,二水鄉,合興村,830,692,100,239,339,21,360
公投第１４案,彰化縣,二水鄉,源泉村,831,635,98,250,348,26,374
公投第１４案,彰化縣,二水鄉,倡和村,832,566,81,214,295,33,328
公投第１４案,彰化縣,北斗鎮,中寮里,833,925,128,350,478,44,522
公投第１４案,彰化縣,北斗鎮,中寮里,834,869,146,338,484,45,529
公投第１４案,彰化縣,北斗鎮,中寮里,835,855,142,380,522,31,553
公投第１４案,彰化縣,北斗鎮,大道里,836,1065,178,458,636,35,671
公投第１４案,彰化縣,北斗鎮,大道里,837,828,100,371,471,39,510
公投第１４案,彰化縣,北斗鎮,西德里,838,1124,169,465,634,40,674
公投第１４案,彰化縣,北斗鎮,西德里,839,1096,196,440,636,37,673
公投第１４案,彰化縣,北斗鎮,西德里,840,1213,184,494,678,34,712
公投第１４案,彰化縣,北斗鎮,西德里,841,1164,158,427,585,61,646
公投第１４案,彰化縣,北斗鎮,西安里,842,730,117,277,394,21,415
公投第１４案,彰化縣,北斗鎮,西安里,843,878,114,354,468,25,493
公投第１４案,彰化縣,北斗鎮,光復里,844,833,121,365,486,28,514
公投第１４案,彰化縣,北斗鎮,光復里,845,957,177,368,545,23,568
公投第１４案,彰化縣,北斗鎮,新政里,846,783,119,295,414,26,440
公投第１４案,彰化縣,北斗鎮,重慶里,847,573,95,198,293,27,320
公投第１４案,彰化縣,北斗鎮,五權里,848,672,111,258,369,21,390
公投第１４案,彰化縣,北斗鎮,七星里,849,695,123,222,345,36,381
公投第１４案,彰化縣,北斗鎮,七星里,850,747,94,280,374,29,403
公投第１４案,彰化縣,北斗鎮,居仁里,851,643,116,281,397,14,411
公投第１４案,彰化縣,北斗鎮,居仁里,852,662,101,267,368,33,401
公投第１４案,彰化縣,北斗鎮,東光里,853,1085,173,478,651,44,695
公投第１４案,彰化縣,北斗鎮,東光里,854,1121,174,441,615,56,671
公投第１４案,彰化縣,北斗鎮,文昌里,855,830,136,346,482,28,510
公投第１４案,彰化縣,北斗鎮,文昌里,856,975,145,374,519,25,544
公投第１４案,彰化縣,北斗鎮,文昌里,857,1212,202,429,631,31,662
公投第１４案,彰化縣,北斗鎮,中和里,858,1302,210,528,738,44,782
公投第１４案,彰化縣,北斗鎮,新生里,859,1077,138,368,506,39,545
公投第１４案,彰化縣,北斗鎮,新生里,860,917,330,127,457,48,505
公投第１４案,彰化縣,北斗鎮,大新里,861,825,122,323,445,20,465
公投第１４案,彰化縣,北斗鎮,大新里,862,937,149,375,524,35,559
公投第１４案,彰化縣,田尾鄉,田尾村,863,1284,184,447,631,41,672
公投第１４案,彰化縣,田尾鄉,溪畔村,864,1187,176,498,674,54,728
公投第１４案,彰化縣,田尾鄉,打簾村,865,1033,178,427,605,30,635
公投第１４案,彰化縣,田尾鄉,打簾村,866,696,88,300,388,38,426
公投第１４案,彰化縣,田尾鄉,正義村,867,872,146,370,516,27,543
公投第１４案,彰化縣,田尾鄉,北曾村,868,680,83,269,352,18,370
公投第１４案,彰化縣,田尾鄉,北曾村,869,875,180,350,530,27,557
公投第１４案,彰化縣,田尾鄉,南曾村,870,1337,208,487,695,35,730
公投第１４案,彰化縣,田尾鄉,饒平村,871,1376,235,567,802,43,845
公投第１４案,彰化縣,田尾鄉,饒平村,872,1186,175,519,694,44,738
公投第１４案,彰化縣,田尾鄉,豐田村,873,874,144,420,564,43,607
公投第１４案,彰化縣,田尾鄉,仁里村,874,647,84,258,342,25,367
公投第１４案,彰化縣,田尾鄉,仁里村,875,959,99,447,546,28,574
公投第１４案,彰化縣,田尾鄉,新厝村,876,263,31,104,135,9,144
公投第１４案,彰化縣,田尾鄉,溪頂村,877,618,81,230,311,24,335
公投第１４案,彰化縣,田尾鄉,柳鳳村,878,938,181,392,573,25,598
公投第１４案,彰化縣,田尾鄉,陸豐村,879,880,138,384,522,41,563
公投第１４案,彰化縣,田尾鄉,海豐村,880,804,120,287,407,21,428
公投第１４案,彰化縣,田尾鄉,海豐村,881,592,105,199,304,25,329
公投第１４案,彰化縣,田尾鄉,睦宜村,882,1079,174,449,623,62,685
公投第１４案,彰化縣,田尾鄉,新生村,883,1336,222,515,737,43,780
公投第１４案,彰化縣,田尾鄉,北鎮村,884,1198,175,435,610,41,651
公投第１４案,彰化縣,田尾鄉,南鎮村,885,621,95,227,322,32,354
公投第１４案,彰化縣,田尾鄉,福田村,886,760,117,271,388,23,411
公投第１４案,彰化縣,田尾鄉,新興村,887,1084,185,454,639,62,701
公投第１４案,彰化縣,埤頭鄉,和豊村,888,1178,152,369,521,59,580
公投第１４案,彰化縣,埤頭鄉,和豊村,889,1290,111,546,657,32,689
公投第１４案,彰化縣,埤頭鄉,興農村,890,973,152,329,481,52,533
公投第１４案,彰化縣,埤頭鄉,興農村,891,783,108,289,397,26,423
公投第１４案,彰化縣,埤頭鄉,埤頭村,892,733,107,269,376,43,419
公投第１４案,彰化縣,埤頭鄉,埤頭村,893,899,145,316,461,66,527
公投第１４案,彰化縣,埤頭鄉,豊崙村,894,965,125,368,493,51,544
公投第１４案,彰化縣,埤頭鄉,豊崙村,895,1356,151,504,655,56,711
公投第１４案,彰化縣,埤頭鄉,崙子村,896,1265,186,435,621,68,689
公投第１４案,彰化縣,埤頭鄉,永豊村,897,877,134,360,494,48,542
公投第１４案,彰化縣,埤頭鄉,永豊村,898,705,105,240,345,37,382
公投第１４案,彰化縣,埤頭鄉,合興村,899,1062,169,447,616,39,655
公投第１４案,彰化縣,埤頭鄉,合興村,900,1300,214,489,703,50,753
公投第１４案,彰化縣,埤頭鄉,合興村,901,923,125,363,488,52,540
公投第１４案,彰化縣,埤頭鄉,平原村,902,1085,151,381,532,24,556
公投第１４案,彰化縣,埤頭鄉,平原村,903,1103,165,436,601,53,654
公投第１４案,彰化縣,埤頭鄉,崙腳村,904,735,93,267,360,21,381
公投第１４案,彰化縣,埤頭鄉,元埔村,905,574,82,198,280,36,316
公投第１４案,彰化縣,埤頭鄉,芙朝村,906,767,78,269,347,39,386
公投第１４案,彰化縣,埤頭鄉,芙朝村,907,737,95,274,369,41,410
公投第１４案,彰化縣,埤頭鄉,新庄村,908,1058,145,307,452,54,506
公投第１４案,彰化縣,埤頭鄉,陸嘉村,909,826,101,271,372,57,429
公投第１４案,彰化縣,埤頭鄉,竹圍村,910,1082,341,134,475,72,547
公投第１４案,彰化縣,埤頭鄉,中和村,911,737,89,313,402,44,446
公投第１４案,彰化縣,埤頭鄉,中和村,912,711,80,276,356,21,377
公投第１４案,彰化縣,埤頭鄉,庄內村,913,1043,181,352,533,59,592
公投第１４案,彰化縣,埤頭鄉,大湖村,914,910,112,328,440,27,467
公投第１４案,彰化縣,溪州鄉,溪厝村,915,778,102,292,394,37,431
公投第１４案,彰化縣,溪州鄉,溪厝村,916,1061,131,367,498,29,527
公投第１４案,彰化縣,溪州鄉,坑厝村,917,701,77,231,308,32,340
公投第１４案,彰化縣,溪州鄉,瓦厝村,918,879,143,351,494,40,534
公投第１４案,彰化縣,溪州鄉,溪州村,919,654,105,289,394,36,430
公投第１４案,彰化縣,溪州鄉,溪州村,920,878,125,346,471,34,505
公投第１４案,彰化縣,溪州鄉,尾厝村,921,942,127,407,534,43,577
公投第１４案,彰化縣,溪州鄉,尾厝村,922,871,154,298,452,32,484
公投第１４案,彰化縣,溪州鄉,東州村,923,1047,362,154,516,20,536
公投第１４案,彰化縣,溪州鄉,東州村,924,858,128,340,468,40,508
公投第１４案,彰化縣,溪州鄉,舊眉村,925,1409,171,424,595,58,653
公投第１４案,彰化縣,溪州鄉,圳寮村,926,792,106,294,400,16,416
公投第１４案,彰化縣,溪州鄉,圳寮村,927,714,94,243,337,49,386
公投第１４案,彰化縣,溪州鄉,西畔村,928,1109,122,370,492,50,542
公投第１４案,彰化縣,溪州鄉,西畔村,929,962,110,292,402,37,439
公投第１４案,彰化縣,溪州鄉,柑園村,930,1157,136,345,481,51,532
公投第１４案,彰化縣,溪州鄉,成功村,931,952,126,330,456,35,491
公投第１４案,彰化縣,溪州鄉,成功村,932,887,136,307,443,33,476
公投第１４案,彰化縣,溪州鄉,大庄村,933,866,102,236,338,43,381
公投第１４案,彰化縣,溪州鄉,大庄村,934,1010,116,319,435,55,490
公投第１４案,彰化縣,溪州鄉,榮光村,935,853,102,303,405,18,423
公投第１４案,彰化縣,溪州鄉,潮洋村,936,843,124,270,394,51,445
公投第１４案,彰化縣,溪州鄉,張厝村,937,711,81,178,259,12,271
公投第１４案,彰化縣,溪州鄉,菜公村,938,851,123,288,411,59,470
公投第１４案,彰化縣,溪州鄉,三條村,939,883,304,113,417,26,443
公投第１４案,彰化縣,溪州鄉,三圳村,940,1247,126,428,554,55,609
公投第１４案,彰化縣,溪州鄉,水尾村,941,1490,253,514,767,63,830
公投第１４案,彰化縣,二林鎮,豐田里,942,731,71,223,294,22,316
公投第１４案,彰化縣,二林鎮,豐田里,943,1025,146,405,551,38,589
公投第１４案,彰化縣,二林鎮,豐田里,944,784,120,317,437,16,453
公投第１４案,彰化縣,二林鎮,東和里,945,892,142,344,486,33,519
公投第１４案,彰化縣,二林鎮,東和里,946,1256,216,469,685,39,724
公投第１４案,彰化縣,二林鎮,南光里,947,1043,138,389,527,45,572
公投第１４案,彰化縣,二林鎮,南光里,948,1076,197,421,618,31,649
公投第１４案,彰化縣,二林鎮,南光里,949,1082,151,447,598,39,637
公投第１４案,彰化縣,二林鎮,西平里,950,1427,206,527,733,43,776
公投第１４案,彰化縣,二林鎮,北平里,951,1030,145,337,482,49,531
公投第１４案,彰化縣,二林鎮,北平里,952,1033,150,345,495,47,542
公投第１４案,彰化縣,二林鎮,北平里,953,977,124,356,480,49,529
公投第１４案,彰化縣,二林鎮,中西里,954,683,84,242,326,26,352
公投第１４案,彰化縣,二林鎮,中西里,955,975,108,342,450,63,513
公投第１４案,彰化縣,二林鎮,廣興里,956,1336,161,393,554,52,606
公投第１４案,彰化縣,二林鎮,香田里,957,1019,128,314,442,42,484
公投第１４案,彰化縣,二林鎮,外竹里,958,1003,100,302,402,52,454
公投第１４案,彰化縣,二林鎮,興華里,959,1151,127,485,612,37,649
公投第１４案,彰化縣,二林鎮,東興里,960,1598,237,600,837,75,912
公投第１４案,彰化縣,二林鎮,後厝里,961,1488,207,546,753,47,800
公投第１４案,彰化縣,二林鎮,後厝里,962,1771,274,686,960,45,1005
公投第１４案,彰化縣,二林鎮,頂厝里,963,1360,154,389,543,41,584
公投第１４案,彰化縣,二林鎮,趙甲里,964,1613,171,527,698,57,755
公投第１４案,彰化縣,二林鎮,振興里,965,1228,159,418,577,62,639
公投第１４案,彰化縣,二林鎮,萬興里,966,771,102,325,427,18,445
公投第１４案,彰化縣,二林鎮,永興里,967,858,138,328,466,38,504
公投第１４案,彰化縣,二林鎮,永興里,968,661,74,225,299,0,299
公投第１４案,彰化縣,二林鎮,西庄里,969,1268,148,415,563,72,635
公投第１４案,彰化縣,二林鎮,梅芳里,970,1081,128,390,518,19,537
公投第１４案,彰化縣,二林鎮,華崙里,971,1213,157,417,574,24,598
公投第１４案,彰化縣,二林鎮,華崙里,972,1328,184,515,699,41,740
公投第１４案,彰化縣,二林鎮,華崙里,973,1118,106,356,462,72,534
公投第１４案,彰化縣,二林鎮,萬合里,974,1157,128,359,487,47,534
公投第１４案,彰化縣,二林鎮,東勢里,975,972,101,352,453,26,479
公投第１４案,彰化縣,二林鎮,大永里,976,902,135,321,456,33,489
公投第１４案,彰化縣,二林鎮,原斗里,977,1273,170,591,761,46,807
公投第１４案,彰化縣,二林鎮,西斗里,978,1087,138,413,551,23,574
公投第１４案,彰化縣,二林鎮,東華里,979,987,135,397,532,59,591
公投第１４案,彰化縣,二林鎮,復豐里,980,719,94,226,320,20,340
公投第１４案,彰化縣,大城鄉,山腳村,981,1288,93,346,439,24,463
公投第１４案,彰化縣,大城鄉,潭墘村,982,1104,98,269,367,61,428
公投第１４案,彰化縣,大城鄉,大城村,983,964,119,361,480,57,537
公投第１４案,彰化縣,大城鄉,東城村,984,1312,132,434,566,41,607
公投第１４案,彰化縣,大城鄉,西城村,985,853,80,249,329,38,367
公投第１４案,彰化縣,大城鄉,上山村,986,518,34,134,168,15,183
公投第１４案,彰化縣,大城鄉,上山村,987,574,65,163,228,23,251
公投第１４案,彰化縣,大城鄉,永和村,988,702,59,181,240,30,270
公投第１４案,彰化縣,大城鄉,公館村,989,376,29,79,108,12,120
公投第１４案,彰化縣,大城鄉,公館村,990,693,33,161,194,21,215
公投第１４案,彰化縣,大城鄉,豐美村,991,877,80,264,344,41,385
公投第１４案,彰化縣,大城鄉,三豐村,992,655,50,147,197,12,209
公投第１４案,彰化縣,大城鄉,菜寮村,993,1103,91,305,396,18,414
公投第１４案,彰化縣,大城鄉,東港村,994,1192,102,289,391,25,416
公投第１４案,彰化縣,大城鄉,西港村,995,917,76,250,326,35,361
公投第１４案,彰化縣,大城鄉,頂庄村,996,686,52,156,208,21,229
公投第１４案,彰化縣,大城鄉,臺西村,997,899,75,202,277,21,298
公投第１４案,彰化縣,芳苑鄉,芳苑村,998,940,92,209,301,34,335
公投第１４案,彰化縣,芳苑鄉,芳中村,999,403,39,104,143,19,162
公投第１４案,彰化縣,芳苑鄉,仁愛村,1000,756,80,266,346,30,376
公投第１４案,彰化縣,芳苑鄉,信義村,1001,548,51,105,156,22,178
公投第１４案,彰化縣,芳苑鄉,後寮村,1002,997,108,360,468,52,520
公投第１４案,彰化縣,芳苑鄉,三合村,1003,1300,166,369,535,55,590
公投第１４案,彰化縣,芳苑鄉,三合村,1004,859,108,300,408,35,443
公投第１４案,彰化縣,芳苑鄉,永興村,1005,734,90,255,345,16,361
公投第１４案,彰化縣,芳苑鄉,永興村,1006,636,75,206,281,24,305
公投第１４案,彰化縣,芳苑鄉,新街村,1007,808,88,231,319,55,374
公投第１４案,彰化縣,芳苑鄉,路上村,1008,668,74,182,256,39,295
公投第１４案,彰化縣,芳苑鄉,路平村,1009,744,110,219,329,24,353
公投第１４案,彰化縣,芳苑鄉,三成村,1010,1026,115,296,411,76,487
公投第１４案,彰化縣,芳苑鄉,福榮村,1011,586,57,168,225,8,233
公投第１４案,彰化縣,芳苑鄉,頂廍村,1012,593,66,225,291,24,315
公投第１４案,彰化縣,芳苑鄉,王功村,1013,1071,132,380,512,67,579
公投第１４案,彰化縣,芳苑鄉,王功村,1014,1060,120,369,489,66,555
公投第１４案,彰化縣,芳苑鄉,博愛村,1015,708,79,266,345,21,366
公投第１４案,彰化縣,芳苑鄉,和平村,1016,735,88,227,315,48,363
公投第１４案,彰化縣,芳苑鄉,興仁村,1017,571,74,222,296,37,333
公投第１４案,彰化縣,芳苑鄉,興仁村,1018,729,73,220,293,26,319
公投第１４案,彰化縣,芳苑鄉,民生村,1019,674,87,223,310,41,351
公投第１４案,彰化縣,芳苑鄉,新寶村,1020,846,103,293,396,37,433
公投第１４案,彰化縣,芳苑鄉,新寶村,1021,806,110,326,436,33,469
公投第１４案,彰化縣,芳苑鄉,五俊村,1022,470,46,125,171,11,182
公投第１４案,彰化縣,芳苑鄉,草湖村,1023,1124,123,443,566,49,615
公投第１４案,彰化縣,芳苑鄉,草湖村,1024,317,36,105,141,11,152
公投第１４案,彰化縣,芳苑鄉,建平村,1025,1158,102,373,475,50,525
公投第１４案,彰化縣,芳苑鄉,建平村,1026,967,120,322,442,26,468
公投第１４案,彰化縣,芳苑鄉,崙腳村,1027,762,98,281,379,30,409
公投第１４案,彰化縣,芳苑鄉,文津村,1028,1086,100,339,439,41,480
公投第１４案,彰化縣,芳苑鄉,新生村,1029,747,85,261,346,21,367
公投第１４案,彰化縣,芳苑鄉,新生村,1030,653,62,187,249,17,266
公投第１４案,彰化縣,芳苑鄉,漢寶村,1031,872,111,368,479,35,514
公投第１４案,彰化縣,芳苑鄉,漢寶村,1032,1235,100,600,700,45,745
公投第１４案,彰化縣,芳苑鄉,漢寶村,1033,1102,134,421,555,42,597
公投第１４案,彰化縣,竹塘鄉,竹元村,1034,1168,167,447,614,58,672
公投第１４案,彰化縣,竹塘鄉,竹塘村,1035,965,130,417,547,23,570
公投第１４案,彰化縣,竹塘鄉,竹塘村,1036,960,146,417,563,37,600
公投第１４案,彰化縣,竹塘鄉,小西村,1037,743,125,302,427,54,481
公投第１４案,彰化縣,竹塘鄉,民靖村,1038,751,92,219,311,29,340
公投第１４案,彰化縣,竹塘鄉,五庄村,1039,792,77,269,346,38,384
公投第１４案,彰化縣,竹塘鄉,五庄村,1040,733,97,238,335,14,349
公投第１４案,彰化縣,竹塘鄉,樹腳村,1041,657,87,238,325,30,355
公投第１４案,彰化縣,竹塘鄉,田頭村,1042,1063,135,380,515,35,550
公投第１４案,彰化縣,竹塘鄉,新廣村,1043,1114,145,438,583,57,640
公投第１４案,彰化縣,竹塘鄉,溪墘村,1044,506,85,230,315,29,344
公投第１４案,彰化縣,竹塘鄉,竹林村,1045,823,114,276,390,36,426
公投第１４案,彰化縣,竹塘鄉,土庫村,1046,654,71,251,322,19,341
公投第１４案,彰化縣,竹塘鄉,內新村,1047,577,70,170,240,19,259
公投第１４案,彰化縣,竹塘鄉,長安村,1048,772,101,261,362,47,409
公投第１４案,彰化縣,竹塘鄉,永安村,1049,543,66,160,226,26,252
公投第１４案,南投縣,南投市,龍泉里,1,927,173,352,525,29,554
公投第１４案,南投縣,南投市,康壽里,2,667,120,308,428,26,454
公投第１４案,南投縣,南投市,康壽里,3,773,140,342,482,23,505
公投第１４案,南投縣,南投市,三民里,4,818,145,348,493,23,516
公投第１４案,南投縣,南投市,仁和里,5,525,108,230,338,19,357
公投第１４案,南投縣,南投市,南投里,6,575,97,263,360,28,388
公投第１４案,南投縣,南投市,彰仁里,7,368,80,162,242,12,254
公投第１４案,南投縣,南投市,崇文里,8,956,141,448,589,44,633
公投第１４案,南投縣,南投市,三興里,9,1245,186,459,645,23,668
公投第１４案,南投縣,南投市,三興里,10,1484,243,600,843,24,867
公投第１４案,南投縣,南投市,三興里,11,1191,193,558,751,30,781
公投第１４案,南投縣,南投市,三興里,12,1506,255,616,871,45,916
公投第１４案,南投縣,南投市,三和里,13,1070,190,462,652,28,680
公投第１４案,南投縣,南投市,三和里,14,670,112,295,407,20,427
公投第１４案,南投縣,南投市,三和里,15,1050,201,454,655,44,699
公投第１４案,南投縣,南投市,嘉興里,16,1122,162,413,575,36,611
公投第１４案,南投縣,南投市,嘉興里,17,984,156,374,530,28,558
公投第１４案,南投縣,南投市,嘉和里,18,1062,196,479,675,31,706
公投第１４案,南投縣,南投市,嘉和里,19,1053,145,455,600,46,646
公投第１４案,南投縣,南投市,嘉和里,20,1104,208,459,667,35,702
公投第１４案,南投縣,南投市,嘉和里,21,1192,200,458,658,35,693
公投第１４案,南投縣,南投市,平和里,22,960,137,389,526,33,559
公投第１４案,南投縣,南投市,平和里,23,906,153,376,529,30,559
公投第１４案,南投縣,南投市,平和里,24,957,174,393,567,31,598
公投第１４案,南投縣,南投市,平和里,25,997,158,450,608,43,651
公投第１４案,南投縣,南投市,平和里,26,1008,186,413,599,30,629
公投第１４案,南投縣,南投市,平和里,27,1164,219,444,663,21,684
公投第１４案,南投縣,南投市,振興里,28,587,90,232,322,27,349
公投第１４案,南投縣,南投市,振興里,29,734,118,266,384,31,415
公投第１４案,南投縣,南投市,振興里,30,724,113,277,390,40,430
公投第１４案,南投縣,南投市,千秋里,31,1003,145,432,577,25,602
公投第１４案,南投縣,南投市,軍功里,32,1356,215,528,743,47,790
公投第１４案,南投縣,南投市,軍功里,33,1373,233,492,725,44,769
公投第１４案,南投縣,南投市,軍功里,34,1452,226,562,788,30,818
公投第１４案,南投縣,南投市,軍功里,35,362,40,162,202,8,210
公投第１４案,南投縣,南投市,東山里,36,389,51,160,211,24,235
公投第１４案,南投縣,南投市,營南里,37,1276,228,561,789,41,830
公投第１４案,南投縣,南投市,營南里,38,1089,205,474,679,29,708
公投第１４案,南投縣,南投市,營北里,39,921,174,375,549,44,593
公投第１４案,南投縣,南投市,營北里,40,892,168,413,581,21,602
公投第１４案,南投縣,南投市,營北里,41,1050,180,487,667,24,691
公投第１４案,南投縣,南投市,營北里,42,1078,181,481,662,20,682
公投第１４案,南投縣,南投市,營北里,43,1078,164,479,643,25,668
公投第１４案,南投縣,南投市,營北里,44,861,177,417,594,29,623
公投第１４案,南投縣,南投市,內興里,45,1221,165,519,684,52,736
公投第１４案,南投縣,南投市,內興里,46,1105,186,451,637,23,660
公投第１４案,南投縣,南投市,內興里,47,1230,203,533,736,20,756
公投第１４案,南投縣,南投市,內興里,48,1092,172,473,645,30,675
公投第１４案,南投縣,南投市,內興里,49,1286,227,572,799,22,821
公投第１４案,南投縣,南投市,內興里,50,655,121,302,423,30,453
公投第１４案,南投縣,南投市,內新里,51,719,129,323,452,23,475
公投第１４案,南投縣,南投市,內新里,52,720,130,276,406,24,430
公投第１４案,南投縣,南投市,光輝里,53,509,67,264,331,13,344
公投第１４案,南投縣,南投市,光榮里,54,492,39,226,265,15,280
公投第１４案,南投縣,南投市,光榮里,55,616,67,297,364,11,375
公投第１４案,南投縣,南投市,光明里,56,1010,133,485,618,22,640
公投第１４案,南投縣,南投市,光華里,57,848,99,380,479,27,506
公投第１４案,南投縣,南投市,漳興里,58,1387,225,599,824,57,881
公投第１４案,南投縣,南投市,漳興里,59,1245,216,549,765,43,808
公投第１４案,南投縣,南投市,漳和里,60,1199,185,493,678,24,702
公投第１４案,南投縣,南投市,漳和里,61,1288,212,546,758,45,803
公投第１４案,南投縣,南投市,漳和里,62,1040,170,414,584,40,624
公投第１４案,南投縣,南投市,漳和里,63,1070,176,455,631,36,667
公投第１４案,南投縣,南投市,漳和里,64,1299,229,550,779,46,825
公投第１４案,南投縣,南投市,漳和里,65,1122,213,522,735,32,767
公投第１４案,南投縣,南投市,平山里,66,1414,209,597,806,37,843
公投第１４案,南投縣,南投市,平山里,67,1121,174,453,627,39,666
公投第１４案,南投縣,南投市,平山里,68,1434,232,577,809,20,829
公投第１４案,南投縣,南投市,平山里,69,1393,176,559,735,38,773
公投第１４案,南投縣,南投市,新興里,70,1059,146,447,593,22,615
公投第１４案,南投縣,南投市,新興里,71,1218,171,509,680,26,706
公投第１４案,南投縣,南投市,新興里,72,1293,213,482,695,20,715
公投第１４案,南投縣,南投市,新興里,73,1337,154,491,645,32,677
公投第１４案,南投縣,南投市,永豐里,74,876,150,382,532,26,558
公投第１４案,南投縣,南投市,永豐里,75,971,154,384,538,25,563
公投第１４案,南投縣,南投市,永豐里,76,1012,166,401,567,28,595
公投第１４案,南投縣,南投市,福興里,77,973,122,396,518,32,550
公投第１４案,南投縣,南投市,福興里,78,1002,171,420,591,36,627
公投第１４案,南投縣,南投市,福興里,79,1024,177,407,584,27,611
公投第１４案,南投縣,南投市,鳳山里,80,1122,156,351,507,85,592
公投第１４案,南投縣,南投市,永興里,81,790,109,263,372,28,400
公投第１４案,南投縣,南投市,鳳鳴里,82,647,76,214,290,10,300
公投第１４案,南投縣,南投市,福山里,83,950,139,346,485,50,535
公投第１４案,南投縣,南投市,福山里,84,980,154,354,508,19,527
公投第１４案,南投縣,埔里鎮,東門里,85,828,129,338,467,35,502
公投第１４案,南投縣,埔里鎮,東門里,86,786,128,332,460,35,495
公投第１４案,南投縣,埔里鎮,東門里,87,1062,125,451,576,32,608
公投第１４案,南投縣,埔里鎮,杷城里,88,1201,194,515,709,44,753
公投第１４案,南投縣,埔里鎮,杷城里,89,1415,185,769,954,23,977
公投第１４案,南投縣,埔里鎮,枇杷里,90,1282,179,517,696,30,726
公投第１４案,南投縣,埔里鎮,枇杷里,91,859,106,366,472,36,508
公投第１４案,南投縣,埔里鎮,枇杷里,92,1288,187,487,674,72,746
公投第１４案,南投縣,埔里鎮,枇杷里,93,1330,207,522,729,21,750
公投第１４案,南投縣,埔里鎮,枇杷里,94,1416,201,522,723,42,765
公投第１４案,南投縣,埔里鎮,枇杷里,95,1283,169,455,624,22,646
公投第１４案,南投縣,埔里鎮,水頭里,96,1151,153,486,639,61,700
公投第１４案,南投縣,埔里鎮,水頭里,97,1193,166,441,607,28,635
公投第１４案,南投縣,埔里鎮,水頭里,98,1471,132,659,791,53,844
公投第１４案,南投縣,埔里鎮,麒麟里,99,1044,112,351,463,70,533
公投第１４案,南投縣,埔里鎮,珠格里,100,1122,145,475,620,52,672
公投第１４案,南投縣,埔里鎮,溪南里,101,1129,172,527,699,31,730
公投第１４案,南投縣,埔里鎮,西門里,102,901,116,371,487,18,505
公投第１４案,南投縣,埔里鎮,西門里,103,997,134,370,504,41,545
公投第１４案,南投縣,埔里鎮,西門里,104,1209,177,460,637,12,649
公投第１４案,南投縣,埔里鎮,南門里,105,838,126,309,435,24,459
公投第１４案,南投縣,埔里鎮,北門里,106,1226,158,425,583,31,614
公投第１４案,南投縣,埔里鎮,北門里,107,1263,214,527,741,53,794
公投第１４案,南投縣,埔里鎮,北安里,108,1045,182,434,616,21,637
公投第１４案,南投縣,埔里鎮,北安里,109,1120,178,487,665,32,697
公投第１４案,南投縣,埔里鎮,北安里,110,1062,185,472,657,36,693
公投第１４案,南投縣,埔里鎮,北梅里,111,1022,156,413,569,28,597
公投第１４案,南投縣,埔里鎮,北梅里,112,1051,155,419,574,21,595
公投第１４案,南投縣,埔里鎮,北梅里,113,1106,161,443,604,24,628
公投第１４案,南投縣,埔里鎮,泰安里,114,1098,155,470,625,13,638
公投第１４案,南投縣,埔里鎮,泰安里,115,1067,158,442,600,32,632
公投第１４案,南投縣,埔里鎮,大湳里,116,725,274,114,388,41,429
公投第１４案,南投縣,埔里鎮,大湳里,117,905,147,378,525,28,553
公投第１４案,南投縣,埔里鎮,蜈蚣里,118,1179,174,429,603,42,645
公投第１４案,南投縣,埔里鎮,蜈蚣里,119,944,111,361,472,26,498
公投第１４案,南投縣,埔里鎮,蜈蚣里,120,465,58,179,237,32,269
公投第１４案,南投縣,埔里鎮,同聲里,121,1133,155,452,607,35,642
公投第１４案,南投縣,埔里鎮,同聲里,122,1100,148,421,569,36,605
公投第１４案,南投縣,埔里鎮,清新里,123,1155,169,457,626,45,671
公投第１４案,南投縣,埔里鎮,清新里,124,1254,175,445,620,55,675
公投第１４案,南投縣,埔里鎮,清新里,125,1296,174,483,657,43,700
公投第１４案,南投縣,埔里鎮,薰化里,126,1023,175,456,631,33,664
公投第１４案,南投縣,埔里鎮,大城里,127,964,99,375,474,15,489
公投第１４案,南投縣,埔里鎮,大城里,128,986,152,403,555,27,582
公投第１４案,南投縣,埔里鎮,大城里,129,1016,153,434,587,26,613
公投第１４案,南投縣,埔里鎮,大城里,130,898,135,368,503,33,536
公投第１４案,南投縣,埔里鎮,大城里,131,980,150,415,565,35,600
公投第１４案,南投縣,埔里鎮,大城里,132,933,127,411,538,22,560
公投第１４案,南投縣,埔里鎮,籃城里,133,929,176,435,611,36,647
公投第１４案,南投縣,埔里鎮,桃米里,134,1032,149,399,548,40,588
公投第１４案,南投縣,埔里鎮,成功里,135,315,32,126,158,9,167
公投第１４案,南投縣,埔里鎮,南村里,136,1363,172,498,670,73,743
公投第１４案,南投縣,埔里鎮,愛蘭里,137,725,112,305,417,24,441
公投第１４案,南投縣,埔里鎮,愛蘭里,138,705,94,309,403,24,427
公投第１４案,南投縣,埔里鎮,鐵山里,139,751,127,332,459,31,490
公投第１４案,南投縣,埔里鎮,鐵山里,140,932,136,360,496,38,534
公投第１４案,南投縣,埔里鎮,房里里,141,956,149,383,532,27,559
公投第１４案,南投縣,埔里鎮,房里里,142,376,51,153,204,19,223
公投第１４案,南投縣,埔里鎮,向善里,143,682,102,277,379,29,408
公投第１４案,南投縣,埔里鎮,一新里,144,990,67,533,600,46,646
公投第１４案,南投縣,埔里鎮,合成里,145,1324,172,435,607,65,672
公投第１４案,南投縣,埔里鎮,合成里,146,298,40,92,132,16,148
公投第１４案,南投縣,埔里鎮,廣成里,147,1170,113,484,597,57,654
公投第１４案,南投縣,埔里鎮,史港里,148,604,83,259,342,19,361
公投第１４案,南投縣,埔里鎮,福興里,149,999,129,394,523,28,551
公投第１４案,南投縣,埔里鎮,牛眠里,150,923,219,250,469,17,486
公投第１４案,南投縣,埔里鎮,牛眠里,151,887,131,374,505,30,535
公投第１４案,南投縣,埔里鎮,牛眠里,152,981,122,383,505,29,534
公投第１４案,南投縣,草屯鎮,玉峰里,153,998,187,424,611,19,630
公投第１４案,南投縣,草屯鎮,玉峰里,154,1127,183,425,608,22,630
公投第１４案,南投縣,草屯鎮,明正里,155,1401,203,529,732,30,762
公投第１４案,南投縣,草屯鎮,明正里,156,1110,168,428,596,30,626
公投第１４案,南投縣,草屯鎮,明正里,157,1285,170,575,745,43,788
公投第１４案,南投縣,草屯鎮,炎峰里,158,936,131,382,513,30,543
公投第１４案,南投縣,草屯鎮,炎峰里,159,1141,190,433,623,42,665
公投第１４案,南投縣,草屯鎮,中正里,160,705,135,285,420,25,445
公投第１４案,南投縣,草屯鎮,和平里,161,1121,221,467,688,19,707
公投第１４案,南投縣,草屯鎮,中山里,162,877,153,404,557,25,582
公投第１４案,南投縣,草屯鎮,中山里,163,1401,249,530,779,41,820
公投第１４案,南投縣,草屯鎮,敦和里,164,1267,149,503,652,44,696
公投第１４案,南投縣,草屯鎮,敦和里,165,1214,190,476,666,56,722
公投第１４案,南投縣,草屯鎮,敦和里,166,1259,187,511,698,52,750
公投第１４案,南投縣,草屯鎮,敦和里,167,1442,265,578,843,32,875
公投第１４案,南投縣,草屯鎮,敦和里,168,1273,180,554,734,31,765
公投第１４案,南投縣,草屯鎮,山腳里,169,1145,199,436,635,24,659
公投第１４案,南投縣,草屯鎮,山腳里,170,1279,192,512,704,20,724
公投第１４案,南投縣,草屯鎮,山腳里,171,1158,164,466,630,23,653
公投第１４案,南投縣,草屯鎮,山腳里,172,1335,232,615,847,32,879
公投第１４案,南投縣,草屯鎮,山腳里,173,1178,229,508,737,30,767
公投第１４案,南投縣,草屯鎮,山腳里,174,1327,260,502,762,27,789
公投第１４案,南投縣,草屯鎮,新厝里,175,1000,165,420,585,21,606
公投第１４案,南投縣,草屯鎮,新厝里,176,1257,198,496,694,37,731
公投第１４案,南投縣,草屯鎮,新厝里,177,883,143,405,548,22,570
公投第１４案,南投縣,草屯鎮,上林里,178,1121,155,444,599,23,622
公投第１４案,南投縣,草屯鎮,上林里,179,1043,163,428,591,30,621
公投第１４案,南投縣,草屯鎮,上林里,180,979,174,417,591,14,605
公投第１４案,南投縣,草屯鎮,碧峰里,181,1048,145,383,528,17,545
公投第１４案,南投縣,草屯鎮,碧峰里,182,1009,135,412,547,31,578
公投第１４案,南投縣,草屯鎮,碧峰里,183,1138,147,444,591,26,617
公投第１４案,南投縣,草屯鎮,碧峰里,184,1197,196,459,655,16,671
公投第１４案,南投縣,草屯鎮,碧洲里,185,1364,215,562,777,34,811
公投第１４案,南投縣,草屯鎮,碧洲里,186,1059,253,355,608,34,642
公投第１４案,南投縣,草屯鎮,復興里,187,1108,189,438,627,34,661
公投第１４案,南投縣,草屯鎮,復興里,188,879,126,348,474,31,505
公投第１４案,南投縣,草屯鎮,復興里,189,957,138,390,528,40,568
公投第１４案,南投縣,草屯鎮,御史里,190,1395,190,469,659,17,676
公投第１４案,南投縣,草屯鎮,御史里,191,1101,177,477,654,29,683
公投第１４案,南投縣,草屯鎮,御史里,192,1297,203,474,677,22,699
公投第１４案,南投縣,草屯鎮,御史里,193,877,128,264,392,20,412
公投第１４案,南投縣,草屯鎮,御史里,194,1376,192,439,631,50,681
公投第１４案,南投縣,草屯鎮,新豐里,195,1008,166,441,607,42,649
公投第１４案,南投縣,草屯鎮,新豐里,196,1080,174,457,631,37,668
公投第１４案,南投縣,草屯鎮,新豐里,197,1017,153,379,532,37,569
公投第１４案,南投縣,草屯鎮,新豐里,198,961,146,421,567,46,613
公投第１４案,南投縣,草屯鎮,新庄里,199,1160,194,481,675,38,713
公投第１４案,南投縣,草屯鎮,新庄里,200,1121,175,457,632,31,663
公投第１４案,南投縣,草屯鎮,新庄里,201,1243,173,513,686,34,720
公投第１４案,南投縣,草屯鎮,加老里,202,932,152,378,530,28,558
公投第１４案,南投縣,草屯鎮,加老里,203,1323,250,576,826,39,865
公投第１４案,南投縣,草屯鎮,石川里,204,1518,188,584,772,31,803
公投第１４案,南投縣,草屯鎮,北投里,205,923,176,369,545,42,587
公投第１４案,南投縣,草屯鎮,北投里,206,970,161,338,499,35,534
公投第１４案,南投縣,草屯鎮,北投里,207,1026,182,391,573,30,603
公投第１４案,南投縣,草屯鎮,富寮里,208,1466,246,547,793,39,832
公投第１４案,南投縣,草屯鎮,富寮里,209,1180,180,469,649,27,676
公投第１４案,南投縣,草屯鎮,富寮里,210,1006,175,420,595,18,613
公投第１４案,南投縣,草屯鎮,富寮里,211,1000,142,333,475,32,507
公投第１４案,南投縣,草屯鎮,富寮里,212,1128,214,474,688,14,702
公投第１４案,南投縣,草屯鎮,富寮里,213,623,106,235,341,16,357
公投第１４案,南投縣,草屯鎮,北勢里,214,707,105,277,382,37,419
公投第１４案,南投縣,草屯鎮,北勢里,215,719,104,262,366,27,393
公投第１４案,南投縣,草屯鎮,北勢里,216,527,74,165,239,19,258
公投第１４案,南投縣,草屯鎮,中原里,217,1183,199,460,659,49,708
公投第１４案,南投縣,草屯鎮,中原里,218,869,145,365,510,25,535
公投第１４案,南投縣,草屯鎮,南埔里,219,1132,197,367,564,20,584
公投第１４案,南投縣,草屯鎮,南埔里,220,949,147,382,529,39,568
公投第１４案,南投縣,草屯鎮,南埔里,221,965,157,401,558,26,584
公投第１４案,南投縣,草屯鎮,南埔里,222,1068,168,392,560,31,591
公投第１４案,南投縣,草屯鎮,坪頂里,223,1024,153,419,572,51,623
公投第１４案,南投縣,草屯鎮,土城里,224,642,71,265,336,18,354
公投第１４案,南投縣,草屯鎮,土城里,225,1017,132,373,505,32,537
公投第１４案,南投縣,草屯鎮,平林里,226,1092,143,462,605,20,625
公投第１４案,南投縣,草屯鎮,雙冬里,227,1170,167,446,613,41,654
公投第１４案,南投縣,草屯鎮,雙冬里,228,1106,160,472,632,33,665
公投第１４案,南投縣,竹山鎮,竹山里,229,1170,174,487,661,42,703
公投第１４案,南投縣,竹山鎮,竹山里,230,850,136,350,486,46,532
公投第１４案,南投縣,竹山鎮,中正里,231,621,77,241,318,24,342
公投第１４案,南投縣,竹山鎮,中山里,232,905,146,342,488,30,518
公投第１４案,南投縣,竹山鎮,中山里,233,1099,123,392,515,41,556
公投第１４案,南投縣,竹山鎮,中山里,234,1214,126,478,604,42,646
公投第１４案,南投縣,竹山鎮,中山里,235,1287,209,521,730,49,779
公投第１４案,南投縣,竹山鎮,雲林里,236,1191,164,462,626,46,672
公投第１４案,南投縣,竹山鎮,雲林里,237,1118,173,408,581,53,634
公投第１４案,南投縣,竹山鎮,雲林里,238,1278,212,501,713,23,736
公投第１４案,南投縣,竹山鎮,竹圍里,239,1153,200,433,633,43,676
公投第１４案,南投縣,竹山鎮,竹圍里,240,1243,179,434,613,49,662
公投第１４案,南投縣,竹山鎮,桂林里,241,1308,203,501,704,39,743
公投第１４案,南投縣,竹山鎮,桂林里,242,1358,175,516,691,34,725
公投第１４案,南投縣,竹山鎮,桂林里,243,1044,142,392,534,42,576
公投第１４案,南投縣,竹山鎮,下坪里,244,511,86,211,297,24,321
公投第１４案,南投縣,竹山鎮,下坪里,245,682,102,252,354,16,370
公投第１４案,南投縣,竹山鎮,中和里,246,989,132,335,467,24,491
公投第１４案,南投縣,竹山鎮,中崎里,247,1378,169,553,722,39,761
公投第１４案,南投縣,竹山鎮,秀林里,248,217,33,84,117,2,119
公投第１４案,南投縣,竹山鎮,秀林里,249,479,71,196,267,21,288
公投第１４案,南投縣,竹山鎮,大鞍里,250,430,41,157,198,13,211
公投第１４案,南投縣,竹山鎮,延和里,251,1437,222,542,764,43,807
公投第１４案,南投縣,竹山鎮,延和里,252,1286,199,537,736,39,775
公投第１４案,南投縣,竹山鎮,延和里,253,1080,158,464,622,34,656
公投第１４案,南投縣,竹山鎮,延和里,254,1070,175,393,568,31,599
公投第１４案,南投縣,竹山鎮,延祥里,255,1295,187,531,718,32,750
公投第１４案,南投縣,竹山鎮,延祥里,256,1047,128,435,563,37,600
公投第１４案,南投縣,竹山鎮,延祥里,257,1300,177,507,684,44,728
公投第１４案,南投縣,竹山鎮,延正里,258,908,104,306,410,23,433
公投第１４案,南投縣,竹山鎮,延正里,259,821,123,244,367,55,422
公投第１４案,南投縣,竹山鎮,延平里,260,1320,200,517,717,49,766
公投第１４案,南投縣,竹山鎮,延平里,261,967,141,352,493,30,523
公投第１４案,南投縣,竹山鎮,延平里,262,595,64,223,287,22,309
公投第１４案,南投縣,竹山鎮,延山里,263,859,111,311,422,55,477
公投第１４案,南投縣,竹山鎮,山崇里,264,1196,164,431,595,53,648
公投第１４案,南投縣,竹山鎮,山崇里,265,649,95,242,337,33,370
公投第１４案,南投縣,竹山鎮,社寮里,266,1341,197,509,706,47,753
公投第１４案,南投縣,竹山鎮,中央里,267,1222,143,436,579,53,632
公投第１４案,南投縣,竹山鎮,富州里,268,602,93,237,330,19,349
公投第１４案,南投縣,竹山鎮,田子里,269,617,90,234,324,22,346
公投第１４案,南投縣,竹山鎮,硘磘里,270,793,133,327,460,28,488
公投第１４案,南投縣,竹山鎮,硘磘里,271,922,141,364,505,31,536
公投第１４案,南投縣,竹山鎮,德興里,272,366,34,140,174,21,195
公投第１４案,南投縣,竹山鎮,德興里,273,509,41,195,236,8,244
公投第１４案,南投縣,竹山鎮,福興里,274,193,20,83,103,6,109
公投第１４案,南投縣,竹山鎮,福興里,275,406,73,160,233,19,252
公投第１４案,南投縣,竹山鎮,鯉魚里,276,495,62,167,229,23,252
公投第１４案,南投縣,竹山鎮,鯉魚里,277,307,25,84,109,9,118
公投第１４案,南投縣,竹山鎮,坪頂里,278,440,38,166,204,33,237
公投第１４案,南投縣,竹山鎮,瑞竹里,279,577,63,219,282,32,314
公投第１４案,南投縣,竹山鎮,桶頭里,280,486,43,139,182,30,212
公投第１４案,南投縣,竹山鎮,桶頭里,281,403,31,106,137,11,148
公投第１４案,南投縣,集集鎮,集集里,282,1070,165,458,623,33,656
公投第１４案,南投縣,集集鎮,和平里,283,918,129,390,519,40,559
公投第１４案,南投縣,集集鎮,林尾里,284,581,94,228,322,33,355
公投第１４案,南投縣,集集鎮,田寮里,285,1194,176,492,668,48,716
公投第１４案,南投縣,集集鎮,隘寮里,286,488,59,148,207,15,222
公投第１４案,南投縣,集集鎮,玉映里,287,504,75,209,284,29,313
公投第１４案,南投縣,集集鎮,吳厝里,288,910,135,355,490,73,563
公投第１４案,南投縣,集集鎮,八張里,289,773,134,311,445,36,481
公投第１４案,南投縣,集集鎮,八張里,290,709,125,261,386,16,402
公投第１４案,南投縣,集集鎮,永昌里,291,960,166,371,537,16,553
公投第１４案,南投縣,集集鎮,廣明里,292,503,76,180,256,20,276
公投第１４案,南投縣,集集鎮,廣明里,293,419,67,132,199,13,212
公投第１４案,南投縣,集集鎮,富山里,294,582,67,191,258,13,271
公投第１４案,南投縣,名間鄉,南雅村,295,1050,189,491,680,51,731
公投第１４案,南投縣,名間鄉,中正村,296,920,130,378,508,48,556
公投第１４案,南投縣,名間鄉,中正村,297,727,102,347,449,29,478
公投第１４案,南投縣,名間鄉,中正村,298,861,133,400,533,21,554
公投第１４案,南投縣,名間鄉,中正村,299,897,130,363,493,36,529
公投第１４案,南投縣,名間鄉,中山村,300,1055,157,452,609,40,649
公投第１４案,南投縣,名間鄉,中山村,301,1184,174,471,645,52,697
公投第１４案,南投縣,名間鄉,濁水村,302,783,109,300,409,37,446
公投第１４案,南投縣,名間鄉,濁水村,303,781,106,351,457,32,489
公投第１４案,南投縣,名間鄉,新民村,304,977,141,384,525,36,561
公投第１４案,南投縣,名間鄉,炭寮村,305,1015,158,379,537,36,573
公投第１４案,南投縣,名間鄉,新街村,306,914,142,388,530,33,563
公投第１４案,南投縣,名間鄉,新街村,307,1028,170,377,547,14,561
公投第１４案,南投縣,名間鄉,新街村,308,1018,145,438,583,33,616
公投第１４案,南投縣,名間鄉,新街村,309,1274,280,422,702,54,756
公投第１４案,南投縣,名間鄉,東湖村,310,755,112,315,427,29,456
公投第１４案,南投縣,名間鄉,東湖村,311,895,137,418,555,37,592
公投第１４案,南投縣,名間鄉,仁和村,312,892,138,367,505,22,527
公投第１４案,南投縣,名間鄉,萬丹村,313,951,142,363,505,47,552
公投第１４案,南投縣,名間鄉,田仔村,314,1261,153,528,681,45,726
公投第１４案,南投縣,名間鄉,大坑村,315,768,117,294,411,33,444
公投第１４案,南投縣,名間鄉,大庄村,316,962,143,397,540,45,585
公投第１４案,南投縣,名間鄉,大庄村,317,867,124,369,493,42,535
公投第１４案,南投縣,名間鄉,廍下村,318,930,163,344,507,61,568
公投第１４案,南投縣,名間鄉,赤水村,319,641,91,257,348,40,388
公投第１４案,南投縣,名間鄉,赤水村,320,530,60,205,265,17,282
公投第１４案,南投縣,名間鄉,竹圍村,321,931,162,347,509,52,561
公投第１４案,南投縣,名間鄉,三崙村,322,1127,154,475,629,41,670
公投第１４案,南投縣,名間鄉,三崙村,323,443,71,195,266,29,295
公投第１４案,南投縣,名間鄉,松山村,324,870,126,373,499,35,534
公投第１４案,南投縣,名間鄉,松山村,325,621,108,254,362,33,395
公投第１４案,南投縣,名間鄉,松柏村,326,1179,176,441,617,26,643
公投第１４案,南投縣,名間鄉,崁腳村,327,881,149,378,527,36,563
公投第１４案,南投縣,名間鄉,埔中村,328,876,135,434,569,27,596
公投第１４案,南投縣,名間鄉,新厝村,329,783,107,335,442,34,476
公投第１４案,南投縣,名間鄉,新光村,330,778,84,308,392,32,424
公投第１４案,南投縣,名間鄉,新光村,331,983,141,362,503,40,543
公投第１４案,南投縣,鹿谷鄉,鹿谷村,332,934,94,358,452,32,484
公投第１４案,南投縣,鹿谷鄉,鹿谷村,333,940,367,141,508,33,541
公投第１４案,南投縣,鹿谷鄉,彰雅村,334,852,135,297,432,25,457
公投第１４案,南投縣,鹿谷鄉,彰雅村,335,451,68,132,200,18,218
公投第１４案,南投縣,鹿谷鄉,廣興村,336,810,331,145,476,20,496
公投第１４案,南投縣,鹿谷鄉,廣興村,337,1142,169,505,674,38,712
公投第１４案,南投縣,鹿谷鄉,永隆村,338,766,98,266,364,16,380
公投第１４案,南投縣,鹿谷鄉,永隆村,339,884,115,362,477,41,518
公投第１４案,南投縣,鹿谷鄉,鳳凰村,340,811,129,299,428,32,460
公投第１４案,南投縣,鹿谷鄉,鳳凰村,341,581,70,184,254,22,276
公投第１４案,南投縣,鹿谷鄉,內湖村,342,578,73,199,272,23,295
公投第１４案,南投縣,鹿谷鄉,內湖村,343,467,64,189,253,26,279
公投第１４案,南投縣,鹿谷鄉,和雅村,344,622,66,259,325,21,346
公投第１４案,南投縣,鹿谷鄉,竹林村,345,740,93,266,359,25,384
公投第１４案,南投縣,鹿谷鄉,竹林村,346,767,84,317,401,32,433
公投第１４案,南投縣,鹿谷鄉,竹豐村,347,909,114,381,495,36,531
公投第１４案,南投縣,鹿谷鄉,初鄉村,348,713,99,156,255,19,274
公投第１４案,南投縣,鹿谷鄉,初鄉村,349,717,84,233,317,21,338
公投第１４案,南投縣,鹿谷鄉,秀峰村,350,794,105,272,377,31,408
公投第１４案,南投縣,鹿谷鄉,清水村,351,726,100,250,350,14,364
公投第１４案,南投縣,鹿谷鄉,瑞田村,352,737,83,220,303,27,330
公投第１４案,南投縣,中寮鄉,廣興村,353,822,128,351,479,28,507
公投第１４案,南投縣,中寮鄉,崁頂村,354,253,39,103,142,13,155
公投第１４案,南投縣,中寮鄉,崁頂村,355,221,24,67,91,4,95
公投第１４案,南投縣,中寮鄉,八仙村,356,353,39,122,161,6,167
公投第１４案,南投縣,中寮鄉,八仙村,357,427,58,169,227,9,236
公投第１４案,南投縣,中寮鄉,福盛村,358,406,45,176,221,11,232
公投第１４案,南投縣,中寮鄉,福盛村,359,307,27,110,137,24,161
公投第１４案,南投縣,中寮鄉,和興村,360,661,71,305,376,27,403
公投第１４案,南投縣,中寮鄉,復興村,361,290,50,133,183,10,193
公投第１４案,南投縣,中寮鄉,永平村,362,973,163,374,537,38,575
公投第１４案,南投縣,中寮鄉,永平村,363,754,119,317,436,20,456
公投第１４案,南投縣,中寮鄉,中寮村,364,662,73,270,343,25,368
公投第１４案,南投縣,中寮鄉,廣福村,365,490,41,185,226,10,236
公投第１４案,南投縣,中寮鄉,永福村,366,335,40,121,161,15,176
公投第１４案,南投縣,中寮鄉,永福村,367,990,132,412,544,31,575
公投第１４案,南投縣,中寮鄉,義和村,368,461,58,217,275,21,296
公投第１４案,南投縣,中寮鄉,義和村,369,614,98,265,363,18,381
公投第１４案,南投縣,中寮鄉,清水村,370,895,113,356,469,43,512
公投第１４案,南投縣,中寮鄉,內城村,371,465,57,182,239,26,265
公投第１４案,南投縣,中寮鄉,龍安村,372,682,106,251,357,45,402
公投第１４案,南投縣,中寮鄉,爽文村,373,490,201,77,278,25,303
公投第１４案,南投縣,中寮鄉,龍岩村,374,643,82,277,359,35,394
公投第１４案,南投縣,中寮鄉,永芳村,375,459,60,209,269,15,284
公投第１４案,南投縣,中寮鄉,永和村,376,528,57,189,246,19,265
公投第１４案,南投縣,魚池鄉,魚池村,377,922,150,344,494,37,531
公投第１４案,南投縣,魚池鄉,魚池村,378,1098,190,410,600,49,649
公投第１４案,南投縣,魚池鄉,東池村,379,720,91,270,361,26,387
公投第１４案,南投縣,魚池鄉,東池村,380,860,127,347,474,34,508
公投第１４案,南投縣,魚池鄉,大林村,381,514,50,189,239,24,263
公投第１４案,南投縣,魚池鄉,大林村,382,574,76,204,280,11,291
公投第１４案,南投縣,魚池鄉,東光村,383,1249,173,454,627,49,676
公投第１４案,南投縣,魚池鄉,共和村,384,293,49,140,189,5,194
公投第１４案,南投縣,魚池鄉,共和村,385,513,67,195,262,17,279
公投第１４案,南投縣,魚池鄉,共和村,386,186,27,70,97,6,103
公投第１４案,南投縣,魚池鄉,新城村,387,841,104,313,417,26,443
公投第１４案,南投縣,魚池鄉,新城村,388,270,52,102,154,16,170
公投第１４案,南投縣,魚池鄉,新城村,389,275,32,108,140,15,155
公投第１４案,南投縣,魚池鄉,大雁村,390,282,26,97,123,8,131
公投第１４案,南投縣,魚池鄉,大雁村,391,392,52,139,191,6,197
公投第１４案,南投縣,魚池鄉,五城村,392,556,76,202,278,28,306
公投第１４案,南投縣,魚池鄉,五城村,393,176,18,73,91,7,98
公投第１４案,南投縣,魚池鄉,中明村,394,578,173,74,247,25,272
公投第１４案,南投縣,魚池鄉,中明村,395,439,61,143,204,20,224
公投第１４案,南投縣,魚池鄉,水社村,396,844,123,348,471,25,496
公投第１４案,南投縣,魚池鄉,日月村,397,868,317,130,447,22,469
公投第１４案,南投縣,魚池鄉,頭社村,398,405,44,136,180,10,190
公投第１４案,南投縣,魚池鄉,頭社村,399,537,85,205,290,17,307
公投第１４案,南投縣,魚池鄉,武登村,400,335,35,134,169,14,183
公投第１４案,南投縣,魚池鄉,武登村,401,231,17,77,94,10,104
公投第１４案,南投縣,國姓鄉,國姓村,402,964,118,429,547,56,603
公投第１４案,南投縣,國姓鄉,國姓村,403,736,88,305,393,23,416
公投第１４案,南投縣,國姓鄉,石門村,404,801,89,338,427,48,475
公投第１４案,南投縣,國姓鄉,石門村,405,964,145,391,536,17,553
公投第１４案,南投縣,國姓鄉,大旗村,406,686,94,265,359,27,386
公投第１４案,南投縣,國姓鄉,長流村,407,661,253,88,341,21,362
公投第１４案,南投縣,國姓鄉,長流村,408,730,79,270,349,30,379
公投第１４案,南投縣,國姓鄉,長豐村,409,774,102,296,398,37,435
公投第１４案,南投縣,國姓鄉,長福村,410,706,101,300,401,18,419
公投第１４案,南投縣,國姓鄉,北港村,411,1012,124,415,539,36,575
公投第１４案,南投縣,國姓鄉,北港村,412,868,102,294,396,15,411
公投第１４案,南投縣,國姓鄉,福龜村,413,918,122,416,538,23,561
公投第１４案,南投縣,國姓鄉,福龜村,414,937,120,373,493,42,535
公投第１４案,南投縣,國姓鄉,乾溝村,415,815,95,313,408,42,450
公投第１４案,南投縣,國姓鄉,柑林村,416,1134,159,492,651,35,686
公投第１４案,南投縣,國姓鄉,大石村,417,714,95,275,370,24,394
公投第１４案,南投縣,國姓鄉,北山村,418,1095,174,447,621,35,656
公投第１４案,南投縣,國姓鄉,北山村,419,448,55,162,217,20,237
公投第１４案,南投縣,國姓鄉,南港村,420,1064,102,422,524,47,571
公投第１４案,南投縣,國姓鄉,南港村,421,570,61,222,283,17,300
公投第１４案,南投縣,水里鄉,水里村,422,757,91,305,396,27,423
公投第１４案,南投縣,水里鄉,新城村,423,554,68,211,279,35,314
公投第１４案,南投縣,水里鄉,新城村,424,999,159,376,535,44,579
公投第１４案,南投縣,水里鄉,中央村,425,616,80,239,319,19,338
公投第１４案,南投縣,水里鄉,城中村,426,875,134,367,501,24,525
公投第１４案,南投縣,水里鄉,農富村,427,480,75,207,282,12,294
公投第１４案,南投縣,水里鄉,車埕村,428,450,68,161,229,19,248
公投第１４案,南投縣,水里鄉,新興村,429,643,91,232,323,32,355
公投第１４案,南投縣,水里鄉,北埔村,430,1004,142,417,559,28,587
公投第１４案,南投縣,水里鄉,南光村,431,741,107,290,397,13,410
公投第１４案,南投縣,水里鄉,南光村,432,802,155,302,457,12,469
公投第１４案,南投縣,水里鄉,鉅工村,433,998,213,378,591,50,641
公投第１４案,南投縣,水里鄉,永豐村,434,800,126,279,405,38,443
公投第１４案,南投縣,水里鄉,永豐村,435,589,73,274,347,19,366
公投第１４案,南投縣,水里鄉,民和村,436,887,104,315,419,52,471
公投第１４案,南投縣,水里鄉,頂崁村,437,1217,155,448,603,32,635
公投第１４案,南投縣,水里鄉,新山村,438,205,23,56,79,3,82
公投第１４案,南投縣,水里鄉,郡坑村,439,330,42,144,186,23,209
公投第１４案,南投縣,水里鄉,上安村,440,1100,124,425,549,33,582
公投第１４案,南投縣,水里鄉,興隆村,441,275,29,70,99,4,103
公投第１４案,南投縣,水里鄉,永興村,442,318,51,88,139,1,140
公投第１４案,南投縣,水里鄉,玉峰村,443,818,99,303,402,44,446
公投第１４案,南投縣,信義鄉,明德村,444,1201,146,466,612,67,679
公投第１４案,南投縣,信義鄉,明德村,445,329,28,135,163,14,177
公投第１４案,南投縣,信義鄉,愛國村,446,516,66,187,253,18,271
公投第１４案,南投縣,信義鄉,自強村,447,424,50,135,185,19,204
公投第１４案,南投縣,信義鄉,自強村,448,321,44,119,163,6,169
公投第１４案,南投縣,信義鄉,豐丘村,449,648,81,307,388,28,416
公投第１４案,南投縣,信義鄉,新鄉村,450,584,60,342,402,36,438
公投第１４案,南投縣,信義鄉,羅娜村,451,1376,107,624,731,26,757
公投第１４案,南投縣,信義鄉,望美村,452,979,423,99,522,25,547
公投第１４案,南投縣,信義鄉,望美村,453,530,56,302,358,36,394
公投第１４案,南投縣,信義鄉,同富村,454,961,121,356,477,33,510
公投第１４案,南投縣,信義鄉,同富村,455,464,47,196,243,14,257
公投第１４案,南投縣,信義鄉,神木村,456,517,68,210,278,27,305
公投第１４案,南投縣,信義鄉,神木村,457,149,24,59,83,6,89
公投第１４案,南投縣,信義鄉,東埔村,458,1020,91,608,699,63,762
公投第１４案,南投縣,信義鄉,人和村,459,929,74,506,580,58,638
公投第１４案,南投縣,信義鄉,人和村,460,274,25,95,120,9,129
公投第１４案,南投縣,信義鄉,地利村,461,900,98,502,600,37,637
公投第１４案,南投縣,信義鄉,雙龍村,462,617,72,346,418,33,451
公投第１４案,南投縣,信義鄉,潭南村,463,560,71,290,361,28,389
公投第１４案,南投縣,仁愛鄉,南豐村,464,973,399,124,523,25,548
公投第１４案,南投縣,仁愛鄉,南豐村,465,296,34,101,135,15,150
公投第１４案,南投縣,仁愛鄉,大同村,466,900,111,327,438,17,455
公投第１４案,南投縣,仁愛鄉,大同村,467,460,77,206,283,15,298
公投第１４案,南投縣,仁愛鄉,大同村,468,305,35,138,173,10,183
公投第１４案,南投縣,仁愛鄉,榮興村,469,58,2,16,18,2,20
公投第１４案,南投縣,仁愛鄉,春陽村,470,952,96,417,513,11,524
公投第１４案,南投縣,仁愛鄉,精英村,471,679,59,244,303,6,309
公投第１４案,南投縣,仁愛鄉,都達村,472,623,78,251,329,40,369
公投第１４案,南投縣,仁愛鄉,合作村,473,597,44,171,215,4,219
公投第１４案,南投縣,仁愛鄉,發祥村,474,384,31,192,223,25,248
公投第１４案,南投縣,仁愛鄉,發祥村,475,121,7,51,58,4,62
公投第１４案,南投縣,仁愛鄉,發祥村,476,264,32,136,168,4,172
公投第１４案,南投縣,仁愛鄉,力行村,477,509,52,314,366,17,383
公投第１４案,南投縣,仁愛鄉,翠華村,478,338,26,164,190,17,207
公投第１４案,南投縣,仁愛鄉,翠華村,479,169,17,68,85,3,88
公投第１４案,南投縣,仁愛鄉,親愛村,480,613,71,203,274,19,293
公投第１４案,南投縣,仁愛鄉,親愛村,481,404,42,141,183,7,190
公投第１４案,南投縣,仁愛鄉,親愛村,482,134,15,62,77,1,78
公投第１４案,南投縣,仁愛鄉,萬豐村,483,630,66,308,374,34,408
公投第１４案,南投縣,仁愛鄉,法治村,484,763,78,288,366,14,380
公投第１４案,南投縣,仁愛鄉,中正村,485,889,77,471,548,30,578
公投第１４案,南投縣,仁愛鄉,互助村,486,672,83,320,403,35,438
公投第１４案,南投縣,仁愛鄉,互助村,487,447,63,197,260,14,274
公投第１４案,南投縣,仁愛鄉,新生村,488,409,238,61,299,6,305
公投第１４案,雲林縣,麥寮鄉,麥豐村,1,1497,159,446,605,52,657
公投第１４案,雲林縣,麥寮鄉,麥豐村,2,1738,230,593,823,50,873
公投第１４案,雲林縣,麥寮鄉,麥豐村,3,1921,248,653,901,55,956
公投第１４案,雲林縣,麥寮鄉,麥豐村,4,1832,241,586,827,55,882
公投第１４案,雲林縣,麥寮鄉,麥津村,5,1340,188,369,557,55,612
公投第１４案,雲林縣,麥寮鄉,麥津村,6,1138,151,351,502,50,552
公投第１４案,雲林縣,麥寮鄉,麥津村,7,1551,187,522,709,48,757
公投第１４案,雲林縣,麥寮鄉,瓦磘村,8,715,78,209,287,25,312
公投第１４案,雲林縣,麥寮鄉,瓦磘村,9,1194,144,325,469,51,520
公投第１４案,雲林縣,麥寮鄉,興華村,10,1023,119,337,456,32,488
公投第１４案,雲林縣,麥寮鄉,興華村,11,1558,167,402,569,36,605
公投第１４案,雲林縣,麥寮鄉,海豐村,12,1187,146,307,453,25,478
公投第１４案,雲林縣,麥寮鄉,海豐村,13,983,117,285,402,20,422
公投第１４案,雲林縣,麥寮鄉,後安村,14,1363,270,355,625,61,686
公投第１４案,雲林縣,麥寮鄉,後安村,15,1596,182,525,707,61,768
公投第１４案,雲林縣,麥寮鄉,中興村,16,1469,230,559,789,73,862
公投第１４案,雲林縣,麥寮鄉,三盛村,17,964,125,262,387,45,432
公投第１４案,雲林縣,麥寮鄉,三盛村,18,1038,121,292,413,33,446
公投第１４案,雲林縣,麥寮鄉,崙後村,19,1230,146,423,569,52,621
公投第１４案,雲林縣,麥寮鄉,崙後村,20,1329,164,443,607,46,653
公投第１４案,雲林縣,麥寮鄉,橋頭村,21,1129,130,403,533,72,605
公投第１４案,雲林縣,麥寮鄉,橋頭村,22,1241,195,431,626,74,700
公投第１４案,雲林縣,麥寮鄉,橋頭村,23,1471,208,505,713,93,806
公投第１４案,雲林縣,麥寮鄉,新吉村,24,1107,169,410,579,60,639
公投第１４案,雲林縣,麥寮鄉,施厝村,25,1636,227,606,833,67,900
公投第１４案,雲林縣,麥寮鄉,施厝村,26,1755,227,585,812,44,856
公投第１４案,雲林縣,麥寮鄉,雷厝村,27,1158,157,430,587,35,622
公投第１４案,雲林縣,麥寮鄉,雷厝村,28,956,166,318,484,32,516
公投第１４案,雲林縣,臺西鄉,臺西村,29,1238,174,454,628,54,682
公投第１４案,雲林縣,臺西鄉,海南村,30,1091,120,358,478,38,516
公投第１４案,雲林縣,臺西鄉,海北村,31,1098,145,384,529,52,581
公投第１４案,雲林縣,臺西鄉,海口村,32,1048,124,299,423,30,453
公投第１４案,雲林縣,臺西鄉,海口村,33,1025,111,335,446,48,494
公投第１４案,雲林縣,臺西鄉,山寮村,34,850,107,285,392,37,429
公投第１４案,雲林縣,臺西鄉,溪頂村,35,1460,135,445,580,67,647
公投第１４案,雲林縣,臺西鄉,牛厝村,36,1180,96,275,371,66,437
公投第１４案,雲林縣,臺西鄉,牛厝村,37,710,49,168,217,22,239
公投第１４案,雲林縣,臺西鄉,泉州村,38,620,60,181,241,14,255
公投第１４案,雲林縣,臺西鄉,五榔村,39,449,61,125,186,27,213
公投第１４案,雲林縣,臺西鄉,光華村,40,687,65,171,236,39,275
公投第１４案,雲林縣,臺西鄉,五港村,41,1247,140,373,513,49,562
公投第１４案,雲林縣,臺西鄉,五港村,42,583,49,150,199,11,210
公投第１４案,雲林縣,臺西鄉,富琦村,43,1042,134,342,476,47,523
公投第１４案,雲林縣,臺西鄉,富琦村,44,472,56,147,203,16,219
公投第１４案,雲林縣,臺西鄉,永豐村,45,1409,136,430,566,31,597
公投第１４案,雲林縣,臺西鄉,和豐村,46,1061,132,366,498,64,562
公投第１４案,雲林縣,臺西鄉,和豐村,47,993,110,287,397,30,427
公投第１４案,雲林縣,臺西鄉,和豐村,48,1013,98,321,419,73,492
公投第１４案,雲林縣,臺西鄉,蚊港村,49,1233,139,434,573,31,604
公投第１４案,雲林縣,臺西鄉,蚊港村,50,616,67,181,248,16,264
公投第１４案,雲林縣,東勢鄉,月眉村,51,1207,319,185,504,37,541
公投第１４案,雲林縣,東勢鄉,復興村,52,540,83,220,303,27,330
公投第１４案,雲林縣,東勢鄉,嘉隆村,53,896,110,265,375,23,398
公投第１４案,雲林縣,東勢鄉,嘉隆村,54,728,110,248,358,36,394
公投第１４案,雲林縣,東勢鄉,東南村,55,1533,215,607,822,51,873
公投第１４案,雲林縣,東勢鄉,東北村,56,1203,178,476,654,66,720
公投第１４案,雲林縣,東勢鄉,龍潭村,57,817,89,259,348,45,393
公投第１４案,雲林縣,東勢鄉,程海村,58,546,82,215,297,28,325
公投第１４案,雲林縣,東勢鄉,昌南村,59,853,100,271,371,67,438
公投第１４案,雲林縣,東勢鄉,安南村,60,856,87,232,319,52,371
公投第１４案,雲林縣,東勢鄉,同安村,61,923,113,281,394,51,445
公投第１４案,雲林縣,東勢鄉,同安村,62,1022,132,348,480,37,517
公投第１４案,雲林縣,東勢鄉,四美村,63,634,46,179,225,17,242
公投第１４案,雲林縣,東勢鄉,四美村,64,394,49,112,161,15,176
公投第１４案,雲林縣,東勢鄉,新坤村,65,1087,92,294,386,48,434
公投第１４案,雲林縣,褒忠鄉,中民村,66,923,128,349,477,44,521
公投第１４案,雲林縣,褒忠鄉,中民村,67,993,184,373,557,27,584
公投第１４案,雲林縣,褒忠鄉,埔姜村,68,748,125,248,373,22,395
公投第１４案,雲林縣,褒忠鄉,埔姜村,69,702,115,231,346,11,357
公投第１４案,雲林縣,褒忠鄉,中勝村,70,752,94,272,366,20,386
公投第１４案,雲林縣,褒忠鄉,中勝村,71,756,130,255,385,20,405
公投第１４案,雲林縣,褒忠鄉,馬鳴村,72,490,75,171,246,12,258
公投第１４案,雲林縣,褒忠鄉,馬鳴村,73,1034,135,304,439,32,471
公投第１４案,雲林縣,褒忠鄉,新湖村,74,470,63,150,213,22,235
公投第１４案,雲林縣,褒忠鄉,新湖村,75,737,131,216,347,24,371
公投第１４案,雲林縣,褒忠鄉,有才村,76,878,111,297,408,28,436
公投第１４案,雲林縣,褒忠鄉,田洋村,77,778,103,248,351,39,390
公投第１４案,雲林縣,褒忠鄉,龍岩村,78,1224,191,395,586,45,631
公投第１４案,雲林縣,褒忠鄉,潮厝村,79,896,105,258,363,64,427
公投第１４案,雲林縣,土庫鎮,忠正里,80,809,138,325,463,48,511
公投第１４案,雲林縣,土庫鎮,順天里,81,896,155,345,500,38,538
公投第１４案,雲林縣,土庫鎮,宮北里,82,687,107,262,369,34,403
公投第１４案,雲林縣,土庫鎮,宮北里,83,702,128,317,445,27,472
公投第１４案,雲林縣,土庫鎮,越港里,84,1032,180,431,611,26,637
公投第１４案,雲林縣,土庫鎮,溪邊里,85,697,118,214,332,44,376
公投第１４案,雲林縣,土庫鎮,溪邊里,86,427,54,136,190,33,223
公投第１４案,雲林縣,土庫鎮,石廟里,87,1451,231,566,797,46,843
公投第１４案,雲林縣,土庫鎮,石廟里,88,1283,206,504,710,21,731
公投第１４案,雲林縣,土庫鎮,興新里,89,634,101,186,287,9,296
公投第１４案,雲林縣,土庫鎮,興新里,90,796,147,259,406,29,435
公投第１４案,雲林縣,土庫鎮,奮起里,91,745,99,191,290,43,333
公投第１４案,雲林縣,土庫鎮,奮起里,92,576,65,194,259,29,288
公投第１４案,雲林縣,土庫鎮,埤腳里,93,743,62,244,306,48,354
公投第１４案,雲林縣,土庫鎮,埤腳里,94,534,74,152,226,9,235
公投第１４案,雲林縣,土庫鎮,後埔里,95,1199,154,322,476,71,547
公投第１４案,雲林縣,土庫鎮,後埔里,96,1077,133,347,480,61,541
公投第１４案,雲林縣,土庫鎮,崙內里,97,819,91,236,327,27,354
公投第１４案,雲林縣,土庫鎮,崙內里,98,684,110,224,334,36,370
公投第１４案,雲林縣,土庫鎮,大荖里,99,843,117,302,419,46,465
公投第１４案,雲林縣,土庫鎮,東平里,100,916,124,310,434,55,489
公投第１４案,雲林縣,土庫鎮,東平里,101,948,117,323,440,36,476
公投第１４案,雲林縣,土庫鎮,南平里,102,914,125,333,458,33,491
公投第１４案,雲林縣,土庫鎮,南平里,103,860,124,297,421,55,476
公投第１４案,雲林縣,土庫鎮,西平里,104,929,151,279,430,44,474
公投第１４案,雲林縣,土庫鎮,西平里,105,875,117,256,373,51,424
公投第１４案,雲林縣,土庫鎮,北平里,106,896,104,244,348,38,386
公投第１４案,雲林縣,土庫鎮,新庄里,107,757,86,220,306,39,345
公投第１４案,雲林縣,土庫鎮,新庄里,108,683,103,201,304,29,333
公投第１４案,雲林縣,虎尾鎮,東仁里,109,1347,218,483,701,43,744
公投第１４案,雲林縣,虎尾鎮,東仁里,110,1258,248,475,723,29,752
公投第１４案,雲林縣,虎尾鎮,新興里,111,785,123,295,418,20,438
公投第１４案,雲林縣,虎尾鎮,新興里,112,890,131,279,410,28,438
公投第１４案,雲林縣,虎尾鎮,公安里,113,1413,243,549,792,39,831
公投第１４案,雲林縣,虎尾鎮,公安里,114,1431,246,585,831,39,870
公投第１４案,雲林縣,虎尾鎮,德興里,115,1224,192,421,613,47,660
公投第１４案,雲林縣,虎尾鎮,德興里,116,1325,172,449,621,28,649
公投第１４案,雲林縣,虎尾鎮,中山里,117,941,173,344,517,55,572
公投第１４案,雲林縣,虎尾鎮,西安里,118,1613,249,600,849,24,873
公投第１４案,雲林縣,虎尾鎮,西安里,119,1641,250,594,844,28,872
公投第１４案,雲林縣,虎尾鎮,立仁里,120,1200,208,474,682,33,715
公投第１４案,雲林縣,虎尾鎮,立仁里,121,1294,237,475,712,47,759
公投第１４案,雲林縣,虎尾鎮,立仁里,122,1273,224,481,705,20,725
公投第１４案,雲林縣,虎尾鎮,安慶里,123,1438,224,630,854,35,889
公投第１４案,雲林縣,虎尾鎮,平和里,124,1361,206,546,752,26,778
公投第１４案,雲林縣,虎尾鎮,平和里,125,1444,246,591,837,28,865
公投第１４案,雲林縣,虎尾鎮,平和里,126,1490,248,649,897,35,932
公投第１４案,雲林縣,虎尾鎮,興南里,127,1307,281,517,798,37,835
公投第１４案,雲林縣,虎尾鎮,興南里,128,967,154,313,467,20,487
公投第１４案,雲林縣,虎尾鎮,新吉里,129,1865,268,707,975,28,1003
公投第１４案,雲林縣,虎尾鎮,新吉里,130,1880,329,699,1028,27,1055
公投第１４案,雲林縣,虎尾鎮,穎川里,131,1099,152,400,552,27,579
公投第１４案,雲林縣,虎尾鎮,穎川里,132,901,157,342,499,22,521
公投第１４案,雲林縣,虎尾鎮,延平里,133,1120,182,384,566,35,601
公投第１４案,雲林縣,虎尾鎮,建國里,134,545,64,168,232,9,241
公投第１４案,雲林縣,虎尾鎮,埒內里,135,1420,230,484,714,49,763
公投第１４案,雲林縣,虎尾鎮,埒內里,136,1248,193,419,612,21,633
公投第１４案,雲林縣,虎尾鎮,堀頭里,137,799,119,296,415,24,439
公投第１４案,雲林縣,虎尾鎮,安溪里,138,836,119,283,402,46,448
公投第１４案,雲林縣,虎尾鎮,安溪里,139,924,153,262,415,34,449
公投第１４案,雲林縣,虎尾鎮,興中里,140,1648,202,500,702,22,724
公投第１４案,雲林縣,虎尾鎮,廉使里,141,1616,215,479,694,83,777
公投第１４案,雲林縣,虎尾鎮,廉使里,142,1546,216,506,722,53,775
公投第１４案,雲林縣,虎尾鎮,惠來里,143,1283,167,470,637,28,665
公投第１４案,雲林縣,虎尾鎮,惠來里,144,1078,153,373,526,27,553
公投第１４案,雲林縣,虎尾鎮,頂溪里,145,1313,187,416,603,35,638
公投第１４案,雲林縣,虎尾鎮,頂溪里,146,1284,171,443,614,28,642
公投第１４案,雲林縣,虎尾鎮,中溪里,147,1356,187,468,655,73,728
公投第１４案,雲林縣,虎尾鎮,下溪里,148,1504,223,545,768,57,825
公投第１４案,雲林縣,虎尾鎮,東屯里,149,1224,148,376,524,34,558
公投第１４案,雲林縣,虎尾鎮,西屯里,150,1509,190,462,652,59,711
公投第１４案,雲林縣,虎尾鎮,芳草里,151,855,115,202,317,49,366
公投第１４案,雲林縣,虎尾鎮,墾地里,152,1549,214,444,658,62,720
公投第１４案,雲林縣,虎尾鎮,北溪里,153,851,116,266,382,21,403
公投第１４案,雲林縣,虎尾鎮,三合里,154,1272,151,430,581,56,637
公投第１４案,雲林縣,四湖鄉,四湖村,155,1082,115,319,434,49,483
公投第１４案,雲林縣,四湖鄉,四湖村,156,676,73,255,328,38,366
公投第１４案,雲林縣,四湖鄉,湖西村,157,862,105,309,414,18,432
公投第１４案,雲林縣,四湖鄉,湖西村,158,477,44,112,156,22,178
公投第１４案,雲林縣,四湖鄉,湖西村,159,952,133,370,503,30,533
公投第１４案,雲林縣,四湖鄉,新庄村,160,650,55,175,230,20,250
公投第１４案,雲林縣,四湖鄉,溪底村,161,969,117,289,406,23,429
公投第１４案,雲林縣,四湖鄉,鹿場村,162,925,97,229,326,49,375
公投第１４案,雲林縣,四湖鄉,蔡厝村,163,914,88,288,376,28,404
公投第１４案,雲林縣,四湖鄉,湖寮村,164,759,71,133,204,39,243
公投第１４案,雲林縣,四湖鄉,施湖村,165,1219,120,315,435,44,479
公投第１４案,雲林縣,四湖鄉,羊調村,166,937,80,213,293,31,324
公投第１４案,雲林縣,四湖鄉,內湖村,167,773,67,150,217,15,232
公投第１４案,雲林縣,四湖鄉,飛東村,168,555,46,149,195,30,225
公投第１４案,雲林縣,四湖鄉,飛沙村,169,876,72,195,267,31,298
公投第１４案,雲林縣,四湖鄉,三姓村,170,360,38,86,124,15,139
公投第１４案,雲林縣,四湖鄉,崙北村,171,885,69,157,226,38,264
公投第１４案,雲林縣,四湖鄉,崙北村,172,833,79,175,254,32,286
公投第１４案,雲林縣,四湖鄉,崙南村,173,785,89,196,285,33,318
公投第１４案,雲林縣,四湖鄉,廣溝村,174,705,68,243,311,27,338
公投第１４案,雲林縣,四湖鄉,箔子村,175,927,85,192,277,25,302
公投第１４案,雲林縣,四湖鄉,箔東村,176,1058,98,221,319,60,379
公投第１４案,雲林縣,四湖鄉,林厝村,177,1071,94,263,357,52,409
公投第１４案,雲林縣,四湖鄉,林東村,178,1022,82,197,279,18,297
公投第１４案,雲林縣,四湖鄉,溪尾村,179,711,61,211,272,33,305
公投第１４案,雲林縣,元長鄉,長南村,180,915,127,313,440,25,465
公投第１４案,雲林縣,元長鄉,長南村,181,1284,181,408,589,21,610
公投第１４案,雲林縣,元長鄉,長南村,182,1150,146,357,503,39,542
公投第１４案,雲林縣,元長鄉,長北村,183,744,91,203,294,36,330
公投第１４案,雲林縣,元長鄉,長北村,184,790,98,250,348,44,392
公投第１４案,雲林縣,元長鄉,子茂村,185,1356,114,379,493,66,559
公投第１４案,雲林縣,元長鄉,後湖村,186,739,85,229,314,44,358
公投第１４案,雲林縣,元長鄉,山內村,187,965,99,249,348,40,388
公投第１４案,雲林縣,元長鄉,合和村,188,1080,100,302,402,62,464
公投第１４案,雲林縣,元長鄉,五塊村,189,948,107,243,350,34,384
公投第１４案,雲林縣,元長鄉,潭西村,190,762,59,162,221,23,244
公投第１４案,雲林縣,元長鄉,潭東村,191,582,80,174,254,18,272
公投第１４案,雲林縣,元長鄉,客厝村,192,865,80,226,306,13,319
公投第１４案,雲林縣,元長鄉,卓運村,193,362,19,57,76,6,82
公投第１４案,雲林縣,元長鄉,頂寮村,194,1162,130,290,420,27,447
公投第１４案,雲林縣,元長鄉,下寮村,195,1527,172,459,631,31,662
公投第１４案,雲林縣,元長鄉,龍岩村,196,1006,133,300,433,54,487
公投第１４案,雲林縣,元長鄉,西莊村,197,855,96,249,345,19,364
公投第１４案,雲林縣,元長鄉,鹿北村,198,1181,143,348,491,66,557
公投第１４案,雲林縣,元長鄉,鹿南村,199,864,95,234,329,31,360
公投第１４案,雲林縣,元長鄉,瓦磘村,200,667,78,159,237,30,267
公投第１４案,雲林縣,元長鄉,瓦磘村,201,878,109,214,323,32,355
公投第１４案,雲林縣,元長鄉,內寮村,202,610,48,137,185,6,191
公投第１４案,雲林縣,元長鄉,崙仔村,203,837,103,246,349,51,400
公投第１４案,雲林縣,元長鄉,新吉村,204,701,87,234,321,30,351
公投第１４案,雲林縣,口湖鄉,口湖村,205,1134,155,369,524,64,588
公投第１４案,雲林縣,口湖鄉,湖東村,206,1225,194,395,589,75,664
公投第１４案,雲林縣,口湖鄉,頂湖村,207,647,54,178,232,45,277
公投第１４案,雲林縣,口湖鄉,埔南村,208,709,89,231,320,30,350
公投第１４案,雲林縣,口湖鄉,埔北村,209,900,119,245,364,65,429
公投第１４案,雲林縣,口湖鄉,謝厝村,210,1011,127,305,432,65,497
公投第１４案,雲林縣,口湖鄉,蚵寮村,211,1437,153,393,546,36,582
公投第１４案,雲林縣,口湖鄉,下崙村,212,848,81,180,261,13,274
公投第１４案,雲林縣,口湖鄉,下崙村,213,1193,110,345,455,26,481
公投第１４案,雲林縣,口湖鄉,崙中村,214,759,71,178,249,39,288
公投第１４案,雲林縣,口湖鄉,崙中村,215,815,86,239,325,43,368
公投第１４案,雲林縣,口湖鄉,崙東村,216,1460,196,431,627,77,704
公投第１４案,雲林縣,口湖鄉,青蚶村,217,556,65,117,182,7,189
公投第１４案,雲林縣,口湖鄉,港東村,218,1532,169,482,651,53,704
公投第１４案,雲林縣,口湖鄉,港西村,219,847,85,282,367,17,384
公投第１４案,雲林縣,口湖鄉,台子村,220,374,49,112,161,21,182
公投第１４案,雲林縣,口湖鄉,台子村,221,1508,199,470,669,156,825
公投第１４案,雲林縣,口湖鄉,成龍村,222,951,112,363,475,53,528
公投第１４案,雲林縣,口湖鄉,梧南村,223,910,128,331,459,67,526
公投第１４案,雲林縣,口湖鄉,梧南村,224,879,129,351,480,36,516
公投第１４案,雲林縣,口湖鄉,梧北村,225,1213,150,337,487,104,591
公投第１４案,雲林縣,口湖鄉,水井村,226,952,94,326,420,59,479
公投第１４案,雲林縣,口湖鄉,後厝村,227,720,110,237,347,43,390
公投第１４案,雲林縣,口湖鄉,湖口村,228,1006,113,260,373,34,407
公投第１４案,雲林縣,口湖鄉,過港村,229,607,51,186,237,12,249
公投第１４案,雲林縣,水林鄉,水北村,230,1355,181,387,568,59,627
公投第１４案,雲林縣,水林鄉,水北村,231,887,142,286,428,19,447
公投第１４案,雲林縣,水林鄉,水南村,232,1234,188,431,619,44,663
公投第１４案,雲林縣,水林鄉,水南村,233,763,108,243,351,19,370
公投第１４案,雲林縣,水林鄉,萬興村,234,721,97,167,264,42,306
公投第１４案,雲林縣,水林鄉,尖山村,235,647,63,166,229,10,239
公投第１４案,雲林縣,水林鄉,大溝村,236,989,117,268,385,53,438
公投第１４案,雲林縣,水林鄉,順興村,237,837,94,203,297,31,328
公投第１４案,雲林縣,水林鄉,大山村,238,1081,115,278,393,16,409
公投第１４案,雲林縣,水林鄉,後寮村,239,704,104,177,281,37,318
公投第１４案,雲林縣,水林鄉,春埔村,240,1006,133,286,419,75,494
公投第１４案,雲林縣,水林鄉,西井村,241,651,75,175,250,13,263
公投第１４案,雲林縣,水林鄉,車港村,242,607,62,171,233,10,243
公投第１４案,雲林縣,水林鄉,蘇秦村,243,1033,107,265,372,60,432
公投第１４案,雲林縣,水林鄉,灣東村,244,631,47,141,188,17,205
公投第１４案,雲林縣,水林鄉,灣西村,245,961,89,264,353,47,400
公投第１４案,雲林縣,水林鄉,蕃薯村,246,951,274,94,368,55,423
公投第１４案,雲林縣,水林鄉,山腳村,247,838,99,229,328,36,364
公投第１４案,雲林縣,水林鄉,松北村,248,1055,113,307,420,81,501
公投第１４案,雲林縣,水林鄉,松中村,249,512,40,108,148,28,176
公投第１４案,雲林縣,水林鄉,松西村,250,671,56,173,229,16,245
公投第１４案,雲林縣,水林鄉,欍埔村,251,693,60,123,183,39,222
公投第１４案,雲林縣,水林鄉,塭底村,252,689,53,151,204,35,239
公投第１４案,雲林縣,水林鄉,海埔村,253,1022,148,286,434,62,496
公投第１４案,雲林縣,水林鄉,土厝村,254,1191,123,343,466,33,499
公投第１４案,雲林縣,水林鄉,溪墘村,255,779,101,285,386,36,422
公投第１４案,雲林縣,北港鎮,東陽里,256,724,105,269,374,53,427
公投第１４案,雲林縣,北港鎮,光民里,257,688,144,257,401,54,455
公投第１４案,雲林縣,北港鎮,東華里,258,452,50,178,228,37,265
公投第１４案,雲林縣,北港鎮,南安里,259,866,142,316,458,51,509
公投第１４案,雲林縣,北港鎮,中和里,260,336,56,104,160,19,179
公投第１４案,雲林縣,北港鎮,義民里,261,395,39,153,192,24,216
公投第１４案,雲林縣,北港鎮,共榮里,262,376,47,166,213,25,238
公投第１４案,雲林縣,北港鎮,西勢里,263,950,172,336,508,37,545
公投第１４案,雲林縣,北港鎮,仁和里,264,512,89,203,292,35,327
公投第１４案,雲林縣,北港鎮,賜福里,265,324,55,117,172,26,198
公投第１４案,雲林縣,北港鎮,公舘里,266,546,79,187,266,34,300
公投第１４案,雲林縣,北港鎮,大同里,267,433,81,163,244,19,263
公投第１４案,雲林縣,北港鎮,大同里,268,751,105,280,385,47,432
公投第１４案,雲林縣,北港鎮,仁安里,269,442,64,191,255,18,273
公投第１４案,雲林縣,北港鎮,華勝里,270,1151,182,436,618,50,668
公投第１４案,雲林縣,北港鎮,華勝里,271,1224,205,471,676,41,717
公投第１４案,雲林縣,北港鎮,華勝里,272,1211,190,436,626,42,668
公投第１４案,雲林縣,北港鎮,華勝里,273,1326,217,479,696,62,758
公投第１４案,雲林縣,北港鎮,光復里,274,744,319,128,447,34,481
公投第１４案,雲林縣,北港鎮,光復里,275,977,171,420,591,34,625
公投第１４案,雲林縣,北港鎮,扶朝里,276,960,163,319,482,57,539
公投第１４案,雲林縣,北港鎮,水埔里,277,494,50,134,184,10,194
公投第１４案,雲林縣,北港鎮,新街里,278,1364,230,520,750,39,789
公投第１４案,雲林縣,北港鎮,新街里,279,1123,205,395,600,57,657
公投第１４案,雲林縣,北港鎮,新街里,280,1451,242,542,784,43,827
公投第１４案,雲林縣,北港鎮,新街里,281,1162,213,441,654,43,697
公投第１４案,雲林縣,北港鎮,新街里,282,1130,169,372,541,50,591
公投第１４案,雲林縣,北港鎮,劉厝里,283,1149,158,405,563,32,595
公投第１４案,雲林縣,北港鎮,後溝里,284,533,62,155,217,22,239
公投第１４案,雲林縣,北港鎮,後溝里,285,433,91,165,256,29,285
公投第１４案,雲林縣,北港鎮,新厝里,286,377,39,137,176,8,184
公投第１４案,雲林縣,北港鎮,府番里,287,809,87,246,333,22,355
公投第１４案,雲林縣,北港鎮,草湖里,288,1397,187,390,577,74,651
公投第１４案,雲林縣,北港鎮,溝皂里,289,1145,113,347,460,69,529
公投第１４案,雲林縣,北港鎮,番溝里,290,828,71,193,264,50,314
公投第１４案,雲林縣,北港鎮,大北里,291,557,48,164,212,13,225
公投第１４案,雲林縣,北港鎮,好收里,292,1060,159,305,464,44,508
公投第１４案,雲林縣,北港鎮,好收里,293,577,80,167,247,33,280
公投第１４案,雲林縣,北港鎮,樹腳里,294,931,130,213,343,66,409
公投第１４案,雲林縣,北港鎮,樹腳里,295,1018,158,358,516,36,552
公投第１４案,雲林縣,北港鎮,樹腳里,296,1032,188,384,572,20,592
公投第１４案,雲林縣,崙背鄉,東明村,297,1176,187,412,599,58,657
公投第１４案,雲林縣,崙背鄉,西榮村,298,1439,203,481,684,38,722
公投第１４案,雲林縣,崙背鄉,南陽村,299,1027,139,428,567,41,608
公投第１４案,雲林縣,崙背鄉,南陽村,300,1259,193,472,665,43,708
公投第１４案,雲林縣,崙背鄉,崙前村,301,1058,336,145,481,31,512
公投第１４案,雲林縣,崙背鄉,崙前村,302,998,118,306,424,33,457
公投第１４案,雲林縣,崙背鄉,羅厝村,303,968,120,317,437,26,463
公投第１４案,雲林縣,崙背鄉,羅厝村,304,1055,156,343,499,52,551
公投第１４案,雲林縣,崙背鄉,港尾村,305,1315,194,369,563,62,625
公投第１４案,雲林縣,崙背鄉,阿勸村,306,1027,82,228,310,24,334
公投第１４案,雲林縣,崙背鄉,阿勸村,307,997,127,370,497,83,580
公投第１４案,雲林縣,崙背鄉,五魁村,308,807,100,299,399,29,428
公投第１４案,雲林縣,崙背鄉,大有村,309,698,86,183,269,17,286
公投第１４案,雲林縣,崙背鄉,大有村,310,804,98,239,337,41,378
公投第１４案,雲林縣,崙背鄉,豐榮村,311,867,115,281,396,23,419
公投第１４案,雲林縣,崙背鄉,豐榮村,312,886,98,243,341,29,370
公投第１４案,雲林縣,崙背鄉,草湖村,313,1476,138,401,539,77,616
公投第１４案,雲林縣,崙背鄉,舊庄村,314,1159,109,271,380,28,408
公投第１４案,雲林縣,崙背鄉,水尾村,315,1220,178,449,627,66,693
公投第１４案,雲林縣,崙背鄉,枋南村,316,814,123,273,396,28,424
公投第１４案,雲林縣,二崙鄉,崙東村,317,1463,182,458,640,34,674
公投第１４案,雲林縣,二崙鄉,崙西村,318,1738,230,502,732,61,793
公投第１４案,雲林縣,二崙鄉,來惠村,319,625,77,178,255,46,301
公投第１４案,雲林縣,二崙鄉,來惠村,320,1018,140,312,452,56,508
公投第１４案,雲林縣,二崙鄉,三和村,321,448,45,124,169,4,173
公投第１４案,雲林縣,二崙鄉,三和村,322,1048,98,269,367,43,410
公投第１４案,雲林縣,二崙鄉,湳仔村,323,1161,180,400,580,53,633
公投第１４案,雲林縣,二崙鄉,田尾村,324,991,161,310,471,34,505
公投第１４案,雲林縣,二崙鄉,田尾村,325,849,133,318,451,51,502
公投第１４案,雲林縣,二崙鄉,定安村,326,890,119,288,407,43,450
公投第１４案,雲林縣,二崙鄉,永定村,327,1427,213,434,647,63,710
公投第１４案,雲林縣,二崙鄉,大華村,328,891,111,303,414,24,438
公投第１４案,雲林縣,二崙鄉,義庄村,329,757,85,220,305,25,330
公投第１４案,雲林縣,二崙鄉,楊賢村,330,1497,193,406,599,134,733
公投第１４案,雲林縣,二崙鄉,港後村,331,1171,155,336,491,67,558
公投第１４案,雲林縣,二崙鄉,港後村,332,686,109,252,361,42,403
公投第１４案,雲林縣,二崙鄉,大義村,333,864,105,208,313,74,387
公投第１４案,雲林縣,二崙鄉,油車村,334,1073,161,385,546,69,615
公投第１４案,雲林縣,二崙鄉,油車村,335,696,88,179,267,25,292
公投第１４案,雲林縣,二崙鄉,大庄村,336,1271,124,301,425,52,477
公投第１４案,雲林縣,二崙鄉,庄西村,337,912,94,270,364,42,406
公投第１４案,雲林縣,二崙鄉,大同村,338,861,110,247,357,32,389
公投第１４案,雲林縣,二崙鄉,復興村,339,1030,103,307,410,48,458
公投第１４案,雲林縣,西螺鎮,振興里,340,1590,271,513,784,46,830
公投第１４案,雲林縣,西螺鎮,大園里,341,1741,293,609,902,58,960
公投第１４案,雲林縣,西螺鎮,廣福里,342,1080,206,452,658,43,701
公投第１４案,雲林縣,西螺鎮,廣福里,343,1040,195,415,610,45,655
公投第１４案,雲林縣,西螺鎮,正興里,344,1346,201,532,733,26,759
公投第１４案,雲林縣,西螺鎮,正興里,345,1625,222,628,850,42,892
公投第１４案,雲林縣,西螺鎮,永安里,346,354,60,159,219,10,229
公投第１４案,雲林縣,西螺鎮,中和里,347,580,82,208,290,26,316
公投第１４案,雲林縣,西螺鎮,福興里,348,591,115,241,356,19,375
公投第１４案,雲林縣,西螺鎮,光華里,349,1050,186,387,573,49,622
公投第１４案,雲林縣,西螺鎮,中興里,350,1147,193,456,649,56,705
公投第１４案,雲林縣,西螺鎮,中興里,351,1602,267,523,790,71,861
公投第１４案,雲林縣,西螺鎮,漢光里,352,1452,226,511,737,37,774
公投第１４案,雲林縣,西螺鎮,漢光里,353,1578,243,577,820,62,882
公投第１４案,雲林縣,西螺鎮,漢光里,354,1305,182,457,639,33,672
公投第１４案,雲林縣,西螺鎮,新安里,355,1327,204,390,594,52,646
公投第１４案,雲林縣,西螺鎮,新豐里,356,1516,218,528,746,50,796
公投第１４案,雲林縣,西螺鎮,大新里,357,828,111,220,331,21,352
公投第１４案,雲林縣,西螺鎮,大新里,358,788,85,218,303,20,323
公投第１４案,雲林縣,西螺鎮,埤頭里,359,863,134,271,405,49,454
公投第１４案,雲林縣,西螺鎮,東興里,360,984,149,301,450,72,522
公投第１４案,雲林縣,西螺鎮,鹿場里,361,1514,220,406,626,125,751
公投第１４案,雲林縣,西螺鎮,廣興里,362,870,116,307,423,45,468
公投第１４案,雲林縣,西螺鎮,頂湳里,363,971,145,314,459,59,518
公投第１４案,雲林縣,西螺鎮,吳厝里,364,1304,174,379,553,50,603
公投第１４案,雲林縣,西螺鎮,九隆里,365,726,122,207,329,25,354
公投第１４案,雲林縣,西螺鎮,下湳里,366,823,97,314,411,38,449
公投第１４案,雲林縣,西螺鎮,七座里,367,886,106,250,356,13,369
公投第１４案,雲林縣,西螺鎮,公舘里,368,1373,202,408,610,76,686
公投第１４案,雲林縣,西螺鎮,詔安里,369,983,150,328,478,61,539
公投第１４案,雲林縣,西螺鎮,河南里,370,1014,141,360,501,45,546
公投第１４案,雲林縣,西螺鎮,安定里,371,939,119,283,402,67,469
公投第１４案,雲林縣,西螺鎮,安定里,372,866,122,284,406,42,448
公投第１４案,雲林縣,西螺鎮,福田里,373,1486,182,467,649,76,725
公投第１４案,雲林縣,莿桐鄉,莿桐村,374,1507,246,558,804,66,870
公投第１４案,雲林縣,莿桐鄉,莿桐村,375,1300,206,472,678,33,711
公投第１４案,雲林縣,莿桐鄉,莿桐村,376,1272,197,462,659,97,756
公投第１４案,雲林縣,莿桐鄉,甘厝村,377,861,148,257,405,58,463
公投第１４案,雲林縣,莿桐鄉,甘西村,378,1565,222,405,627,70,697
公投第１４案,雲林縣,莿桐鄉,興桐村,379,577,93,186,279,17,296
公投第１４案,雲林縣,莿桐鄉,興桐村,380,636,90,176,266,33,299
公投第１４案,雲林縣,莿桐鄉,義和村,381,1110,182,334,516,63,579
公投第１４案,雲林縣,莿桐鄉,埔子村,382,973,175,362,537,53,590
公投第１４案,雲林縣,莿桐鄉,埔子村,383,985,216,270,486,62,548
公投第１４案,雲林縣,莿桐鄉,大美村,384,1707,277,645,922,91,1013
公投第１４案,雲林縣,莿桐鄉,大美村,385,1284,202,459,661,62,723
公投第１４案,雲林縣,莿桐鄉,埔尾村,386,1293,213,469,682,53,735
公投第１４案,雲林縣,莿桐鄉,興貴村,387,900,124,345,469,41,510
公投第１４案,雲林縣,莿桐鄉,興貴村,388,1040,100,430,530,101,631
公投第１４案,雲林縣,莿桐鄉,饒平村,389,1165,167,402,569,25,594
公投第１４案,雲林縣,莿桐鄉,四合村,390,871,133,308,441,55,496
公投第１４案,雲林縣,莿桐鄉,四合村,391,885,137,361,498,45,543
公投第１４案,雲林縣,莿桐鄉,麻園村,392,1489,180,489,669,60,729
公投第１４案,雲林縣,莿桐鄉,五華村,393,1347,166,442,608,64,672
公投第１４案,雲林縣,莿桐鄉,六合村,394,1150,228,424,652,14,666
公投第１４案,雲林縣,莿桐鄉,六合村,395,653,104,256,360,30,390
公投第１４案,雲林縣,林內鄉,林南村,396,1036,157,446,603,54,657
公投第１４案,雲林縣,林內鄉,林中村,397,1490,214,564,778,60,838
公投第１４案,雲林縣,林內鄉,林中村,398,1491,209,530,739,65,804
公投第１４案,雲林縣,林內鄉,林中村,399,671,77,229,306,51,357
公投第１４案,雲林縣,林內鄉,林北村,400,1436,214,551,765,100,865
公投第１４案,雲林縣,林內鄉,林北村,401,751,116,282,398,47,445
公投第１４案,雲林縣,林內鄉,坪頂村,402,535,84,192,276,20,296
公投第１４案,雲林縣,林內鄉,林茂村,403,811,256,81,337,50,387
公投第１４案,雲林縣,林內鄉,九芎村,404,1339,205,478,683,88,771
公投第１４案,雲林縣,林內鄉,九芎村,405,1286,188,459,647,65,712
公投第１４案,雲林縣,林內鄉,湖本村,406,646,107,216,323,36,359
公投第１４案,雲林縣,林內鄉,烏塗村,407,1158,153,436,589,59,648
公投第１４案,雲林縣,林內鄉,烏麻村,408,1090,182,384,566,53,619
公投第１４案,雲林縣,林內鄉,重興村,409,950,141,379,520,64,584
公投第１４案,雲林縣,林內鄉,重興村,410,861,148,297,445,33,478
公投第１４案,雲林縣,斗六市,信義里,411,644,160,186,346,13,359
公投第１４案,雲林縣,斗六市,四維里,412,617,96,233,329,21,350
公投第１４案,雲林縣,斗六市,太平里,413,764,167,310,477,26,503
公投第１４案,雲林縣,斗六市,中和里,414,784,141,328,469,21,490
公投第１４案,雲林縣,斗六市,光興里,415,760,126,305,431,21,452
公投第１４案,雲林縣,斗六市,鎮西里,416,1881,331,757,1088,51,1139
公投第１４案,雲林縣,斗六市,鎮西里,417,1829,276,686,962,49,1011
公投第１４案,雲林縣,斗六市,鎮東里,418,1255,221,554,775,24,799
公投第１４案,雲林縣,斗六市,鎮東里,419,1090,194,490,684,19,703
公投第１４案,雲林縣,斗六市,文化里,420,1103,181,462,643,32,675
公投第１４案,雲林縣,斗六市,文化里,421,1176,157,497,654,33,687
公投第１４案,雲林縣,斗六市,三平里,422,1529,249,603,852,15,867
公投第１４案,雲林縣,斗六市,三平里,423,1335,213,538,751,36,787
公投第１４案,雲林縣,斗六市,三平里,424,1770,285,712,997,35,1032
公投第１４案,雲林縣,斗六市,明德里,425,1308,226,492,718,33,751
公投第１４案,雲林縣,斗六市,明德里,426,2171,319,771,1090,66,1156
公投第１４案,雲林縣,斗六市,鎮北里,427,1193,188,495,683,32,715
公投第１４案,雲林縣,斗六市,鎮北里,428,1572,251,685,936,35,971
公投第１４案,雲林縣,斗六市,公誠里,429,1009,166,386,552,24,576
公投第１４案,雲林縣,斗六市,公誠里,430,1195,220,493,713,33,746
公投第１４案,雲林縣,斗六市,忠孝里,431,1415,225,568,793,50,843
公投第１４案,雲林縣,斗六市,仁愛里,432,1101,185,464,649,29,678
公投第１４案,雲林縣,斗六市,八德里,433,1648,272,615,887,37,924
公投第１４案,雲林縣,斗六市,八德里,434,1588,233,575,808,24,832
公投第１４案,雲林縣,斗六市,公正里,435,1392,275,529,804,19,823
公投第１４案,雲林縣,斗六市,公正里,436,1422,245,566,811,24,835
公投第１４案,雲林縣,斗六市,重光里,437,1187,139,421,560,34,594
公投第１４案,雲林縣,斗六市,重光里,438,1142,189,380,569,26,595
公投第１４案,雲林縣,斗六市,林頭里,439,1421,244,606,850,30,880
公投第１４案,雲林縣,斗六市,林頭里,440,1261,210,484,694,33,727
公投第１４案,雲林縣,斗六市,林頭里,441,1506,227,550,777,28,805
公投第１４案,雲林縣,斗六市,成功里,442,1214,236,472,708,28,736
公投第１４案,雲林縣,斗六市,成功里,443,1362,317,400,717,33,750
公投第１４案,雲林縣,斗六市,鎮南里,444,1097,179,403,582,17,599
公投第１４案,雲林縣,斗六市,鎮南里,445,1262,181,520,701,28,729
公投第１４案,雲林縣,斗六市,鎮南里,446,1154,191,426,617,18,635
公投第１４案,雲林縣,斗六市,社口里,447,847,138,331,469,36,505
公投第１４案,雲林縣,斗六市,社口里,448,1439,284,554,838,30,868
公投第１４案,雲林縣,斗六市,龍潭里,449,1747,326,691,1017,49,1066
公投第１４案,雲林縣,斗六市,嘉東里,450,1418,283,492,775,41,816
公投第１４案,雲林縣,斗六市,崙峰里,451,1112,154,455,609,27,636
公投第１４案,雲林縣,斗六市,崙峰里,452,1302,223,503,726,24,750
公投第１４案,雲林縣,斗六市,溝埧里,453,669,114,302,416,18,434
公投第１４案,雲林縣,斗六市,江厝里,454,752,127,281,408,27,435
公投第１４案,雲林縣,斗六市,江厝里,455,1450,226,541,767,21,788
公投第１４案,雲林縣,斗六市,三光里,456,555,84,210,294,31,325
公投第１４案,雲林縣,斗六市,久安里,457,1470,238,495,733,35,768
公投第１４案,雲林縣,斗六市,久安里,458,927,144,388,532,21,553
公投第１４案,雲林縣,斗六市,虎溪里,459,1893,333,722,1055,46,1101
公投第１４案,雲林縣,斗六市,虎溪里,460,1708,258,650,908,72,980
公投第１４案,雲林縣,斗六市,虎溪里,461,1773,257,575,832,53,885
公投第１４案,雲林縣,斗六市,保庄里,462,1412,261,557,818,23,841
公投第１４案,雲林縣,斗六市,保庄里,463,1354,250,578,828,24,852
公投第１４案,雲林縣,斗六市,保庄里,464,1267,217,484,701,21,722
公投第１４案,雲林縣,斗六市,保庄里,465,1273,229,445,674,22,696
公投第１４案,雲林縣,斗六市,長平里,466,1748,211,623,834,78,912
公投第１４案,雲林縣,斗六市,榴中里,467,1238,184,502,686,48,734
公投第１４案,雲林縣,斗六市,榴中里,468,1648,236,583,819,37,856
公投第１４案,雲林縣,斗六市,榴中里,469,1520,260,608,868,50,918
公投第１４案,雲林縣,斗六市,榴北里,470,1087,135,426,561,26,587
公投第１４案,雲林縣,斗六市,榴南里,471,1904,297,720,1017,66,1083
公投第１４案,雲林縣,斗六市,梅林里,472,702,113,289,402,32,434
公投第１４案,雲林縣,斗六市,梅林里,473,1111,193,416,609,51,660
公投第１４案,雲林縣,斗六市,湖山里,474,1123,135,383,518,37,555
公投第１４案,雲林縣,斗六市,長安里,475,1146,169,425,594,26,620
公投第１４案,雲林縣,斗六市,長安里,476,1786,292,632,924,36,960
公投第１４案,雲林縣,斗六市,溪洲里,477,1023,180,363,543,49,592
公投第１４案,雲林縣,斗六市,溪洲里,478,2072,325,752,1077,71,1148
公投第１４案,雲林縣,斗六市,十三里,479,1128,178,414,592,23,615
公投第１４案,雲林縣,大埤鄉,北和村,480,750,111,254,365,32,397
公投第１４案,雲林縣,大埤鄉,吉田村,481,719,105,236,341,28,369
公投第１４案,雲林縣,大埤鄉,豐岡村,482,603,69,227,296,21,317
公投第１４案,雲林縣,大埤鄉,聯美村,483,1106,136,339,475,54,529
公投第１４案,雲林縣,大埤鄉,南和村,484,1495,249,439,688,51,739
公投第１４案,雲林縣,大埤鄉,南和村,485,600,94,233,327,30,357
公投第１４案,雲林縣,大埤鄉,大德村,486,1004,156,390,546,45,591
公投第１４案,雲林縣,大埤鄉,松竹村,487,948,134,231,365,26,391
公投第１４案,雲林縣,大埤鄉,豐田村,488,1539,216,563,779,52,831
公投第１４案,雲林縣,大埤鄉,尚義村,489,1430,174,457,631,65,696
公投第１４案,雲林縣,大埤鄉,尚義村,490,465,51,168,219,21,240
公投第１４案,雲林縣,大埤鄉,嘉興村,491,1307,172,439,611,40,651
公投第１４案,雲林縣,大埤鄉,嘉興村,492,474,84,149,233,16,249
公投第１４案,雲林縣,大埤鄉,三結村,493,1220,203,441,644,84,728
公投第１４案,雲林縣,大埤鄉,怡然村,494,733,87,264,351,17,368
公投第１４案,雲林縣,大埤鄉,北鎮村,495,681,97,252,349,28,377
公投第１４案,雲林縣,大埤鄉,興安村,496,712,100,175,275,27,302
公投第１４案,雲林縣,大埤鄉,西鎮村,497,723,88,214,302,48,350
公投第１４案,雲林縣,斗南鎮,東仁里,498,1166,195,478,673,40,713
公投第１４案,雲林縣,斗南鎮,西岐里,499,1135,194,472,666,34,700
公投第１４案,雲林縣,斗南鎮,西岐里,500,975,178,403,581,26,607
公投第１４案,雲林縣,斗南鎮,大同里,501,1459,265,565,830,42,872
公投第１４案,雲林縣,斗南鎮,大同里,502,1351,236,513,749,48,797
公投第１４案,雲林縣,斗南鎮,南昌里,503,1321,306,404,710,38,748
公投第１４案,雲林縣,斗南鎮,南昌里,504,907,153,313,466,33,499
公投第１４案,雲林縣,斗南鎮,北銘里,505,1473,228,634,862,60,922
公投第１４案,雲林縣,斗南鎮,中天里,506,1277,225,525,750,53,803
公投第１４案,雲林縣,斗南鎮,林子里,507,1333,221,476,697,67,764
公投第１４案,雲林縣,斗南鎮,石龜里,508,777,124,270,394,30,424
公投第１４案,雲林縣,斗南鎮,石溪里,509,877,139,310,449,32,481
公投第１４案,雲林縣,斗南鎮,靖興里,510,899,111,343,454,41,495
公投第１４案,雲林縣,斗南鎮,新南里,511,688,84,200,284,37,321
公投第１４案,雲林縣,斗南鎮,阿丹里,512,1147,169,392,561,27,588
公投第１４案,雲林縣,斗南鎮,將軍里,513,1709,254,628,882,74,956
公投第１４案,雲林縣,斗南鎮,舊社里,514,1042,175,424,599,39,638
公投第１４案,雲林縣,斗南鎮,舊社里,515,1631,282,567,849,43,892
公投第１４案,雲林縣,斗南鎮,明昌里,516,1702,276,682,958,73,1031
公投第１４案,雲林縣,斗南鎮,明昌里,517,1564,244,617,861,61,922
公投第１４案,雲林縣,斗南鎮,僑真里,518,910,106,302,408,23,431
公投第１４案,雲林縣,斗南鎮,僑真里,519,1276,234,506,740,43,783
公投第１４案,雲林縣,斗南鎮,大東里,520,897,103,228,331,19,350
公投第１４案,雲林縣,斗南鎮,埤麻里,521,803,130,279,409,29,438
公投第１４案,雲林縣,斗南鎮,西伯里,522,866,113,347,460,45,505
公投第１４案,雲林縣,斗南鎮,新崙里,523,852,142,317,459,44,503
公投第１４案,雲林縣,斗南鎮,新崙里,524,671,192,148,340,42,382
公投第１４案,雲林縣,斗南鎮,東明里,525,981,161,345,506,27,533
公投第１４案,雲林縣,斗南鎮,新光里,526,1129,161,361,522,20,542
公投第１４案,雲林縣,斗南鎮,新光里,527,1586,266,604,870,71,941
公投第１４案,雲林縣,斗南鎮,田頭里,528,1243,219,493,712,50,762
公投第１４案,雲林縣,斗南鎮,田頭里,529,984,122,337,459,23,482
公投第１４案,雲林縣,斗南鎮,小東里,530,1507,237,558,795,61,856
公投第１４案,雲林縣,古坑鄉,棋盤村,531,1126,171,404,575,50,625
公投第１４案,雲林縣,古坑鄉,棋盤村,532,994,155,322,477,49,526
公投第１４案,雲林縣,古坑鄉,新庄村,533,1517,267,488,755,52,807
公投第１４案,雲林縣,古坑鄉,東和村,534,1302,174,513,687,38,725
公投第１４案,雲林縣,古坑鄉,東和村,535,1772,238,608,846,48,894
公投第１４案,雲林縣,古坑鄉,荷苞村,536,1122,146,431,577,67,644
公投第１４案,雲林縣,古坑鄉,荷苞村,537,304,24,79,103,6,109
公投第１４案,雲林縣,古坑鄉,高林村,538,1169,140,464,604,80,684
公投第１４案,雲林縣,古坑鄉,水碓村,539,1255,175,423,598,54,652
公投第１４案,雲林縣,古坑鄉,田心村,540,1078,197,414,611,42,653
公投第１４案,雲林縣,古坑鄉,古坑村,541,943,121,318,439,26,465
公投第１４案,雲林縣,古坑鄉,古坑村,542,1300,187,418,605,63,668
公投第１４案,雲林縣,古坑鄉,朝陽村,543,964,118,345,463,35,498
公投第１４案,雲林縣,古坑鄉,朝陽村,544,1144,164,414,578,42,620
公投第１４案,雲林縣,古坑鄉,西平村,545,1482,196,545,741,47,788
公投第１４案,雲林縣,古坑鄉,湳仔村,546,688,101,256,357,29,386
公投第１４案,雲林縣,古坑鄉,永光村,547,998,147,325,472,33,505
公投第１４案,雲林縣,古坑鄉,永光村,548,1140,163,449,612,40,652
公投第１４案,雲林縣,古坑鄉,永昌村,549,1102,167,383,550,43,593
公投第１４案,雲林縣,古坑鄉,永昌村,550,956,129,345,474,27,501
公投第１４案,雲林縣,古坑鄉,麻園村,551,695,107,243,350,27,377
公投第１４案,雲林縣,古坑鄉,崁腳村,552,1233,158,405,563,33,596
公投第１４案,雲林縣,古坑鄉,華南村,553,285,31,83,114,7,121
公投第１４案,雲林縣,古坑鄉,華山村,554,734,73,210,283,12,295
公投第１４案,雲林縣,古坑鄉,桂林村,555,1150,171,397,568,68,636
公投第１４案,雲林縣,古坑鄉,樟湖村,556,453,51,177,228,16,244
公投第１４案,雲林縣,古坑鄉,草嶺村,557,571,52,194,246,32,278
公投第１４案,嘉義縣,太保市,太保里,1,1210,179,435,614,65,679
公投第１４案,嘉義縣,太保市,太保里,2,1076,171,385,556,36,592
公投第１４案,嘉義縣,太保市,後庄里,3,488,84,145,229,14,243
公投第１４案,嘉義縣,太保市,前潭里,4,1475,197,460,657,73,730
公投第１４案,嘉義縣,太保市,後潭里,5,790,94,227,321,27,348
公投第１４案,嘉義縣,太保市,後潭里,6,883,121,287,408,34,442
公投第１４案,嘉義縣,太保市,梅埔里,7,758,102,251,353,43,396
公投第１４案,嘉義縣,太保市,梅埔里,8,389,41,108,149,10,159
公投第１４案,嘉義縣,太保市,春珠里,9,1101,143,326,469,43,512
公投第１４案,嘉義縣,太保市,崙頂里,10,853,118,305,423,17,440
公投第１４案,嘉義縣,太保市,安仁里,11,224,35,50,85,7,92
公投第１４案,嘉義縣,太保市,安仁里,12,662,87,188,275,47,322
公投第１４案,嘉義縣,太保市,安仁里,13,1630,253,681,934,36,970
公投第１４案,嘉義縣,太保市,東勢里,14,913,121,286,407,31,438
公投第１４案,嘉義縣,太保市,東勢里,15,779,145,275,420,14,434
公投第１４案,嘉義縣,太保市,新埤里,16,1278,209,396,605,106,711
公投第１４案,嘉義縣,太保市,舊埤里,17,819,116,248,364,33,397
公投第１４案,嘉義縣,太保市,舊埤里,18,1573,230,546,776,29,805
公投第１４案,嘉義縣,太保市,田尾里,19,481,58,181,239,25,264
公投第１４案,嘉義縣,太保市,田尾里,20,245,34,110,144,5,149
公投第１４案,嘉義縣,太保市,港尾里,21,317,112,56,168,10,178
公投第１４案,嘉義縣,太保市,港尾里,22,258,43,86,129,8,137
公投第１４案,嘉義縣,太保市,過溝里,23,611,71,220,291,42,333
公投第１４案,嘉義縣,太保市,過溝里,24,1526,257,596,853,37,890
公投第１４案,嘉義縣,太保市,過溝里,25,1196,207,441,648,29,677
公投第１４案,嘉義縣,太保市,麻寮里,26,1536,239,520,759,86,845
公投第１４案,嘉義縣,太保市,麻寮里,27,1481,245,521,766,58,824
公投第１４案,嘉義縣,太保市,麻寮里,28,1450,229,525,754,40,794
公投第１４案,嘉義縣,太保市,南新里,29,840,129,274,403,20,423
公投第１４案,嘉義縣,太保市,南新里,30,989,187,332,519,26,545
公投第１４案,嘉義縣,太保市,北新里,31,1529,218,568,786,62,848
公投第１４案,嘉義縣,太保市,北新里,32,1511,279,522,801,50,851
公投第１４案,嘉義縣,太保市,埤鄉里,33,697,93,212,305,35,340
公投第１４案,嘉義縣,鹿草鄉,後寮村,34,522,80,128,208,33,241
公投第１４案,嘉義縣,鹿草鄉,鹿東村,35,563,98,177,275,30,305
公投第１４案,嘉義縣,鹿草鄉,鹿草村,36,1304,188,383,571,75,646
公投第１４案,嘉義縣,鹿草鄉,西井村,37,1312,200,412,612,48,660
公投第１４案,嘉義縣,鹿草鄉,豊稠村,38,320,44,98,142,3,145
公投第１４案,嘉義縣,鹿草鄉,豊稠村,39,418,25,80,105,5,110
公投第１４案,嘉義縣,鹿草鄉,重寮村,40,1025,118,271,389,56,445
公投第１４案,嘉義縣,鹿草鄉,施家村,41,451,56,111,167,19,186
公投第１４案,嘉義縣,鹿草鄉,下潭村,42,830,79,289,368,78,446
公投第１４案,嘉義縣,鹿草鄉,光潭村,43,1050,143,280,423,68,491
公投第１４案,嘉義縣,鹿草鄉,碧潭村,44,972,110,223,333,65,398
公投第１４案,嘉義縣,鹿草鄉,松竹村,45,962,129,270,399,47,446
公投第１４案,嘉義縣,鹿草鄉,竹山村,46,678,113,193,306,45,351
公投第１４案,嘉義縣,鹿草鄉,竹山村,47,262,31,86,117,17,134
公投第１４案,嘉義縣,鹿草鄉,後堀村,48,906,127,222,349,42,391
公投第１４案,嘉義縣,鹿草鄉,後堀村,49,306,24,74,98,9,107
公投第１４案,嘉義縣,鹿草鄉,三角村,50,1062,150,334,484,60,544
公投第１４案,嘉義縣,鹿草鄉,三角村,51,373,49,129,178,18,196
公投第１４案,嘉義縣,鹿草鄉,下麻村,52,324,42,111,153,22,175
公投第１４案,嘉義縣,鹿草鄉,下麻村,53,297,33,102,135,15,150
公投第１４案,嘉義縣,水上鄉,水上村,54,1024,123,366,489,27,516
公投第１４案,嘉義縣,水上鄉,水上村,55,1015,179,389,568,47,615
公投第１４案,嘉義縣,水上鄉,水上村,56,1932,258,619,877,69,946
公投第１４案,嘉義縣,水上鄉,水頭村,57,1170,202,437,639,45,684
公投第１４案,嘉義縣,水上鄉,水頭村,58,1305,206,497,703,63,766
公投第１４案,嘉義縣,水上鄉,粗溪村,59,1242,277,295,572,46,618
公投第１４案,嘉義縣,水上鄉,粗溪村,60,324,49,94,143,16,159
公投第１４案,嘉義縣,水上鄉,下寮村,61,622,87,216,303,23,326
公投第１４案,嘉義縣,水上鄉,下寮村,62,1216,180,392,572,57,629
公投第１４案,嘉義縣,水上鄉,三和村,63,1020,159,376,535,23,558
公投第１４案,嘉義縣,水上鄉,三和村,64,771,137,310,447,34,481
公投第１４案,嘉義縣,水上鄉,回歸村,65,441,114,144,258,19,277
公投第１４案,嘉義縣,水上鄉,大堀村,66,626,128,235,363,50,413
公投第１４案,嘉義縣,水上鄉,大堀村,67,570,104,201,305,34,339
公投第１４案,嘉義縣,水上鄉,大堀村,68,368,43,124,167,25,192
公投第１４案,嘉義縣,水上鄉,大崙村,69,1037,147,304,451,86,537
公投第１４案,嘉義縣,水上鄉,大崙村,70,1065,167,353,520,60,580
公投第１４案,嘉義縣,水上鄉,塗溝村,71,802,136,285,421,89,510
公投第１４案,嘉義縣,水上鄉,龍德村,72,1948,279,652,931,44,975
公投第１４案,嘉義縣,水上鄉,溪洲村,73,1028,136,332,468,54,522
公投第１４案,嘉義縣,水上鄉,三鎮村,74,641,100,248,348,25,373
公投第１４案,嘉義縣,水上鄉,靖和村,75,408,62,169,231,10,241
公投第１４案,嘉義縣,水上鄉,南和村,76,794,140,276,416,42,458
公投第１４案,嘉義縣,水上鄉,南和村,77,569,71,177,248,23,271
公投第１４案,嘉義縣,水上鄉,柳新村,78,806,122,296,418,32,450
公投第１４案,嘉義縣,水上鄉,柳新村,79,960,129,381,510,43,553
公投第１４案,嘉義縣,水上鄉,柳林村,80,2035,334,709,1043,73,1116
公投第１４案,嘉義縣,水上鄉,柳鄉村,81,1987,301,670,971,88,1059
公投第１４案,嘉義縣,水上鄉,內溪村,82,1154,162,435,597,29,626
公投第１４案,嘉義縣,水上鄉,寬士村,83,2208,305,741,1046,70,1116
公投第１４案,嘉義縣,水上鄉,寬士村,84,2102,259,625,884,57,941
公投第１４案,嘉義縣,水上鄉,民生村,85,1309,155,445,600,57,657
公投第１４案,嘉義縣,水上鄉,民生村,86,1671,258,570,828,79,907
公投第１４案,嘉義縣,水上鄉,義興村,87,822,109,298,407,41,448
公投第１４案,嘉義縣,水上鄉,中庄村,88,1772,230,617,847,46,893
公投第１４案,嘉義縣,水上鄉,忠和村,89,1919,262,663,925,82,1007
公投第１４案,嘉義縣,水上鄉,南鄉村,90,912,114,283,397,17,414
公投第１４案,嘉義縣,水上鄉,三界村,91,992,127,344,471,25,496
公投第１４案,嘉義縣,水上鄉,國姓村,92,1270,158,364,522,48,570
公投第１４案,嘉義縣,民雄鄉,東榮村,93,1267,227,468,695,37,732
公投第１４案,嘉義縣,民雄鄉,東榮村,94,1030,159,331,490,35,525
公投第１４案,嘉義縣,民雄鄉,中樂村,95,1590,262,604,866,82,948
公投第１４案,嘉義縣,民雄鄉,西安村,96,1673,272,558,830,29,859
公投第１４案,嘉義縣,民雄鄉,西安村,97,1718,292,629,921,62,983
公投第１４案,嘉義縣,民雄鄉,寮頂村,98,1040,184,380,564,51,615
公投第１４案,嘉義縣,民雄鄉,寮頂村,99,1100,150,395,545,48,593
公投第１４案,嘉義縣,民雄鄉,福權村,100,1559,228,498,726,71,797
公投第１４案,嘉義縣,民雄鄉,東湖村,101,1862,267,603,870,76,946
公投第１４案,嘉義縣,民雄鄉,頂崙村,102,1435,249,490,739,70,809
公投第１４案,嘉義縣,民雄鄉,菁埔村,103,1751,282,496,778,139,917
公投第１４案,嘉義縣,民雄鄉,中和村,104,933,143,350,493,39,532
公投第１４案,嘉義縣,民雄鄉,平和村,105,827,151,327,478,39,517
公投第１４案,嘉義縣,民雄鄉,西昌村,106,843,119,241,360,43,403
公投第１４案,嘉義縣,民雄鄉,豊收村,107,1774,259,615,874,62,936
公投第１４案,嘉義縣,民雄鄉,豊收村,108,385,55,110,165,17,182
公投第１４案,嘉義縣,民雄鄉,三興村,109,1306,244,484,728,32,760
公投第１４案,嘉義縣,民雄鄉,東興村,110,535,83,204,287,33,320
公投第１４案,嘉義縣,民雄鄉,鎮北村,111,1055,165,397,562,54,616
公投第１４案,嘉義縣,民雄鄉,北斗村,112,1476,207,542,749,52,801
公投第１４案,嘉義縣,民雄鄉,北斗村,113,1583,202,550,752,44,796
公投第１４案,嘉義縣,民雄鄉,北斗村,114,758,102,226,328,29,357
公投第１４案,嘉義縣,民雄鄉,北斗村,115,1354,196,441,637,38,675
公投第１４案,嘉義縣,民雄鄉,双福村,116,1202,194,435,629,63,692
公投第１４案,嘉義縣,民雄鄉,双福村,117,1175,193,409,602,45,647
公投第１４案,嘉義縣,民雄鄉,福樂村,118,1423,237,461,698,36,734
公投第１４案,嘉義縣,民雄鄉,福樂村,119,1612,242,579,821,29,850
公投第１４案,嘉義縣,民雄鄉,福樂村,120,1695,262,646,908,31,939
公投第１４案,嘉義縣,民雄鄉,福樂村,121,1665,214,527,741,48,789
公投第１４案,嘉義縣,民雄鄉,大崎村,122,1019,111,334,445,51,496
公投第１４案,嘉義縣,民雄鄉,大崎村,123,1352,186,458,644,62,706
公投第１４案,嘉義縣,民雄鄉,秀林村,124,1620,200,617,817,82,899
公投第１４案,嘉義縣,民雄鄉,秀林村,125,943,140,301,441,33,474
公投第１４案,嘉義縣,民雄鄉,松山村,126,1720,209,539,748,49,797
公投第１４案,嘉義縣,民雄鄉,興中村,127,1875,235,650,885,77,962
公投第１４案,嘉義縣,民雄鄉,興南村,128,1305,217,456,673,54,727
公投第１４案,嘉義縣,民雄鄉,興南村,129,1441,223,472,695,56,751
公投第１４案,嘉義縣,民雄鄉,金興村,130,1413,224,510,734,53,787
公投第１４案,嘉義縣,民雄鄉,金興村,131,1560,238,532,770,59,829
公投第１４案,嘉義縣,民雄鄉,福興村,132,2004,715,314,1029,88,1117
公投第１４案,嘉義縣,民雄鄉,文隆村,133,1354,220,516,736,63,799
公投第１４案,嘉義縣,民雄鄉,文隆村,134,1076,161,412,573,24,597
公投第１４案,嘉義縣,民雄鄉,山中村,135,1629,221,580,801,112,913
公投第１４案,嘉義縣,民雄鄉,山中村,136,1977,268,668,936,70,1006
公投第１４案,嘉義縣,民雄鄉,中央村,137,1295,200,402,602,87,689
公投第１４案,嘉義縣,新港鄉,宮前村,138,1087,176,376,552,30,582
公投第１４案,嘉義縣,新港鄉,宮前村,139,1116,206,485,691,53,744
公投第１４案,嘉義縣,新港鄉,宮後村,140,740,116,252,368,43,411
公投第１４案,嘉義縣,新港鄉,宮後村,141,827,129,246,375,65,440
公投第１４案,嘉義縣,新港鄉,大興村,142,704,131,254,385,48,433
公投第１４案,嘉義縣,新港鄉,大興村,143,768,141,287,428,44,472
公投第１４案,嘉義縣,新港鄉,福德村,144,761,145,270,415,42,457
公投第１４案,嘉義縣,新港鄉,福德村,145,850,123,276,399,49,448
公投第１４案,嘉義縣,新港鄉,古民村,146,1327,185,462,647,54,701
公投第１４案,嘉義縣,新港鄉,中庄村,147,756,118,245,363,54,417
公投第１４案,嘉義縣,新港鄉,中庄村,148,816,129,253,382,81,463
公投第１４案,嘉義縣,新港鄉,大潭村,149,667,95,189,284,33,317
公投第１４案,嘉義縣,新港鄉,大潭村,150,942,144,316,460,42,502
公投第１４案,嘉義縣,新港鄉,西庄村,151,918,91,284,375,67,442
公投第１４案,嘉義縣,新港鄉,埤子村,152,554,66,166,232,9,241
公投第１４案,嘉義縣,新港鄉,南崙村,153,929,138,284,422,33,455
公投第１４案,嘉義縣,新港鄉,北崙村,154,487,67,103,170,35,205
公投第１４案,嘉義縣,新港鄉,海瀛村,155,487,59,166,225,45,270
公投第１４案,嘉義縣,新港鄉,月眉村,156,836,135,244,379,45,424
公投第１４案,嘉義縣,新港鄉,月眉村,157,845,137,288,425,47,472
公投第１４案,嘉義縣,新港鄉,月潭村,158,834,151,262,413,49,462
公投第１４案,嘉義縣,新港鄉,月潭村,159,753,142,239,381,44,425
公投第１４案,嘉義縣,新港鄉,溪北村,160,1328,207,436,643,62,705
公投第１４案,嘉義縣,新港鄉,菜公村,161,969,160,356,516,40,556
公投第１４案,嘉義縣,新港鄉,中洋村,162,1043,163,393,556,64,620
公投第１４案,嘉義縣,新港鄉,三間村,163,1400,226,556,782,63,845
公投第１４案,嘉義縣,新港鄉,安和村,164,1017,102,242,344,23,367
公投第１４案,嘉義縣,新港鄉,潭大村,165,1132,143,336,479,44,523
公投第１４案,嘉義縣,新港鄉,南港村,166,1037,156,331,487,53,540
公投第１４案,嘉義縣,新港鄉,板頭村,167,563,79,204,283,50,333
公投第１４案,嘉義縣,新港鄉,共和村,168,849,121,278,399,25,424
公投第１４案,嘉義縣,大林鎮,東林里,169,483,75,171,246,22,268
公投第１４案,嘉義縣,大林鎮,西林里,170,1823,290,673,963,58,1021
公投第１４案,嘉義縣,大林鎮,吉林里,171,955,139,381,520,23,543
公投第１４案,嘉義縣,大林鎮,平林里,172,1436,229,484,713,33,746
公投第１４案,嘉義縣,大林鎮,平林里,173,1390,251,452,703,60,763
公投第１４案,嘉義縣,大林鎮,平林里,174,1512,241,549,790,62,852
公投第１４案,嘉義縣,大林鎮,平林里,175,1536,271,559,830,46,876
公投第１４案,嘉義縣,大林鎮,明華里,176,1165,154,369,523,39,562
公投第１４案,嘉義縣,大林鎮,明和里,177,1730,362,603,965,56,1021
公投第１４案,嘉義縣,大林鎮,排路里,178,602,63,182,245,16,261
公投第１４案,嘉義縣,大林鎮,西結里,179,716,107,208,315,41,356
公投第１４案,嘉義縣,大林鎮,湖北里,180,625,65,174,239,12,251
公投第１４案,嘉義縣,大林鎮,大糖里,181,193,21,50,71,3,74
公投第１４案,嘉義縣,大林鎮,大美里,182,1642,208,484,692,69,761
公投第１４案,嘉義縣,大林鎮,過溪里,183,1465,178,519,697,62,759
公投第１４案,嘉義縣,大林鎮,中坑里,184,928,101,267,368,42,410
公投第１４案,嘉義縣,大林鎮,中坑里,185,361,35,102,137,23,160
公投第１４案,嘉義縣,大林鎮,上林里,186,814,115,265,380,15,395
公投第１４案,嘉義縣,大林鎮,中林里,187,1579,212,509,721,40,761
公投第１４案,嘉義縣,大林鎮,三和里,188,2041,279,689,968,74,1042
公投第１４案,嘉義縣,大林鎮,溝背里,189,931,117,304,421,53,474
公投第１４案,嘉義縣,大林鎮,義和里,190,675,89,222,311,36,347
公投第１４案,嘉義縣,大林鎮,內林里,191,655,71,231,302,25,327
公投第１４案,嘉義縣,大林鎮,三角里,192,833,114,263,377,34,411
公投第１４案,嘉義縣,大林鎮,三村里,193,832,133,323,456,44,500
公投第１４案,嘉義縣,溪口鄉,溪東村,194,1318,195,468,663,91,754
公投第１４案,嘉義縣,溪口鄉,溪西村,195,677,111,235,346,48,394
公投第１４案,嘉義縣,溪口鄉,溪北村,196,417,56,137,193,19,212
公投第１４案,嘉義縣,溪口鄉,溪北村,197,273,48,88,136,20,156
公投第１４案,嘉義縣,溪口鄉,柳溝村,198,908,145,321,466,64,530
公投第１４案,嘉義縣,溪口鄉,柳溝村,199,386,58,104,162,11,173
公投第１４案,嘉義縣,溪口鄉,疊溪村,200,1039,178,347,525,52,577
公投第１４案,嘉義縣,溪口鄉,妙崙村,201,708,90,191,281,47,328
公投第１４案,嘉義縣,溪口鄉,坪頂村,202,909,138,270,408,22,430
公投第１４案,嘉義縣,溪口鄉,柴林村,203,786,127,260,387,46,433
公投第１４案,嘉義縣,溪口鄉,林腳村,204,807,106,235,341,49,390
公投第１４案,嘉義縣,溪口鄉,美南村,205,1168,195,266,461,26,487
公投第１４案,嘉義縣,溪口鄉,美北村,206,1052,179,327,506,80,586
公投第１４案,嘉義縣,溪口鄉,本厝村,207,565,80,164,244,41,285
公投第１４案,嘉義縣,溪口鄉,本厝村,208,388,49,134,183,26,209
公投第１４案,嘉義縣,溪口鄉,游西村,209,701,83,183,266,28,294
公投第１４案,嘉義縣,溪口鄉,游東村,210,1003,107,283,390,40,430
公投第１４案,嘉義縣,梅山鄉,梅東村,211,1041,170,338,508,28,536
公投第１４案,嘉義縣,梅山鄉,梅東村,212,1245,187,464,651,91,742
公投第１４案,嘉義縣,梅山鄉,梅南村,213,917,166,333,499,48,547
公投第１４案,嘉義縣,梅山鄉,梅北村,214,1189,195,398,593,51,644
公投第１４案,嘉義縣,梅山鄉,梅北村,215,1388,228,494,722,67,789
公投第１４案,嘉義縣,梅山鄉,梅北村,216,1827,279,644,923,54,977
公投第１４案,嘉義縣,梅山鄉,過山村,217,545,113,190,303,41,344
公投第１４案,嘉義縣,梅山鄉,圳南村,218,407,61,92,153,30,183
公投第１４案,嘉義縣,梅山鄉,圳北村,219,636,91,236,327,34,361
公投第１４案,嘉義縣,梅山鄉,双溪村,220,576,82,217,299,36,335
公投第１４案,嘉義縣,梅山鄉,大南村,221,1674,231,614,845,81,926
公投第１４案,嘉義縣,梅山鄉,安靖村,222,858,90,283,373,11,384
公投第１４案,嘉義縣,梅山鄉,永興村,223,526,79,228,307,24,331
公投第１４案,嘉義縣,梅山鄉,半天村,224,372,50,100,150,30,180
公投第１４案,嘉義縣,梅山鄉,太平村,225,506,73,154,227,26,253
公投第１４案,嘉義縣,梅山鄉,太興村,226,433,62,207,269,40,309
公投第１４案,嘉義縣,梅山鄉,龍眼村,227,404,36,123,159,6,165
公投第１４案,嘉義縣,梅山鄉,碧湖村,228,293,39,99,138,11,149
公投第１４案,嘉義縣,梅山鄉,瑞峯村,229,712,84,293,377,70,447
公投第１４案,嘉義縣,梅山鄉,瑞里村,230,602,77,260,337,36,373
公投第１４案,嘉義縣,梅山鄉,太和村,231,515,47,177,224,27,251
公投第１４案,嘉義縣,梅山鄉,太和村,232,417,33,117,150,14,164
公投第１４案,嘉義縣,朴子市,安福里,233,1183,205,406,611,32,643
公投第１４案,嘉義縣,朴子市,安福里,234,755,118,259,377,42,419
公投第１４案,嘉義縣,朴子市,平和里,235,1253,179,466,645,35,680
公投第１４案,嘉義縣,朴子市,平和里,236,1078,195,408,603,45,648
公投第１４案,嘉義縣,朴子市,內厝里,237,1117,210,416,626,59,685
公投第１４案,嘉義縣,朴子市,開元里,238,387,75,137,212,19,231
公投第１４案,嘉義縣,朴子市,順天里,239,633,94,216,310,49,359
公投第１４案,嘉義縣,朴子市,中正里,240,650,106,234,340,27,367
公投第１４案,嘉義縣,朴子市,博厚里,241,825,138,353,491,34,525
公投第１４案,嘉義縣,朴子市,文化里,242,810,127,279,406,40,446
公投第１４案,嘉義縣,朴子市,文化里,243,940,142,368,510,41,551
公投第１４案,嘉義縣,朴子市,永和里,244,905,123,316,439,48,487
公投第１４案,嘉義縣,朴子市,永和里,245,1605,231,499,730,38,768
公投第１４案,嘉義縣,朴子市,竹圍里,246,1479,279,539,818,39,857
公投第１４案,嘉義縣,朴子市,竹圍里,247,1218,196,456,652,50,702
公投第１４案,嘉義縣,朴子市,竹圍里,248,1496,225,573,798,58,856
公投第１４案,嘉義縣,朴子市,新寮里,249,667,95,240,335,29,364
公投第１４案,嘉義縣,朴子市,双溪里,250,627,68,168,236,18,254
公投第１４案,嘉義縣,朴子市,溪口里,251,791,80,270,350,45,395
公投第１４案,嘉義縣,朴子市,德興里,252,1034,133,352,485,88,573
公投第１４案,嘉義縣,朴子市,仁和里,253,1710,283,527,810,22,832
公投第１４案,嘉義縣,朴子市,大鄉里,254,1671,224,537,761,35,796
公投第１４案,嘉義縣,朴子市,大鄉里,255,1547,181,442,623,47,670
公投第１４案,嘉義縣,朴子市,大葛里,256,1602,177,418,595,62,657
公投第１４案,嘉義縣,朴子市,大葛里,257,1302,201,517,718,20,738
公投第１４案,嘉義縣,朴子市,佳禾里,258,740,92,240,332,44,376
公投第１４案,嘉義縣,朴子市,竹村里,259,1054,161,402,563,58,621
公投第１４案,嘉義縣,朴子市,崁前里,260,907,97,255,352,17,369
公投第１４案,嘉義縣,朴子市,崁後里,261,720,94,196,290,23,313
公投第１４案,嘉義縣,朴子市,順安里,262,251,36,80,116,31,147
公投第１４案,嘉義縣,朴子市,德家里,263,767,73,212,285,49,334
公投第１４案,嘉義縣,朴子市,新庄里,264,702,91,255,346,44,390
公投第１４案,嘉義縣,朴子市,梅華里,265,1038,109,315,424,66,490
公投第１４案,嘉義縣,朴子市,松華里,266,1228,114,268,382,28,410
公投第１４案,嘉義縣,朴子市,南竹里,267,499,51,157,208,49,257
公投第１４案,嘉義縣,六腳鄉,蒜頭村,268,1165,132,350,482,34,516
公投第１４案,嘉義縣,六腳鄉,蒜東村,269,825,75,199,274,16,290
公投第１４案,嘉義縣,六腳鄉,蒜南村,270,850,121,241,362,26,388
公投第１４案,嘉義縣,六腳鄉,工廠村,271,222,44,74,118,14,132
公投第１４案,嘉義縣,六腳鄉,灣南村,272,1216,170,363,533,62,595
公投第１４案,嘉義縣,六腳鄉,灣北村,273,1200,118,303,421,47,468
公投第１４案,嘉義縣,六腳鄉,雙涵村,274,877,109,260,369,41,410
公投第１４案,嘉義縣,六腳鄉,塗師村,275,644,87,148,235,40,275
公投第１４案,嘉義縣,六腳鄉,三義村,276,594,63,139,202,17,219
公投第１４案,嘉義縣,六腳鄉,三義村,277,167,11,30,41,1,42
公投第１４案,嘉義縣,六腳鄉,正義村,278,204,24,45,69,1,70
公投第１４案,嘉義縣,六腳鄉,正義村,279,234,35,54,89,1,90
公投第１４案,嘉義縣,六腳鄉,正義村,280,361,36,104,140,6,146
公投第１４案,嘉義縣,六腳鄉,正義村,281,592,87,202,289,43,332
公投第１４案,嘉義縣,六腳鄉,溪厝村,282,619,81,194,275,36,311
公投第１４案,嘉義縣,六腳鄉,港美村,283,714,70,169,239,41,280
公投第１４案,嘉義縣,六腳鄉,豐美村,284,1051,123,331,454,64,518
公投第１４案,嘉義縣,六腳鄉,六斗村,285,934,119,305,424,60,484
公投第１４案,嘉義縣,六腳鄉,崙陽村,286,1044,129,330,459,57,516
公投第１４案,嘉義縣,六腳鄉,蘇厝村,287,1476,183,410,593,39,632
公投第１４案,嘉義縣,六腳鄉,竹本村,288,618,65,144,209,19,228
公投第１４案,嘉義縣,六腳鄉,永賢村,289,478,33,95,128,34,162
公投第１４案,嘉義縣,六腳鄉,魚寮村,290,642,62,138,200,36,236
公投第１４案,嘉義縣,六腳鄉,潭墘村,291,883,82,194,276,16,292
公投第１４案,嘉義縣,六腳鄉,六腳村,292,739,55,181,236,5,241
公投第１４案,嘉義縣,六腳鄉,六南村,293,554,65,132,197,22,219
公投第１４案,嘉義縣,六腳鄉,崩山村,294,649,63,131,194,25,219
公投第１４案,嘉義縣,六腳鄉,古林村,295,689,69,160,229,19,248
公投第１４案,嘉義縣,六腳鄉,更寮村,296,455,37,118,155,21,176
公投第１４案,嘉義縣,六腳鄉,更寮村,297,125,7,28,35,3,38
公投第１４案,嘉義縣,東石鄉,東石村,298,1915,201,603,804,84,888
公投第１４案,嘉義縣,東石鄉,猿樹村,299,938,99,234,333,43,376
公投第１４案,嘉義縣,東石鄉,型厝村,300,1366,106,268,374,30,404
公投第１４案,嘉義縣,東石鄉,塭港村,301,1676,148,483,631,9,640
公投第１４案,嘉義縣,東石鄉,三家村,302,1151,112,286,398,78,476
公投第１４案,嘉義縣,東石鄉,永屯村,303,716,75,189,264,57,321
公投第１４案,嘉義縣,東石鄉,海埔村,304,387,30,88,118,15,133
公投第１４案,嘉義縣,東石鄉,龍港村,305,864,58,175,233,15,248
公投第１４案,嘉義縣,東石鄉,副瀨村,306,910,71,206,277,20,297
公投第１４案,嘉義縣,東石鄉,下揖村,307,760,59,186,245,14,259
公投第１４案,嘉義縣,東石鄉,頂揖村,308,166,11,61,72,15,87
公投第１４案,嘉義縣,東石鄉,頂揖村,309,212,15,55,70,10,80
公投第１４案,嘉義縣,東石鄉,溪下村,310,993,68,226,294,37,331
公投第１４案,嘉義縣,東石鄉,港口村,311,306,20,93,113,9,122
公投第１４案,嘉義縣,東石鄉,鰲鼓村,312,1046,82,265,347,64,411
公投第１４案,嘉義縣,東石鄉,鰲鼓村,313,235,13,65,78,12,90
公投第１４案,嘉義縣,東石鄉,港墘村,314,1226,118,370,488,70,558
公投第１４案,嘉義縣,東石鄉,蔦松村,315,843,88,222,310,55,365
公投第１４案,嘉義縣,東石鄉,圍潭村,316,693,76,184,260,30,290
公投第１４案,嘉義縣,東石鄉,洲仔村,317,839,83,283,366,46,412
公投第１４案,嘉義縣,東石鄉,東崙村,318,363,33,117,150,15,165
公投第１４案,嘉義縣,東石鄉,東崙村,319,321,33,69,102,10,112
公投第１４案,嘉義縣,東石鄉,西崙村,320,1083,133,372,505,91,596
公投第１４案,嘉義縣,東石鄉,塭仔村,321,901,119,243,362,53,415
公投第１４案,嘉義縣,東石鄉,網寮村,322,1216,86,282,368,36,404
公投第１４案,嘉義縣,東石鄉,掌潭村,323,418,62,149,211,38,249
公投第１４案,嘉義縣,東石鄉,掌潭村,324,371,33,115,148,7,155
公投第１４案,嘉義縣,布袋鎮,岱江里,325,614,82,195,277,23,300
公投第１４案,嘉義縣,布袋鎮,九龍里,326,372,38,110,148,21,169
公投第１４案,嘉義縣,布袋鎮,岑海里,327,914,139,307,446,65,511
公投第１４案,嘉義縣,布袋鎮,岑海里,328,1198,159,407,566,69,635
公投第１４案,嘉義縣,布袋鎮,興中里,329,1113,108,365,473,51,524
公投第１４案,嘉義縣,布袋鎮,光復里,330,992,143,333,476,62,538
公投第１４案,嘉義縣,布袋鎮,光復里,331,689,72,253,325,19,344
公投第１４案,嘉義縣,布袋鎮,見龍里,332,882,113,283,396,65,461
公投第１４案,嘉義縣,布袋鎮,新厝里,333,731,96,258,354,28,382
公投第１４案,嘉義縣,布袋鎮,龍江里,334,779,87,302,389,34,423
公投第１４案,嘉義縣,布袋鎮,振寮里,335,762,75,227,302,38,340
公投第１４案,嘉義縣,布袋鎮,西安里,336,1184,123,356,479,55,534
公投第１４案,嘉義縣,布袋鎮,中安里,337,1423,139,362,501,71,572
公投第１４案,嘉義縣,布袋鎮,東安里,338,1351,141,344,485,66,551
公投第１４案,嘉義縣,布袋鎮,樹林里,339,275,25,91,116,7,123
公投第１４案,嘉義縣,布袋鎮,樹林里,340,243,27,75,102,13,115
公投第１４案,嘉義縣,布袋鎮,貴舍里,341,661,77,210,287,76,363
公投第１４案,嘉義縣,布袋鎮,永安里,342,1145,134,359,493,46,539
公投第１４案,嘉義縣,布袋鎮,東港里,343,936,116,294,410,30,440
公投第１４案,嘉義縣,布袋鎮,東港里,344,958,142,277,419,37,456
公投第１４案,嘉義縣,布袋鎮,江山里,345,298,34,85,119,16,135
公投第１４案,嘉義縣,布袋鎮,菜舖里,346,428,64,154,218,30,248
公投第１４案,嘉義縣,布袋鎮,考試里,347,121,14,38,52,1,53
公投第１４案,嘉義縣,布袋鎮,考試里,348,174,13,32,45,6,51
公投第１４案,嘉義縣,布袋鎮,新岑里,349,953,111,303,414,39,453
公投第１４案,嘉義縣,布袋鎮,新民里,350,1292,167,478,645,47,692
公投第１４案,嘉義縣,布袋鎮,復興里,351,1127,127,436,563,45,608
公投第１４案,嘉義縣,布袋鎮,復興里,352,1244,166,407,573,30,603
公投第１４案,嘉義縣,布袋鎮,好美里,353,1106,146,338,484,21,505
公投第１４案,嘉義縣,義竹鄉,岸腳村,354,482,62,144,206,26,232
公投第１４案,嘉義縣,義竹鄉,岸腳村,355,223,26,83,109,21,130
公投第１４案,嘉義縣,義竹鄉,義竹村,356,1529,233,507,740,84,824
公投第１４案,嘉義縣,義竹鄉,六桂村,357,1175,173,427,600,59,659
公投第１４案,嘉義縣,義竹鄉,仁里村,358,886,151,332,483,64,547
公投第１４案,嘉義縣,義竹鄉,傳芳村,359,743,91,214,305,31,336
公投第１４案,嘉義縣,義竹鄉,頭竹村,360,1236,184,406,590,91,681
公投第１４案,嘉義縣,義竹鄉,五厝村,361,377,53,116,169,25,194
公投第１４案,嘉義縣,義竹鄉,中平村,362,338,38,92,130,23,153
公投第１４案,嘉義縣,義竹鄉,中平村,363,102,12,45,57,2,59
公投第１４案,嘉義縣,義竹鄉,埤前村,364,763,101,212,313,23,336
公投第１４案,嘉義縣,義竹鄉,平溪村,365,429,62,157,219,29,248
公投第１４案,嘉義縣,義竹鄉,後鎮村,366,427,57,141,198,14,212
公投第１４案,嘉義縣,義竹鄉,北華村,367,607,90,194,284,47,331
公投第１４案,嘉義縣,義竹鄉,新店村,368,1486,200,438,638,46,684
公投第１４案,嘉義縣,義竹鄉,東過村,369,835,104,317,421,57,478
公投第１４案,嘉義縣,義竹鄉,西過村,370,816,94,201,295,59,354
公投第１４案,嘉義縣,義竹鄉,官和村,371,833,117,214,331,54,385
公投第１４案,嘉義縣,義竹鄉,官順村,372,433,42,160,202,12,214
公投第１４案,嘉義縣,義竹鄉,新富村,373,558,63,176,239,5,244
公投第１４案,嘉義縣,義竹鄉,東光村,374,602,91,187,278,35,313
公投第１４案,嘉義縣,義竹鄉,東光村,375,140,13,42,55,2,57
公投第１４案,嘉義縣,義竹鄉,東榮村,376,393,48,111,159,20,179
公投第１４案,嘉義縣,義竹鄉,龍蛟村,377,585,75,194,269,22,291
公投第１４案,嘉義縣,義竹鄉,溪洲村,378,526,41,135,176,7,183
公投第１４案,嘉義縣,義竹鄉,溪洲村,379,123,18,49,67,7,74
公投第１４案,嘉義縣,中埔鄉,富收村,380,1046,100,299,399,26,425
公投第１４案,嘉義縣,中埔鄉,富收村,381,1788,252,510,762,82,844
公投第１４案,嘉義縣,中埔鄉,和睦村,382,1730,225,522,747,42,789
公投第１４案,嘉義縣,中埔鄉,和睦村,383,1581,224,500,724,52,776
公投第１４案,嘉義縣,中埔鄉,和美村,384,1594,189,453,642,39,681
公投第１４案,嘉義縣,中埔鄉,和美村,385,1801,279,605,884,33,917
公投第１４案,嘉義縣,中埔鄉,和美村,386,1862,236,619,855,55,910
公投第１４案,嘉義縣,中埔鄉,和美村,387,1803,229,568,797,28,825
公投第１４案,嘉義縣,中埔鄉,和興村,388,1481,211,506,717,54,771
公投第１４案,嘉義縣,中埔鄉,和興村,389,1366,200,468,668,56,724
公投第１４案,嘉義縣,中埔鄉,和興村,390,1599,184,474,658,58,716
公投第１４案,嘉義縣,中埔鄉,和興村,391,1196,182,383,565,38,603
公投第１４案,嘉義縣,中埔鄉,中埔村,392,1809,228,508,736,92,828
公投第１４案,嘉義縣,中埔鄉,塩舘村,393,953,130,305,435,23,458
公投第１４案,嘉義縣,中埔鄉,金蘭村,394,1441,180,436,616,55,671
公投第１４案,嘉義縣,中埔鄉,隆興村,395,1882,202,597,799,67,866
公投第１４案,嘉義縣,中埔鄉,義仁村,396,1470,160,378,538,18,556
公投第１４案,嘉義縣,中埔鄉,社口村,397,1699,186,494,680,76,756
公投第１４案,嘉義縣,中埔鄉,社口村,398,422,37,120,157,18,175
公投第１４案,嘉義縣,中埔鄉,灣潭村,399,1030,140,315,455,58,513
公投第１４案,嘉義縣,中埔鄉,裕民村,400,879,125,267,392,31,423
公投第１４案,嘉義縣,中埔鄉,龍門村,401,828,94,249,343,20,363
公投第１４案,嘉義縣,中埔鄉,石硦村,402,881,119,325,444,62,506
公投第１４案,嘉義縣,中埔鄉,石硦村,403,296,39,98,137,11,148
公投第１４案,嘉義縣,中埔鄉,頂埔村,404,979,118,296,414,65,479
公投第１４案,嘉義縣,中埔鄉,同仁村,405,1268,143,378,521,40,561
公投第１４案,嘉義縣,中埔鄉,同仁村,406,670,66,130,196,10,206
公投第１４案,嘉義縣,中埔鄉,深坑村,407,754,115,257,372,59,431
公投第１４案,嘉義縣,中埔鄉,三層村,408,648,122,200,322,35,357
公投第１４案,嘉義縣,中埔鄉,瑞豐村,409,741,86,188,274,25,299
公投第１４案,嘉義縣,中埔鄉,沄水村,410,518,67,154,221,12,233
公投第１４案,嘉義縣,中埔鄉,沄水村,411,482,66,149,215,27,242
公投第１４案,嘉義縣,中埔鄉,東興村,412,348,39,100,139,8,147
公投第１４案,嘉義縣,中埔鄉,中崙村,413,294,40,97,137,11,148
公投第１４案,嘉義縣,竹崎鄉,竹崎村,414,1312,207,445,652,37,689
公投第１４案,嘉義縣,竹崎鄉,竹崎村,415,1210,178,455,633,22,655
公投第１４案,嘉義縣,竹崎鄉,和平村,416,991,128,390,518,35,553
公投第１４案,嘉義縣,竹崎鄉,和平村,417,1207,168,432,600,30,630
公投第１４案,嘉義縣,竹崎鄉,坑頭村,418,752,110,216,326,12,338
公投第１４案,嘉義縣,竹崎鄉,沙坑村,419,833,129,302,431,54,485
公投第１４案,嘉義縣,竹崎鄉,獅埜村,420,1220,162,470,632,62,694
公投第１４案,嘉義縣,竹崎鄉,義和村,421,616,93,243,336,19,355
公投第１４案,嘉義縣,竹崎鄉,義仁村,422,1031,120,360,480,49,529
公投第１４案,嘉義縣,竹崎鄉,灣橋村,423,1292,155,464,619,50,669
公投第１４案,嘉義縣,竹崎鄉,灣橋村,424,1995,281,763,1044,58,1102
公投第１４案,嘉義縣,竹崎鄉,灣橋村,425,1996,248,659,907,27,934
公投第１４案,嘉義縣,竹崎鄉,鹿滿村,426,1449,307,380,687,71,758
公投第１４案,嘉義縣,竹崎鄉,紫雲村,427,1420,190,514,704,34,738
公投第１４案,嘉義縣,竹崎鄉,內埔村,428,1590,219,601,820,46,866
公投第１４案,嘉義縣,竹崎鄉,昇平村,429,771,99,264,363,28,391
公投第１４案,嘉義縣,竹崎鄉,昇平村,430,1014,140,290,430,50,480
公投第１４案,嘉義縣,竹崎鄉,桃源村,431,327,27,86,113,5,118
公投第１４案,嘉義縣,竹崎鄉,桃源村,432,687,71,274,345,22,367
公投第１４案,嘉義縣,竹崎鄉,白杞村,433,641,73,223,296,19,315
公投第１４案,嘉義縣,竹崎鄉,塘興村,434,474,70,180,250,10,260
公投第１４案,嘉義縣,竹崎鄉,塘興村,435,383,43,136,179,15,194
公投第１４案,嘉義縣,竹崎鄉,義隆村,436,619,81,256,337,41,378
公投第１４案,嘉義縣,竹崎鄉,龍山村,437,214,29,63,92,8,100
公投第１４案,嘉義縣,竹崎鄉,龍山村,438,1568,206,526,732,83,815
公投第１４案,嘉義縣,竹崎鄉,文峯村,439,658,58,218,276,26,302
公投第１４案,嘉義縣,竹崎鄉,金獅村,440,434,62,161,223,31,254
公投第１４案,嘉義縣,竹崎鄉,復金村,441,917,124,328,452,46,498
公投第１４案,嘉義縣,竹崎鄉,復金村,442,981,129,303,432,46,478
公投第１４案,嘉義縣,竹崎鄉,緞繻村,443,789,91,260,351,18,369
公投第１４案,嘉義縣,竹崎鄉,緞繻村,444,108,6,20,26,4,30
公投第１４案,嘉義縣,竹崎鄉,仁壽村,445,235,24,37,61,2,63
公投第１４案,嘉義縣,竹崎鄉,中和村,446,331,41,104,145,4,149
公投第１４案,嘉義縣,竹崎鄉,中和村,447,450,77,189,266,8,274
公投第１４案,嘉義縣,竹崎鄉,光華村,448,462,40,147,187,7,194
公投第１４案,嘉義縣,竹崎鄉,光華村,449,251,21,72,93,13,106
公投第１４案,嘉義縣,番路鄉,江西村,450,1174,198,451,649,61,710
公投第１４案,嘉義縣,番路鄉,內甕村,451,449,71,192,263,9,272
公投第１４案,嘉義縣,番路鄉,新福村,452,753,105,311,416,37,453
公投第１４案,嘉義縣,番路鄉,新福村,453,551,61,176,237,27,264
公投第１４案,嘉義縣,番路鄉,下坑村,454,1791,282,657,939,66,1005
公投第１４案,嘉義縣,番路鄉,番路村,455,849,134,358,492,46,538
公投第１４案,嘉義縣,番路鄉,民和村,456,866,139,335,474,26,500
公投第１４案,嘉義縣,番路鄉,觸口村,457,800,79,331,410,29,439
公投第１４案,嘉義縣,番路鄉,觸口村,458,444,74,160,234,24,258
公投第１４案,嘉義縣,番路鄉,大湖村,459,635,59,193,252,11,263
公投第１４案,嘉義縣,番路鄉,公田村,460,319,32,106,138,9,147
公投第１４案,嘉義縣,番路鄉,公田村,461,642,60,308,368,20,388
公投第１４案,嘉義縣,番路鄉,公興村,462,509,38,175,213,19,232
公投第１４案,嘉義縣,番路鄉,草山村,463,162,13,77,90,1,91
公投第１４案,嘉義縣,番路鄉,草山村,464,212,19,93,112,9,121
公投第１４案,嘉義縣,大埔鄉,大埔村,465,1468,241,507,748,61,809
公投第１４案,嘉義縣,大埔鄉,和平村,466,320,33,92,125,3,128
公投第１４案,嘉義縣,大埔鄉,和平村,467,304,52,114,166,8,174
公投第１４案,嘉義縣,大埔鄉,永樂村,468,184,21,70,91,2,93
公投第１４案,嘉義縣,大埔鄉,永樂村,469,234,45,108,153,6,159
公投第１４案,嘉義縣,大埔鄉,茄苳村,470,495,76,165,241,9,250
公投第１４案,嘉義縣,大埔鄉,茄苳村,471,199,32,78,110,5,115
公投第１４案,嘉義縣,大埔鄉,茄苳村,472,226,28,76,104,7,111
公投第１４案,嘉義縣,大埔鄉,西興村,473,569,84,244,328,20,348
公投第１４案,嘉義縣,阿里山鄉,中山村,474,371,40,136,176,9,185
公投第１４案,嘉義縣,阿里山鄉,中正村,475,197,17,66,83,4,87
公投第１４案,嘉義縣,阿里山鄉,香林村,476,152,11,56,67,2,69
公投第１４案,嘉義縣,阿里山鄉,十字村,477,231,19,54,73,6,79
公投第１４案,嘉義縣,阿里山鄉,十字村,478,72,3,18,21,0,21
公投第１４案,嘉義縣,阿里山鄉,豐山村,479,311,27,110,137,4,141
公投第１４案,嘉義縣,阿里山鄉,來吉村,480,306,28,126,154,9,163
公投第１４案,嘉義縣,阿里山鄉,樂野村,481,970,100,341,441,15,456
公投第１４案,嘉義縣,阿里山鄉,達邦村,482,827,94,330,424,30,454
公投第１４案,嘉義縣,阿里山鄉,里佳村,483,238,23,103,126,1,127
公投第１４案,嘉義縣,阿里山鄉,山美村,484,479,20,105,125,11,136
公投第１４案,嘉義縣,阿里山鄉,新美村,485,291,28,77,105,7,112
公投第１４案,嘉義縣,阿里山鄉,茶山村,486,246,27,117,144,14,158
公投第１４案,屏東縣,屏東市,端正里,1,237,79,44,123,5,128
公投第１４案,屏東縣,屏東市,武廟里,2,294,53,94,147,19,166
公投第１４案,屏東縣,屏東市,大同里,3,582,132,167,299,17,316
公投第１４案,屏東縣,屏東市,光榮里,4,713,145,239,384,24,408
公投第１４案,屏東縣,屏東市,民權里,5,572,106,186,292,26,318
公投第１４案,屏東縣,屏東市,泰安里,6,455,84,194,278,5,283
公投第１４案,屏東縣,屏東市,文明里,7,249,51,89,140,0,140
公投第１４案,屏東縣,屏東市,維新里,8,1315,181,422,603,24,627
公投第１４案,屏東縣,屏東市,維新里,9,1373,243,387,630,36,666
公投第１４案,屏東縣,屏東市,大埔里,10,713,145,283,428,31,459
公投第１４案,屏東縣,屏東市,必信里,11,573,122,215,337,29,366
公投第１４案,屏東縣,屏東市,崇禮里,12,297,65,121,186,16,202
公投第１４案,屏東縣,屏東市,崇智里,13,409,83,185,268,15,283
公投第１４案,屏東縣,屏東市,慶春里,14,286,50,91,141,19,160
公投第１４案,屏東縣,屏東市,楠樹里,15,421,81,159,240,9,249
公投第１４案,屏東縣,屏東市,扶風里,16,569,119,190,309,14,323
公投第１４案,屏東縣,屏東市,安樂里,17,459,105,133,238,11,249
公投第１４案,屏東縣,屏東市,平和里,18,672,157,254,411,20,431
公投第１４案,屏東縣,屏東市,金泉里,19,668,154,235,389,35,424
公投第１４案,屏東縣,屏東市,勝豐里,20,411,89,135,224,12,236
公投第１４案,屏東縣,屏東市,橋南里,21,768,126,288,414,25,439
公投第１４案,屏東縣,屏東市,橋南里,22,786,135,271,406,31,437
公投第１４案,屏東縣,屏東市,橋北里,23,890,169,323,492,33,525
公投第１４案,屏東縣,屏東市,大連里,24,1353,214,508,722,38,760
公投第１４案,屏東縣,屏東市,大連里,25,1386,205,514,719,19,738
公投第１４案,屏東縣,屏東市,大連里,26,1413,249,487,736,29,765
公投第１４案,屏東縣,屏東市,大連里,27,1272,182,477,659,28,687
公投第１４案,屏東縣,屏東市,大連里,28,1287,234,452,686,20,706
公投第１４案,屏東縣,屏東市,大連里,29,1311,244,461,705,31,736
公投第１４案,屏東縣,屏東市,大連里,30,1285,211,485,696,19,715
公投第１４案,屏東縣,屏東市,豐田里,31,1297,240,475,715,30,745
公投第１４案,屏東縣,屏東市,豐田里,32,1361,216,489,705,20,725
公投第１４案,屏東縣,屏東市,豐田里,33,1381,194,479,673,39,712
公投第１４案,屏東縣,屏東市,豐榮里,34,1258,222,474,696,47,743
公投第１４案,屏東縣,屏東市,豐榮里,35,1259,215,459,674,40,714
公投第１４案,屏東縣,屏東市,豐源里,36,1076,168,392,560,31,591
公投第１４案,屏東縣,屏東市,豐源里,37,1162,217,428,645,25,670
公投第１４案,屏東縣,屏東市,豐源里,38,1318,246,484,730,21,751
公投第１４案,屏東縣,屏東市,長春里,39,939,163,333,496,30,526
公投第１４案,屏東縣,屏東市,長春里,40,972,176,366,542,20,562
公投第１４案,屏東縣,屏東市,瑞光里,41,1535,286,554,840,32,872
公投第１４案,屏東縣,屏東市,瑞光里,42,1419,188,470,658,30,688
公投第１４案,屏東縣,屏東市,瑞光里,43,1398,193,479,672,13,685
公投第１４案,屏東縣,屏東市,瑞光里,44,1405,239,469,708,46,754
公投第１４案,屏東縣,屏東市,瑞光里,45,1486,247,540,787,28,815
公投第１４案,屏東縣,屏東市,湖南里,46,1061,196,337,533,58,591
公投第１４案,屏東縣,屏東市,湖西里,47,1540,227,455,682,75,757
公投第１４案,屏東縣,屏東市,歸心里,48,1141,191,345,536,17,553
公投第１４案,屏東縣,屏東市,清溪里,49,1247,218,369,587,37,624
公投第１４案,屏東縣,屏東市,清溪里,50,1446,243,460,703,31,734
公投第１４案,屏東縣,屏東市,清溪里,51,1303,212,512,724,26,750
公投第１４案,屏東縣,屏東市,大武里,52,1253,187,473,660,30,690
公投第１４案,屏東縣,屏東市,大武里,53,1315,206,473,679,36,715
公投第１４案,屏東縣,屏東市,大武里,54,1425,240,454,694,33,727
公投第１４案,屏東縣,屏東市,大武里,55,1423,218,502,720,15,735
公投第１４案,屏東縣,屏東市,大武里,56,1400,223,528,751,45,796
公投第１４案,屏東縣,屏東市,大武里,57,1359,265,484,749,38,787
公投第１４案,屏東縣,屏東市,崇武里,58,1328,176,524,700,18,718
公投第１４案,屏東縣,屏東市,崇武里,59,1539,216,592,808,28,836
公投第１４案,屏東縣,屏東市,凌雲里,60,391,48,93,141,4,145
公投第１４案,屏東縣,屏東市,永昌里,61,200,32,73,105,12,117
公投第１４案,屏東縣,屏東市,永順里,62,328,48,97,145,22,167
公投第１４案,屏東縣,屏東市,鵬程里,63,231,30,87,117,4,121
公投第１４案,屏東縣,屏東市,安鎮里,64,945,121,328,449,54,503
公投第１４案,屏東縣,屏東市,安鎮里,65,1053,181,335,516,38,554
公投第１４案,屏東縣,屏東市,永光里,66,1043,139,341,480,58,538
公投第１４案,屏東縣,屏東市,長安里,67,1061,153,348,501,53,554
公投第１４案,屏東縣,屏東市,長安里,68,876,132,281,413,39,452
公投第１４案,屏東縣,屏東市,前進里,69,1468,176,512,688,86,774
公投第１４案,屏東縣,屏東市,前進里,70,1454,214,457,671,57,728
公投第１４案,屏東縣,屏東市,大洲里,71,1205,225,418,643,22,665
公投第１４案,屏東縣,屏東市,新興里,72,1284,216,420,636,29,665
公投第１４案,屏東縣,屏東市,新興里,73,1219,188,387,575,40,615
公投第１４案,屏東縣,屏東市,公館里,74,1544,257,545,802,73,875
公投第１４案,屏東縣,屏東市,新生里,75,1485,238,494,732,76,808
公投第１４案,屏東縣,屏東市,新生里,76,1387,229,507,736,34,770
公投第１４案,屏東縣,屏東市,新生里,77,953,134,343,477,19,496
公投第１４案,屏東縣,屏東市,新生里,78,1603,289,564,853,35,888
公投第１４案,屏東縣,屏東市,頂宅里,79,535,105,166,271,27,298
公投第１４案,屏東縣,屏東市,頂柳里,80,1119,169,379,548,42,590
公投第１４案,屏東縣,屏東市,大湖里,81,847,134,312,446,31,477
公投第１４案,屏東縣,屏東市,大湖里,82,923,177,312,489,61,550
公投第１４案,屏東縣,屏東市,龍華里,83,1227,208,391,599,32,631
公投第１４案,屏東縣,屏東市,龍華里,84,1039,140,385,525,45,570
公投第１４案,屏東縣,屏東市,玉成里,85,1485,215,493,708,86,794
公投第１４案,屏東縣,屏東市,擇仁里,86,867,146,289,435,43,478
公投第１４案,屏東縣,屏東市,建國里,87,918,138,331,469,37,506
公投第１４案,屏東縣,屏東市,萬年里,88,663,86,222,308,36,344
公投第１４案,屏東縣,屏東市,厚生里,89,1215,177,371,548,24,572
公投第１４案,屏東縣,屏東市,厚生里,90,1628,261,462,723,63,786
公投第１４案,屏東縣,屏東市,一心里,91,1209,222,407,629,46,675
公投第１４案,屏東縣,屏東市,義勇里,92,1110,180,500,680,19,699
公投第１４案,屏東縣,屏東市,光華里,93,684,83,222,305,18,323
公投第１４案,屏東縣,屏東市,永安里,94,1349,199,383,582,33,615
公投第１４案,屏東縣,屏東市,永安里,95,1457,204,458,662,60,722
公投第１４案,屏東縣,屏東市,永安里,96,1447,243,517,760,33,793
公投第１４案,屏東縣,屏東市,永安里,97,1354,238,418,656,26,682
公投第１４案,屏東縣,屏東市,永安里,98,1583,273,564,837,54,891
公投第１４案,屏東縣,屏東市,崇蘭里,99,1707,235,631,866,17,883
公投第１４案,屏東縣,屏東市,崇蘭里,100,1637,221,528,749,17,766
公投第１４案,屏東縣,屏東市,崇蘭里,101,1459,195,504,699,32,731
公投第１４案,屏東縣,屏東市,崇蘭里,102,1759,275,647,922,35,957
公投第１４案,屏東縣,屏東市,崇蘭里,103,1950,292,680,972,35,1007
公投第１４案,屏東縣,屏東市,崇蘭里,104,1729,241,648,889,28,917
公投第１４案,屏東縣,屏東市,崇蘭里,105,1592,239,550,789,24,813
公投第１４案,屏東縣,屏東市,潭墘里,106,1437,211,478,689,24,713
公投第１４案,屏東縣,屏東市,潭墘里,107,1204,143,443,586,30,616
公投第１４案,屏東縣,屏東市,潭墘里,108,1340,177,630,807,27,834
公投第１４案,屏東縣,屏東市,潭墘里,109,1322,198,487,685,33,718
公投第１４案,屏東縣,屏東市,潭墘里,110,1462,197,514,711,38,749
公投第１４案,屏東縣,屏東市,潭墘里,111,3241,465,1076,1541,48,1589
公投第１４案,屏東縣,屏東市,潭墘里,112,1477,206,504,710,15,725
公投第１４案,屏東縣,屏東市,永城里,113,821,111,273,384,17,401
公投第１４案,屏東縣,屏東市,永城里,114,1099,143,333,476,21,497
公投第１４案,屏東縣,屏東市,空翔里,115,1688,193,640,833,39,872
公投第１４案,屏東縣,屏東市,廣興里,116,1167,197,369,566,30,596
公投第１４案,屏東縣,屏東市,廣興里,117,915,136,317,453,37,490
公投第１４案,屏東縣,屏東市,勝利里,118,1683,147,353,500,27,527
公投第１４案,屏東縣,屏東市,勝利里,119,1497,156,584,740,17,757
公投第１４案,屏東縣,屏東市,勝利里,120,1129,157,400,557,27,584
公投第１４案,屏東縣,屏東市,勝利里,121,1232,185,455,640,27,667
公投第１４案,屏東縣,屏東市,斯文里,122,853,132,312,444,21,465
公投第１４案,屏東縣,屏東市,斯文里,123,869,153,335,488,21,509
公投第１４案,屏東縣,屏東市,華山里,124,1169,190,442,632,38,670
公投第１４案,屏東縣,屏東市,華山里,125,1058,173,389,562,31,593
公投第１４案,屏東縣,屏東市,華山里,126,1344,205,437,642,29,671
公投第１４案,屏東縣,屏東市,華山里,127,1299,218,459,677,23,700
公投第１４案,屏東縣,屏東市,溝美里,128,1204,191,390,581,30,611
公投第１４案,屏東縣,屏東市,溝美里,129,1123,180,387,567,26,593
公投第１４案,屏東縣,屏東市,三山里,130,1318,197,394,591,32,623
公投第１４案,屏東縣,屏東市,海豐里,131,865,155,317,472,44,516
公投第１４案,屏東縣,屏東市,仁義里,132,1100,137,351,488,24,512
公投第１４案,屏東縣,屏東市,北興里,133,1215,184,386,570,24,594
公投第１４案,屏東縣,屏東市,北興里,134,1370,200,496,696,30,726
公投第１４案,屏東縣,屏東市,北興里,135,1240,176,461,637,20,657
公投第１４案,屏東縣,屏東市,北興里,136,1168,219,416,635,34,669
公投第１４案,屏東縣,屏東市,北興里,137,1079,173,400,573,16,589
公投第１４案,屏東縣,屏東市,北勢里,138,1289,231,462,693,50,743
公投第１４案,屏東縣,屏東市,北勢里,139,1115,188,384,572,20,592
公投第１４案,屏東縣,屏東市,中正里,140,1491,259,530,789,47,836
公投第１４案,屏東縣,屏東市,中正里,141,1411,199,464,663,19,682
公投第１４案,屏東縣,屏東市,中正里,142,1803,288,605,893,22,915
公投第１４案,屏東縣,屏東市,興樂里,143,744,112,295,407,20,427
公投第１４案,屏東縣,屏東市,明正里,144,678,112,234,346,25,371
公投第１４案,屏東縣,屏東市,太平里,145,681,116,269,385,16,401
公投第１４案,屏東縣,屏東市,信和里,146,1535,116,535,651,36,687
公投第１４案,屏東縣,屏東市,和興里,147,954,142,342,484,62,546
公投第１４案,屏東縣,屏東市,仁愛里,148,1018,183,396,579,36,615
公投第１４案,屏東縣,屏東市,仁愛里,149,1154,209,422,631,24,655
公投第１４案,屏東縣,潮州鎮,潮州里,150,504,87,188,275,30,305
公投第１４案,屏東縣,潮州鎮,光華里,151,1711,252,527,779,38,817
公投第１４案,屏東縣,潮州鎮,光華里,152,1634,240,570,810,24,834
公投第１４案,屏東縣,潮州鎮,光華里,153,1414,191,452,643,24,667
公投第１４案,屏東縣,潮州鎮,同榮里,154,603,110,224,334,44,378
公投第１４案,屏東縣,潮州鎮,彭城里,155,896,132,303,435,55,490
公投第１４案,屏東縣,潮州鎮,三星里,156,1285,183,447,630,46,676
公投第１４案,屏東縣,潮州鎮,三星里,157,1744,238,587,825,41,866
公投第１４案,屏東縣,潮州鎮,三星里,158,1071,168,412,580,36,616
公投第１４案,屏東縣,潮州鎮,三星里,159,1209,179,481,660,54,714
公投第１４案,屏東縣,潮州鎮,三共里,160,1159,182,406,588,33,621
公投第１４案,屏東縣,潮州鎮,三共里,161,1296,190,436,626,41,667
公投第１４案,屏東縣,潮州鎮,三共里,162,1466,220,510,730,51,781
公投第１４案,屏東縣,潮州鎮,三共里,163,1130,170,435,605,44,649
公投第１４案,屏東縣,潮州鎮,三共里,164,1439,230,504,734,45,779
公投第１４案,屏東縣,潮州鎮,三和里,165,897,127,358,485,42,527
公投第１４案,屏東縣,潮州鎮,三和里,166,1225,175,478,653,42,695
公投第１４案,屏東縣,潮州鎮,九塊里,167,1158,174,361,535,50,585
公投第１４案,屏東縣,潮州鎮,九塊里,168,481,64,125,189,28,217
公投第１４案,屏東縣,潮州鎮,新生里,169,972,169,352,521,37,558
公投第１４案,屏東縣,潮州鎮,新榮里,170,1245,200,484,684,46,730
公投第１４案,屏東縣,潮州鎮,五魁里,171,1415,205,507,712,41,753
公投第１４案,屏東縣,潮州鎮,蓬萊里,172,1255,200,369,569,17,586
公投第１４案,屏東縣,潮州鎮,蓬萊里,173,1058,118,287,405,25,430
公投第１４案,屏東縣,潮州鎮,八爺里,174,1187,174,407,581,33,614
公投第１４案,屏東縣,潮州鎮,八爺里,175,1083,159,397,556,55,611
公投第１４案,屏東縣,潮州鎮,永春里,176,1590,222,505,727,33,760
公投第１４案,屏東縣,潮州鎮,永春里,177,1543,215,585,800,50,850
公投第１４案,屏東縣,潮州鎮,永春里,178,1631,244,521,765,45,810
公投第１４案,屏東縣,潮州鎮,永春里,179,1159,167,438,605,22,627
公投第１４案,屏東縣,潮州鎮,永春里,180,1099,171,424,595,25,620
公投第１４案,屏東縣,潮州鎮,富春里,181,1200,157,383,540,50,590
公投第１４案,屏東縣,潮州鎮,光春里,182,1391,154,503,657,46,703
公投第１４案,屏東縣,潮州鎮,興美里,183,881,135,327,462,44,506
公投第１４案,屏東縣,潮州鎮,檨子里,184,454,46,144,190,20,210
公投第１４案,屏東縣,潮州鎮,泗林里,185,1658,240,587,827,66,893
公投第１４案,屏東縣,潮州鎮,四春里,186,822,110,264,374,28,402
公投第１４案,屏東縣,潮州鎮,四春里,187,948,191,201,392,32,424
公投第１４案,屏東縣,潮州鎮,崙東里,188,1194,136,335,471,27,498
公投第１４案,屏東縣,潮州鎮,崙東里,189,337,51,112,163,28,191
公投第１４案,屏東縣,東港鎮,新勝里,190,981,156,382,538,46,584
公投第１４案,屏東縣,東港鎮,新勝里,191,1070,180,402,582,55,637
公投第１４案,屏東縣,東港鎮,頂新里,192,527,73,236,309,38,347
公投第１４案,屏東縣,東港鎮,頂中里,193,395,61,161,222,18,240
公投第１４案,屏東縣,東港鎮,東和里,194,659,88,219,307,31,338
公投第１４案,屏東縣,東港鎮,興台里,195,513,84,177,261,23,284
公投第１４案,屏東縣,東港鎮,興東里,196,1732,262,579,841,50,891
公投第１４案,屏東縣,東港鎮,興東里,197,1779,266,636,902,51,953
公投第１４案,屏東縣,東港鎮,興東里,198,1270,176,431,607,36,643
公投第１４案,屏東縣,東港鎮,興東里,199,1327,185,465,650,47,697
公投第１４案,屏東縣,東港鎮,興東里,200,1242,200,444,644,56,700
公投第１４案,屏東縣,東港鎮,興東里,201,1607,234,583,817,67,884
公投第１４案,屏東縣,東港鎮,興農里,202,1305,195,400,595,45,640
公投第１４案,屏東縣,東港鎮,中興里,203,695,102,257,359,32,391
公投第１４案,屏東縣,東港鎮,朝安里,204,1076,176,415,591,69,660
公投第１４案,屏東縣,東港鎮,朝安里,205,567,76,186,262,29,291
公投第１４案,屏東縣,東港鎮,八德里,206,806,115,264,379,32,411
公投第１４案,屏東縣,東港鎮,東隆里,207,1227,176,440,616,67,683
公投第１４案,屏東縣,東港鎮,豐漁里,208,599,70,200,270,55,325
公投第１４案,屏東縣,東港鎮,盛漁里,209,1354,147,391,538,38,576
公投第１４案,屏東縣,東港鎮,興漁里,210,734,150,196,346,45,391
公投第１４案,屏東縣,東港鎮,興漁里,211,1107,152,372,524,111,635
公投第１４案,屏東縣,東港鎮,鎮海里,212,1198,165,359,524,74,598
公投第１４案,屏東縣,東港鎮,鎮海里,213,1614,223,493,716,98,814
公投第１４案,屏東縣,東港鎮,嘉蓮里,214,826,114,267,381,42,423
公投第１４案,屏東縣,東港鎮,嘉蓮里,215,912,129,337,466,54,520
公投第１４案,屏東縣,東港鎮,南平里,216,432,57,147,204,24,228
公投第１４案,屏東縣,東港鎮,南平里,217,1204,181,412,593,88,681
公投第１４案,屏東縣,東港鎮,船頭里,218,1304,185,480,665,54,719
公投第１４案,屏東縣,東港鎮,船頭里,219,1317,201,492,693,54,747
公投第１４案,屏東縣,東港鎮,船頭里,220,1387,189,482,671,37,708
公投第１４案,屏東縣,東港鎮,船頭里,221,1310,160,408,568,37,605
公投第１４案,屏東縣,東港鎮,下廍里,222,1228,191,377,568,37,605
公投第１４案,屏東縣,東港鎮,下廍里,223,766,108,224,332,41,373
公投第１４案,屏東縣,東港鎮,大潭里,224,823,150,285,435,45,480
公投第１４案,屏東縣,東港鎮,大潭里,225,755,77,196,273,16,289
公投第１４案,屏東縣,東港鎮,興和里,226,1094,159,402,561,66,627
公投第１４案,屏東縣,東港鎮,共和里,227,753,86,259,345,27,372
公投第１４案,屏東縣,恆春鎮,城南里,228,902,98,295,393,32,425
公投第１４案,屏東縣,恆春鎮,城北里,229,969,165,356,521,33,554
公投第１４案,屏東縣,恆春鎮,城北里,230,1280,195,391,586,44,630
公投第１４案,屏東縣,恆春鎮,城西里,231,1133,175,413,588,22,610
公投第１４案,屏東縣,恆春鎮,網紗里,232,1552,203,440,643,15,658
公投第１４案,屏東縣,恆春鎮,網紗里,233,1485,182,394,576,47,623
公投第１４案,屏東縣,恆春鎮,仁壽里,234,896,110,330,440,42,482
公投第１４案,屏東縣,恆春鎮,茄湖里,235,531,68,161,229,21,250
公投第１４案,屏東縣,恆春鎮,頭溝里,236,478,59,150,209,10,219
公投第１４案,屏東縣,恆春鎮,四溝里,237,1020,139,310,449,40,489
公投第１４案,屏東縣,恆春鎮,德和里,238,924,151,274,425,21,446
公投第１４案,屏東縣,恆春鎮,龍水里,239,1079,134,313,447,26,473
公投第１４案,屏東縣,恆春鎮,山海里,240,775,74,229,303,20,323
公投第１４案,屏東縣,恆春鎮,山海里,241,813,89,319,408,45,453
公投第１４案,屏東縣,恆春鎮,大光里,242,1104,133,344,477,46,523
公投第１４案,屏東縣,恆春鎮,大光里,243,1110,150,300,450,46,496
公投第１４案,屏東縣,恆春鎮,水泉里,244,692,84,164,248,49,297
公投第１４案,屏東縣,恆春鎮,水泉里,245,708,73,177,250,10,260
公投第１４案,屏東縣,恆春鎮,山腳里,246,1505,427,282,709,17,726
公投第１４案,屏東縣,恆春鎮,山腳里,247,1111,140,332,472,44,516
公投第１４案,屏東縣,恆春鎮,山腳里,248,1543,182,491,673,34,707
公投第１４案,屏東縣,恆春鎮,南灣里,249,828,117,203,320,17,337
公投第１４案,屏東縣,恆春鎮,南灣里,250,844,137,278,415,29,444
公投第１４案,屏東縣,恆春鎮,墾丁里,251,1253,190,381,571,38,609
公投第１４案,屏東縣,恆春鎮,鵝鑾里,252,1126,138,337,475,38,513
公投第１４案,屏東縣,萬丹鄉,香社村,253,1527,185,440,625,47,672
公投第１４案,屏東縣,萬丹鄉,新庄村,254,1147,157,351,508,61,569
公投第１４案,屏東縣,萬丹鄉,新庄村,255,949,145,278,423,37,460
公投第１４案,屏東縣,萬丹鄉,新鐘村,256,990,139,300,439,40,479
公投第１４案,屏東縣,萬丹鄉,新鐘村,257,1022,132,337,469,13,482
公投第１４案,屏東縣,萬丹鄉,水仙村,258,545,101,217,318,50,368
公投第１４案,屏東縣,萬丹鄉,興全村,259,1159,170,450,620,86,706
公投第１４案,屏東縣,萬丹鄉,興安村,260,837,150,287,437,64,501
公投第１４案,屏東縣,萬丹鄉,甘棠村,261,392,58,123,181,17,198
公投第１４案,屏東縣,萬丹鄉,萬惠村,262,847,130,320,450,37,487
公投第１４案,屏東縣,萬丹鄉,萬全村,263,1149,160,390,550,39,589
公投第１４案,屏東縣,萬丹鄉,萬全村,264,1131,176,387,563,45,608
公投第１４案,屏東縣,萬丹鄉,萬全村,265,1178,185,377,562,48,610
公投第１４案,屏東縣,萬丹鄉,萬後村,266,711,116,286,402,23,425
公投第１４案,屏東縣,萬丹鄉,萬安村,267,595,116,225,341,22,363
公投第１４案,屏東縣,萬丹鄉,萬生村,268,1403,241,515,756,52,808
公投第１４案,屏東縣,萬丹鄉,寶厝村,269,1094,137,377,514,30,544
公投第１４案,屏東縣,萬丹鄉,寶厝村,270,1158,185,435,620,31,651
公投第１４案,屏東縣,萬丹鄉,四維村,271,963,174,378,552,52,604
公投第１４案,屏東縣,萬丹鄉,四維村,272,1062,179,367,546,38,584
公投第１４案,屏東縣,萬丹鄉,竹林村,273,1684,234,578,812,73,885
公投第１４案,屏東縣,萬丹鄉,水泉村,274,1702,244,556,800,29,829
公投第１４案,屏東縣,萬丹鄉,田厝村,275,976,152,354,506,33,539
公投第１４案,屏東縣,萬丹鄉,崙頂村,276,1013,151,346,497,61,558
公投第１４案,屏東縣,萬丹鄉,崙頂村,277,847,94,250,344,42,386
公投第１４案,屏東縣,萬丹鄉,厦北村,278,1570,244,553,797,115,912
公投第１４案,屏東縣,萬丹鄉,厦南村,279,1411,170,466,636,60,696
公投第１４案,屏東縣,萬丹鄉,後村村,280,1046,189,340,529,71,600
公投第１４案,屏東縣,萬丹鄉,灣內村,281,1385,212,454,666,30,696
公投第１４案,屏東縣,萬丹鄉,上村村,282,804,107,306,413,33,446
公投第１４案,屏東縣,萬丹鄉,加興村,283,1284,202,423,625,78,703
公投第１４案,屏東縣,萬丹鄉,社口村,284,1430,205,450,655,48,703
公投第１４案,屏東縣,萬丹鄉,磚寮村,285,960,169,373,542,58,600
公投第１４案,屏東縣,萬丹鄉,社皮村,286,786,128,309,437,42,479
公投第１４案,屏東縣,萬丹鄉,社皮村,287,1158,206,371,577,71,648
公投第１４案,屏東縣,萬丹鄉,社中村,288,1647,196,447,643,68,711
公投第１４案,屏東縣,萬丹鄉,社上村,289,1666,228,483,711,65,776
公投第１４案,屏東縣,萬丹鄉,廣安村,290,1023,170,396,566,60,626
公投第１４案,屏東縣,萬丹鄉,廣安村,291,1227,201,468,669,48,717
公投第１４案,屏東縣,長治鄉,進興村,292,1018,134,387,521,47,568
公投第１４案,屏東縣,長治鄉,進興村,293,1614,562,253,815,67,882
公投第１４案,屏東縣,長治鄉,新潭村,294,1848,316,694,1010,60,1070
公投第１４案,屏東縣,長治鄉,新潭村,295,1707,259,609,868,56,924
公投第１４案,屏東縣,長治鄉,潭頭村,296,972,166,359,525,23,548
公投第１４案,屏東縣,長治鄉,潭頭村,297,989,159,365,524,46,570
公投第１４案,屏東縣,長治鄉,香楊村,298,735,114,283,397,48,445
公投第１４案,屏東縣,長治鄉,香楊村,299,1813,286,549,835,60,895
公投第１４案,屏東縣,長治鄉,長興村,300,1073,183,415,598,53,651
公投第１４案,屏東縣,長治鄉,崙上村,301,1654,244,562,806,66,872
公投第１４案,屏東縣,長治鄉,德榮村,302,1205,217,389,606,56,662
公投第１４案,屏東縣,長治鄉,德和村,303,758,122,284,406,27,433
公投第１４案,屏東縣,長治鄉,復興村,304,1492,242,489,731,83,814
公投第１４案,屏東縣,長治鄉,德成村,305,884,139,321,460,50,510
公投第１４案,屏東縣,長治鄉,德協村,306,1090,176,393,569,55,624
公投第１４案,屏東縣,長治鄉,繁榮村,307,1422,192,429,621,68,689
公投第１４案,屏東縣,長治鄉,繁昌村,308,845,123,292,415,51,466
公投第１４案,屏東縣,長治鄉,繁昌村,309,925,135,313,448,87,535
公投第１４案,屏東縣,長治鄉,繁隆村,310,1138,145,408,553,69,622
公投第１４案,屏東縣,長治鄉,繁華村,311,1242,179,443,622,77,699
公投第１４案,屏東縣,長治鄉,繁華村,312,1159,195,366,561,21,582
公投第１４案,屏東縣,長治鄉,榮華村,313,673,103,267,370,32,402
公投第１４案,屏東縣,麟洛鄉,新田村,314,788,131,283,414,34,448
公投第１４案,屏東縣,麟洛鄉,新田村,315,1386,200,598,798,31,829
公投第１４案,屏東縣,麟洛鄉,麟頂村,316,957,167,387,554,34,588
公投第１４案,屏東縣,麟洛鄉,麟蹄村,317,731,117,288,405,43,448
公投第１４案,屏東縣,麟洛鄉,麟蹄村,318,806,159,297,456,48,504
公投第１４案,屏東縣,麟洛鄉,麟趾村,319,1207,209,375,584,22,606
公投第１４案,屏東縣,麟洛鄉,麟趾村,320,1340,253,490,743,70,813
公投第１４案,屏東縣,麟洛鄉,田中村,321,1221,200,420,620,58,678
公投第１４案,屏東縣,麟洛鄉,田心村,322,851,153,284,437,20,457
公投第１４案,屏東縣,麟洛鄉,田道村,323,683,106,238,344,11,355
公投第１４案,屏東縣,九如鄉,九清村,324,1491,249,512,761,76,837
公投第１４案,屏東縣,九如鄉,九塊村,325,1375,221,442,663,75,738
公投第１４案,屏東縣,九如鄉,九明村,326,1678,224,550,774,57,831
公投第１４案,屏東縣,九如鄉,大坵村,327,1166,194,420,614,71,685
公投第１４案,屏東縣,九如鄉,玉水村,328,1276,185,348,533,37,570
公投第１４案,屏東縣,九如鄉,玉泉村,329,1033,167,356,523,60,583
公投第１４案,屏東縣,九如鄉,玉泉村,330,577,108,245,353,44,397
公投第１４案,屏東縣,九如鄉,東寧村,331,649,107,234,341,57,398
公投第１４案,屏東縣,九如鄉,東寧村,332,1999,303,650,953,140,1093
公投第１４案,屏東縣,九如鄉,東寧村,333,1766,261,564,825,92,917
公投第１４案,屏東縣,九如鄉,三塊村,334,1600,254,490,744,89,833
公投第１４案,屏東縣,九如鄉,耆老村,335,1248,174,430,604,76,680
公投第１４案,屏東縣,九如鄉,後庄村,336,1792,251,632,883,159,1042
公投第１４案,屏東縣,九如鄉,洽興村,337,1482,172,565,737,80,817
公投第１４案,屏東縣,里港鄉,玉田村,338,1552,261,579,840,76,916
公投第１４案,屏東縣,里港鄉,玉田村,339,1480,245,474,719,67,786
公投第１４案,屏東縣,里港鄉,塔樓村,340,1534,209,434,643,40,683
公投第１４案,屏東縣,里港鄉,潮厝村,341,1578,256,510,766,89,855
公投第１４案,屏東縣,里港鄉,大平村,342,1127,201,424,625,47,672
公投第１４案,屏東縣,里港鄉,永春村,343,845,145,304,449,49,498
公投第１４案,屏東縣,里港鄉,春林村,344,1282,299,319,618,59,677
公投第１４案,屏東縣,里港鄉,過江村,345,981,150,367,517,49,566
公投第１４案,屏東縣,里港鄉,過江村,346,1031,172,371,543,54,597
公投第１４案,屏東縣,里港鄉,鐵店村,347,1423,255,455,710,93,803
公投第１４案,屏東縣,里港鄉,茄苳村,348,363,49,95,144,23,167
公投第１４案,屏東縣,里港鄉,茄苳村,349,1203,212,385,597,104,701
公投第１４案,屏東縣,里港鄉,載興村,350,1027,162,409,571,66,637
公投第１４案,屏東縣,里港鄉,載興村,351,1384,217,418,635,63,698
公投第１４案,屏東縣,里港鄉,土庫村,352,1512,231,463,694,88,782
公投第１４案,屏東縣,里港鄉,土庫村,353,522,63,228,291,17,308
公投第１４案,屏東縣,里港鄉,三廍村,354,822,124,266,390,67,457
公投第１４案,屏東縣,里港鄉,三廍村,355,1007,150,307,457,71,528
公投第１４案,屏東縣,里港鄉,中和村,356,956,155,300,455,82,537
公投第１４案,屏東縣,里港鄉,瀰力村,357,499,91,170,261,21,282
公投第１４案,屏東縣,鹽埔鄉,鹽北村,358,951,126,336,462,35,497
公投第１４案,屏東縣,鹽埔鄉,鹽北村,359,899,131,294,425,21,446
公投第１４案,屏東縣,鹽埔鄉,鹽中村,360,1116,139,335,474,27,501
公投第１４案,屏東縣,鹽埔鄉,鹽中村,361,1241,166,425,591,38,629
公投第１４案,屏東縣,鹽埔鄉,鹽南村,362,770,116,244,360,43,403
公投第１４案,屏東縣,鹽埔鄉,鹽南村,363,962,155,323,478,34,512
公投第１４案,屏東縣,鹽埔鄉,仕絨村,364,1041,166,403,569,64,633
公投第１４案,屏東縣,鹽埔鄉,高朗村,365,1367,268,431,699,9,708
公投第１４案,屏東縣,鹽埔鄉,高朗村,366,1465,173,442,615,65,680
公投第１４案,屏東縣,鹽埔鄉,振興村,367,894,119,266,385,37,422
公投第１４案,屏東縣,鹽埔鄉,振興村,368,958,115,303,418,4,422
公投第１４案,屏東縣,鹽埔鄉,久愛村,369,924,123,296,419,72,491
公投第１４案,屏東縣,鹽埔鄉,新圍村,370,1598,189,511,700,39,739
公投第１４案,屏東縣,鹽埔鄉,新圍村,371,1550,259,487,746,84,830
公投第１４案,屏東縣,鹽埔鄉,新二村,372,1127,158,389,547,57,604
公投第１４案,屏東縣,鹽埔鄉,新二村,373,1150,178,437,615,55,670
公投第１４案,屏東縣,鹽埔鄉,新二村,374,1233,210,428,638,37,675
公投第１４案,屏東縣,鹽埔鄉,彭厝村,375,984,148,371,519,73,592
公投第１４案,屏東縣,鹽埔鄉,洛陽村,376,1619,254,576,830,52,882
公投第１４案,屏東縣,鹽埔鄉,永隆村,377,553,70,203,273,34,307
公投第１４案,屏東縣,高樹鄉,高樹村,378,883,167,310,477,72,549
公投第１４案,屏東縣,高樹鄉,高樹村,379,1255,152,298,450,25,475
公投第１４案,屏東縣,高樹鄉,長榮村,380,1278,198,411,609,39,648
公投第１４案,屏東縣,高樹鄉,東興村,381,738,72,239,311,25,336
公投第１４案,屏東縣,高樹鄉,東振村,382,585,89,168,257,14,271
公投第１４案,屏東縣,高樹鄉,源泉村,383,1012,175,302,477,110,587
公投第１４案,屏東縣,高樹鄉,建興村,384,1148,176,337,513,69,582
公投第１４案,屏東縣,高樹鄉,大埔村,385,591,81,183,264,36,300
公投第１４案,屏東縣,高樹鄉,菜寮村,386,786,108,201,309,51,360
公投第１４案,屏東縣,高樹鄉,司馬村,387,649,58,203,261,20,281
公投第１４案,屏東縣,高樹鄉,舊寮村,388,1229,136,311,447,67,514
公投第１４案,屏東縣,高樹鄉,新豐村,389,1446,167,410,577,57,634
公投第１４案,屏東縣,高樹鄉,泰山村,390,899,145,195,340,17,357
公投第１４案,屏東縣,高樹鄉,泰山村,391,922,122,299,421,57,478
公投第１４案,屏東縣,高樹鄉,南華村,392,1259,178,359,537,67,604
公投第１４案,屏東縣,高樹鄉,廣福村,393,1056,119,274,393,22,415
公投第１４案,屏東縣,高樹鄉,廣興村,394,1116,173,358,531,71,602
公投第１４案,屏東縣,高樹鄉,舊庄村,395,1020,174,331,505,65,570
公投第１４案,屏東縣,高樹鄉,田子村,396,1055,155,345,500,73,573
公投第１４案,屏東縣,高樹鄉,鹽樹村,397,738,126,275,401,39,440
公投第１４案,屏東縣,高樹鄉,鹽樹村,398,493,57,155,212,27,239
公投第１４案,屏東縣,高樹鄉,新南村,399,1539,236,540,776,94,870
公投第１４案,屏東縣,萬巒鄉,萬巒村,400,1239,285,282,567,42,609
公投第１４案,屏東縣,萬巒鄉,萬全村,401,759,135,262,397,45,442
公投第１４案,屏東縣,萬巒鄉,萬和村,402,932,142,335,477,79,556
公投第１４案,屏東縣,萬巒鄉,萬和村,403,769,131,274,405,59,464
公投第１４案,屏東縣,萬巒鄉,鹿寮村,404,920,137,304,441,65,506
公投第１４案,屏東縣,萬巒鄉,硫黃村,405,560,106,183,289,35,324
公投第１４案,屏東縣,萬巒鄉,泗溝村,406,1120,140,348,488,33,521
公投第１４案,屏東縣,萬巒鄉,五溝村,407,1048,134,347,481,30,511
公投第１４案,屏東縣,萬巒鄉,成德村,408,1438,163,443,606,41,647
公投第１４案,屏東縣,萬巒鄉,赤山村,409,834,112,239,351,64,415
公投第１４案,屏東縣,萬巒鄉,赤山村,410,813,91,268,359,66,425
公投第１４案,屏東縣,萬巒鄉,萬金村,411,1020,103,337,440,35,475
公投第１４案,屏東縣,萬巒鄉,萬金村,412,1007,188,339,527,63,590
公投第１４案,屏東縣,萬巒鄉,佳佐村,413,1648,221,424,645,84,729
公投第１４案,屏東縣,萬巒鄉,佳和村,414,1437,204,459,663,62,725
公投第１４案,屏東縣,萬巒鄉,新厝村,415,1228,148,374,522,26,548
公投第１４案,屏東縣,萬巒鄉,新置村,416,597,70,251,321,40,361
公投第１４案,屏東縣,萬巒鄉,新置村,417,576,81,206,287,31,318
公投第１４案,屏東縣,內埔鄉,內埔村,418,1305,154,427,581,25,606
公投第１４案,屏東縣,內埔鄉,內埔村,419,1287,152,428,580,31,611
公投第１４案,屏東縣,內埔鄉,內埔村,420,1387,275,353,628,14,642
公投第１４案,屏東縣,內埔鄉,內田村,421,1540,233,469,702,28,730
公投第１４案,屏東縣,內埔鄉,內田村,422,1605,231,495,726,48,774
公投第１４案,屏東縣,內埔鄉,興南村,423,1326,185,428,613,51,664
公投第１４案,屏東縣,內埔鄉,義亭村,424,591,96,193,289,44,333
公投第１４案,屏東縣,內埔鄉,美和村,425,1123,154,346,500,39,539
公投第１４案,屏東縣,內埔鄉,美和村,426,1079,134,369,503,20,523
公投第１４案,屏東縣,內埔鄉,和興村,427,1485,205,498,703,64,767
公投第１４案,屏東縣,內埔鄉,和興村,428,1248,178,492,670,37,707
公投第１４案,屏東縣,內埔鄉,東寧村,429,1569,239,509,748,48,796
公投第１４案,屏東縣,內埔鄉,東寧村,430,1493,211,448,659,53,712
公投第１４案,屏東縣,內埔鄉,東寧村,431,1420,194,452,646,10,656
公投第１４案,屏東縣,內埔鄉,豐田村,432,1334,176,453,629,64,693
公投第１４案,屏東縣,內埔鄉,豐田村,433,1519,207,480,687,53,740
公投第１４案,屏東縣,內埔鄉,振豐村,434,784,112,271,383,38,421
公投第１４案,屏東縣,內埔鄉,振豐村,435,888,136,317,453,47,500
公投第１４案,屏東縣,內埔鄉,富田村,436,747,92,183,275,21,296
公投第１４案,屏東縣,內埔鄉,富田村,437,1168,144,327,471,27,498
公投第１４案,屏東縣,內埔鄉,竹圍村,438,546,87,183,270,42,312
公投第１４案,屏東縣,內埔鄉,竹圍村,439,1278,191,401,592,46,638
公投第１４案,屏東縣,內埔鄉,東勢村,440,1348,174,384,558,43,601
公投第１４案,屏東縣,內埔鄉,東勢村,441,1550,178,400,578,79,657
公投第１４案,屏東縣,內埔鄉,東片村,442,947,141,377,518,61,579
公投第１４案,屏東縣,內埔鄉,上樹村,443,1097,155,338,493,72,565
公投第１４案,屏東縣,內埔鄉,老埤村,444,1128,166,261,427,51,478
公投第１４案,屏東縣,內埔鄉,老埤村,445,1253,128,290,418,24,442
公投第１４案,屏東縣,內埔鄉,中林村,446,1525,170,413,583,29,612
公投第１４案,屏東縣,內埔鄉,龍泉村,447,1215,164,400,564,74,638
公投第１４案,屏東縣,內埔鄉,龍泉村,448,1216,129,364,493,27,520
公投第１４案,屏東縣,內埔鄉,龍潭村,449,1353,160,418,578,39,617
公投第１４案,屏東縣,內埔鄉,龍潭村,450,1026,133,341,474,38,512
公投第１４案,屏東縣,內埔鄉,建興村,451,862,118,260,378,29,407
公投第１４案,屏東縣,內埔鄉,大新村,452,921,106,226,332,40,372
公投第１４案,屏東縣,內埔鄉,大新村,453,854,127,274,401,21,422
公投第１４案,屏東縣,內埔鄉,黎明村,454,1230,144,364,508,37,545
公投第１４案,屏東縣,內埔鄉,黎明村,455,1204,132,384,516,21,537
公投第１４案,屏東縣,內埔鄉,隘寮村,456,1301,65,406,471,33,504
公投第１４案,屏東縣,內埔鄉,水門村,457,806,249,165,414,39,453
公投第１４案,屏東縣,竹田鄉,竹田村,458,1503,208,558,766,78,844
公投第１４案,屏東縣,竹田鄉,竹南村,459,899,169,346,515,35,550
公投第１４案,屏東縣,竹田鄉,糶糴村,460,716,117,295,412,40,452
公投第１４案,屏東縣,竹田鄉,履豐村,461,581,115,220,335,48,383
公投第１４案,屏東縣,竹田鄉,頭崙村,462,1327,193,456,649,92,741
公投第１４案,屏東縣,竹田鄉,二崙村,463,997,158,373,531,87,618
公投第１４案,屏東縣,竹田鄉,美崙村,464,649,109,217,326,32,358
公投第１４案,屏東縣,竹田鄉,南勢村,465,476,92,240,332,15,347
公投第１４案,屏東縣,竹田鄉,西勢村,466,1259,206,467,673,64,737
公投第１４案,屏東縣,竹田鄉,西勢村,467,1227,161,417,578,63,641
公投第１４案,屏東縣,竹田鄉,福田村,468,504,91,190,281,41,322
公投第１４案,屏東縣,竹田鄉,永豐村,469,860,112,302,414,49,463
公投第１４案,屏東縣,竹田鄉,六巷村,470,800,268,130,398,28,426
公投第１４案,屏東縣,竹田鄉,泗洲村,471,1134,172,403,575,84,659
公投第１４案,屏東縣,竹田鄉,大湖村,472,1229,73,437,510,59,569
公投第１４案,屏東縣,竹田鄉,鳳明村,473,1192,193,387,580,50,630
公投第１４案,屏東縣,新埤鄉,新埤村,474,1712,229,539,768,46,814
公投第１４案,屏東縣,新埤鄉,新埤村,475,314,34,111,145,30,175
公投第１４案,屏東縣,新埤鄉,建功村,476,752,104,267,371,37,408
公投第１４案,屏東縣,新埤鄉,建功村,477,334,42,124,166,19,185
公投第１４案,屏東縣,新埤鄉,打鐵村,478,957,134,352,486,54,540
公投第１４案,屏東縣,新埤鄉,南豐村,479,764,128,284,412,39,451
公投第１４案,屏東縣,新埤鄉,萬隆村,480,373,53,141,194,20,214
公投第１４案,屏東縣,新埤鄉,萬隆村,481,678,83,203,286,30,316
公投第１４案,屏東縣,新埤鄉,萬隆村,482,701,92,204,296,31,327
公投第１４案,屏東縣,新埤鄉,餉潭村,483,1323,153,340,493,52,545
公投第１４案,屏東縣,新埤鄉,箕湖村,484,541,82,203,285,27,312
公投第１４案,屏東縣,新埤鄉,箕湖村,485,584,67,185,252,22,274
公投第１４案,屏東縣,枋寮鄉,枋寮村,486,1213,180,438,618,66,684
公投第１４案,屏東縣,枋寮鄉,新龍村,487,891,127,339,466,54,520
公投第１４案,屏東縣,枋寮鄉,保生村,488,970,119,309,428,69,497
公投第１４案,屏東縣,枋寮鄉,中寮村,489,629,75,226,301,32,333
公投第１４案,屏東縣,枋寮鄉,安樂村,490,840,84,307,391,47,438
公投第１４案,屏東縣,枋寮鄉,安樂村,491,774,103,304,407,38,445
公投第１４案,屏東縣,枋寮鄉,隆山村,492,1379,184,474,658,56,714
公投第１４案,屏東縣,枋寮鄉,隆山村,493,1502,214,554,768,51,819
公投第１４案,屏東縣,枋寮鄉,隆山村,494,1276,159,434,593,72,665
公投第１４案,屏東縣,枋寮鄉,天時村,495,964,134,325,459,56,515
公投第１４案,屏東縣,枋寮鄉,天時村,496,1005,127,403,530,81,611
公投第１４案,屏東縣,枋寮鄉,地利村,497,734,102,250,352,22,374
公投第１４案,屏東縣,枋寮鄉,地利村,498,725,116,248,364,45,409
公投第１４案,屏東縣,枋寮鄉,人和村,499,1046,148,329,477,58,535
公投第１４案,屏東縣,枋寮鄉,人和村,500,1067,141,396,537,75,612
公投第１４案,屏東縣,枋寮鄉,內寮村,501,718,71,156,227,57,284
公投第１４案,屏東縣,枋寮鄉,新開村,502,903,105,264,369,54,423
公投第１４案,屏東縣,枋寮鄉,東海村,503,1387,201,415,616,81,697
公投第１４案,屏東縣,枋寮鄉,東海村,504,1367,212,462,674,80,754
公投第１４案,屏東縣,枋寮鄉,大庄村,505,618,132,203,335,52,387
公投第１４案,屏東縣,枋寮鄉,太源村,506,959,114,236,350,41,391
公投第１４案,屏東縣,枋寮鄉,玉泉村,507,427,68,138,206,31,237
公投第１４案,屏東縣,新園鄉,瓦磘村,508,820,137,293,430,42,472
公投第１４案,屏東縣,新園鄉,瓦磘村,509,843,179,283,462,44,506
公投第１４案,屏東縣,新園鄉,仙吉村,510,1242,185,406,591,52,643
公投第１４案,屏東縣,新園鄉,仙吉村,511,1290,223,464,687,55,742
公投第１４案,屏東縣,新園鄉,田洋村,512,1073,164,362,526,42,568
公投第１４案,屏東縣,新園鄉,田洋村,513,1088,165,392,557,89,646
公投第１４案,屏東縣,新園鄉,港墘村,514,845,111,274,385,35,420
公投第１４案,屏東縣,新園鄉,內庄村,515,862,145,268,413,54,467
公投第１４案,屏東縣,新園鄉,新東村,516,1183,152,368,520,68,588
公投第１４案,屏東縣,新園鄉,新東村,517,1109,139,398,537,76,613
公投第１４案,屏東縣,新園鄉,新園村,518,1119,164,336,500,12,512
公投第１４案,屏東縣,新園鄉,新園村,519,1152,181,353,534,40,574
公投第１４案,屏東縣,新園鄉,港西村,520,1030,150,379,529,42,571
公投第１４案,屏東縣,新園鄉,港西村,521,1104,161,352,513,76,589
公投第１４案,屏東縣,新園鄉,烏龍村,522,1240,158,376,534,38,572
公投第１４案,屏東縣,新園鄉,興龍村,523,1120,154,278,432,25,457
公投第１４案,屏東縣,新園鄉,興龍村,524,1074,165,393,558,66,624
公投第１４案,屏東縣,新園鄉,中洲村,525,849,102,258,360,37,397
公投第１４案,屏東縣,新園鄉,中洲村,526,749,110,244,354,56,410
公投第１４案,屏東縣,新園鄉,南龍村,527,1416,210,425,635,87,722
公投第１４案,屏東縣,新園鄉,五房村,528,895,128,318,446,35,481
公投第１４案,屏東縣,新園鄉,五房村,529,933,123,329,452,69,521
公投第１４案,屏東縣,新園鄉,五房村,530,972,141,346,487,33,520
公投第１４案,屏東縣,新園鄉,鹽埔村,531,1454,175,430,605,58,663
公投第１４案,屏東縣,新園鄉,鹽埔村,532,1653,216,671,887,78,965
公投第１４案,屏東縣,新園鄉,鹽埔村,533,1270,156,418,574,66,640
公投第１４案,屏東縣,新園鄉,共和村,534,1123,156,440,596,100,696
公投第１４案,屏東縣,新園鄉,共和村,535,1198,151,413,564,60,624
公投第１４案,屏東縣,崁頂鄉,崁頂村,536,1190,164,380,544,53,597
公投第１４案,屏東縣,崁頂鄉,崁頂村,537,1044,195,347,542,57,599
公投第１４案,屏東縣,崁頂鄉,園寮村,538,818,142,261,403,49,452
公投第１４案,屏東縣,崁頂鄉,園寮村,539,1214,207,372,579,51,630
公投第１４案,屏東縣,崁頂鄉,力社村,540,1325,165,437,602,30,632
公投第１４案,屏東縣,崁頂鄉,圍內村,541,1253,212,445,657,53,710
公投第１４案,屏東縣,崁頂鄉,洲子村,542,1039,170,315,485,44,529
公投第１４案,屏東縣,崁頂鄉,北勢村,543,813,113,224,337,55,392
公投第１４案,屏東縣,崁頂鄉,北勢村,544,736,105,237,342,23,365
公投第１４案,屏東縣,崁頂鄉,越溪村,545,934,154,327,481,44,525
公投第１４案,屏東縣,崁頂鄉,港東村,546,900,130,274,404,69,473
公投第１４案,屏東縣,崁頂鄉,港東村,547,1004,147,343,490,42,532
公投第１４案,屏東縣,林邊鄉,林邊村,548,1458,224,547,771,94,865
公投第１４案,屏東縣,林邊鄉,光林村,549,891,153,323,476,53,529
公投第１４案,屏東縣,林邊鄉,光林村,550,695,120,269,389,35,424
公投第１４案,屏東縣,林邊鄉,永樂村,551,1015,168,373,541,63,604
公投第１４案,屏東縣,林邊鄉,永樂村,552,1171,200,429,629,50,679
公投第１４案,屏東縣,林邊鄉,永樂村,553,1003,157,337,494,45,539
公投第１４案,屏東縣,林邊鄉,中林村,554,725,158,262,420,41,461
公投第１４案,屏東縣,林邊鄉,仁和村,555,841,138,301,439,62,501
公投第１４案,屏東縣,林邊鄉,仁和村,556,793,134,296,430,43,473
公投第１４案,屏東縣,林邊鄉,田厝村,557,919,160,336,496,51,547
公投第１４案,屏東縣,林邊鄉,崎峯村,558,1283,204,408,612,57,669
公投第１４案,屏東縣,林邊鄉,水利村,559,783,122,219,341,41,382
公投第１４案,屏東縣,林邊鄉,水利村,560,1033,124,305,429,47,476
公投第１４案,屏東縣,林邊鄉,竹林村,561,1186,155,401,556,83,639
公投第１４案,屏東縣,林邊鄉,竹林村,562,773,99,265,364,56,420
公投第１４案,屏東縣,林邊鄉,鎮安村,563,1122,35,460,495,39,534
公投第１４案,屏東縣,南州鄉,溪洲村,564,872,117,285,402,53,455
公投第１４案,屏東縣,南州鄉,溪洲村,565,794,121,283,404,34,438
公投第１４案,屏東縣,南州鄉,溪南村,566,962,160,352,512,46,558
公投第１４案,屏東縣,南州鄉,七塊村,567,1033,176,338,514,65,579
公投第１４案,屏東縣,南州鄉,萬華村,568,1007,176,292,468,50,518
公投第１４案,屏東縣,南州鄉,仁里村,569,466,59,192,251,26,277
公投第１４案,屏東縣,南州鄉,溪北村,570,708,119,271,390,26,416
公投第１４案,屏東縣,南州鄉,米崙村,571,1044,168,358,526,65,591
公投第１４案,屏東縣,南州鄉,壽元村,572,1071,156,256,412,39,451
公投第１４案,屏東縣,南州鄉,同安村,573,979,266,166,432,31,463
公投第１４案,屏東縣,南州鄉,南安村,574,543,74,175,249,27,276
公投第１４案,屏東縣,佳冬鄉,佳冬村,575,1472,210,405,615,72,687
公投第１４案,屏東縣,佳冬鄉,六根村,576,1360,163,372,535,68,603
公投第１４案,屏東縣,佳冬鄉,賴家村,577,804,123,271,394,69,463
公投第１４案,屏東縣,佳冬鄉,萬建村,578,925,153,261,414,72,486
公投第１４案,屏東縣,佳冬鄉,萬建村,579,855,108,279,387,16,403
公投第１４案,屏東縣,佳冬鄉,石光村,580,981,164,268,432,55,487
公投第１４案,屏東縣,佳冬鄉,石光村,581,1007,156,285,441,54,495
公投第１４案,屏東縣,佳冬鄉,玉光村,582,872,137,231,368,49,417
公投第１４案,屏東縣,佳冬鄉,玉光村,583,1255,179,320,499,73,572
公投第１４案,屏東縣,佳冬鄉,昌隆村,584,995,126,320,446,109,555
公投第１４案,屏東縣,佳冬鄉,豐隆村,585,734,87,175,262,30,292
公投第１４案,屏東縣,佳冬鄉,大同村,586,1178,147,321,468,38,506
公投第１４案,屏東縣,佳冬鄉,羌園村,587,1095,188,277,465,59,524
公投第１４案,屏東縣,佳冬鄉,燄溫村,588,1097,156,401,557,88,645
公投第１４案,屏東縣,佳冬鄉,塭豐村,589,1273,156,432,588,75,663
公投第１４案,屏東縣,佳冬鄉,塭豐村,590,1160,169,431,600,54,654
公投第１４案,屏東縣,琉球鄉,本福村,591,1111,128,314,442,24,466
公投第１４案,屏東縣,琉球鄉,本福村,592,972,109,287,396,39,435
公投第１４案,屏東縣,琉球鄉,中福村,593,1278,143,489,632,33,665
公投第１４案,屏東縣,琉球鄉,漁福村,594,976,101,344,445,50,495
公投第１４案,屏東縣,琉球鄉,大福村,595,1658,146,572,718,70,788
公投第１４案,屏東縣,琉球鄉,南福村,596,1146,106,298,404,33,437
公投第１４案,屏東縣,琉球鄉,天福村,597,1079,80,312,392,28,420
公投第１４案,屏東縣,琉球鄉,上福村,598,1613,139,438,577,21,598
公投第１４案,屏東縣,琉球鄉,杉福村,599,873,110,287,397,47,444
公投第１４案,屏東縣,車城鄉,海口村,600,737,97,178,275,33,308
公投第１４案,屏東縣,車城鄉,田中村,601,647,79,133,212,29,241
公投第１４案,屏東縣,車城鄉,福興村,602,491,78,130,208,19,227
公投第１４案,屏東縣,車城鄉,福興村,603,856,126,248,374,32,406
公投第１４案,屏東縣,車城鄉,福安村,604,554,78,149,227,9,236
公投第１４案,屏東縣,車城鄉,統埔村,605,388,42,100,142,1,143
公投第１４案,屏東縣,車城鄉,溫泉村,606,922,125,206,331,55,386
公投第１４案,屏東縣,車城鄉,保力村,607,597,65,126,191,6,197
公投第１４案,屏東縣,車城鄉,保力村,608,623,61,132,193,12,205
公投第１４案,屏東縣,車城鄉,新街村,609,425,56,119,175,20,195
公投第１４案,屏東縣,車城鄉,埔墘村,610,428,51,153,204,17,221
公投第１４案,屏東縣,車城鄉,射寮村,611,504,50,114,164,9,173
公投第１４案,屏東縣,車城鄉,後灣村,612,423,60,125,185,24,209
公投第１４案,屏東縣,滿州鄉,滿州村,613,1575,236,437,673,49,722
公投第１４案,屏東縣,滿州鄉,里德村,614,420,61,129,190,10,200
公投第１４案,屏東縣,滿州鄉,响林村,615,602,85,235,320,30,350
公投第１４案,屏東縣,滿州鄉,永靖村,616,1302,128,363,491,18,509
公投第１４案,屏東縣,滿州鄉,港口村,617,1314,170,382,552,52,604
公投第１４案,屏東縣,滿州鄉,長樂村,618,1308,132,243,375,17,392
公投第１４案,屏東縣,滿州鄉,九棚村,619,367,44,76,120,16,136
公投第１４案,屏東縣,滿州鄉,港仔村,620,318,31,117,148,18,166
公投第１４案,屏東縣,枋山鄉,枋山村,621,604,59,240,299,37,336
公投第１４案,屏東縣,枋山鄉,枋山村,622,428,66,172,238,22,260
公投第１４案,屏東縣,枋山鄉,加祿村,623,928,166,360,526,51,577
公投第１４案,屏東縣,枋山鄉,加祿村,624,972,140,328,468,23,491
公投第１４案,屏東縣,枋山鄉,楓港村,625,1041,142,274,416,55,471
公投第１４案,屏東縣,枋山鄉,善餘村,626,883,109,194,303,24,327
公投第１４案,屏東縣,三地門鄉,大社村,627,616,50,242,292,16,308
公投第１４案,屏東縣,三地門鄉,德文村,628,572,79,211,290,65,355
公投第１４案,屏東縣,三地門鄉,達來村,629,323,30,117,147,14,161
公投第１４案,屏東縣,三地門鄉,三地村,630,1448,271,575,846,44,890
公投第１４案,屏東縣,三地門鄉,賽嘉村,631,726,74,178,252,8,260
公投第１４案,屏東縣,三地門鄉,口社村,632,554,81,188,269,24,293
公投第１４案,屏東縣,三地門鄉,馬兒村,633,346,68,134,202,14,216
公投第１４案,屏東縣,三地門鄉,安坡村,634,458,50,184,234,5,239
公投第１４案,屏東縣,三地門鄉,青山村,635,692,119,303,422,15,437
公投第１４案,屏東縣,三地門鄉,青葉村,636,638,116,331,447,25,472
公投第１４案,屏東縣,霧臺鄉,霧台村,637,346,65,176,241,26,267
公投第１４案,屏東縣,霧臺鄉,霧台村,638,677,85,293,378,11,389
公投第１４案,屏東縣,霧臺鄉,霧台村,639,162,13,46,59,0,59
公投第１４案,屏東縣,霧臺鄉,吉露村,640,189,20,71,91,6,97
公投第１４案,屏東縣,霧臺鄉,阿禮村,641,296,37,149,186,27,213
公投第１４案,屏東縣,霧臺鄉,好茶村,642,483,70,244,314,14,328
公投第１４案,屏東縣,霧臺鄉,佳暮村,643,347,52,142,194,8,202
公投第１４案,屏東縣,霧臺鄉,大武村,644,450,72,170,242,19,261
公投第１４案,屏東縣,瑪家鄉,瑪家村,645,455,78,167,245,2,247
公投第１４案,屏東縣,瑪家鄉,北葉村,646,821,136,362,498,47,545
公投第１４案,屏東縣,瑪家鄉,三和村,647,635,109,307,416,53,469
公投第１４案,屏東縣,瑪家鄉,三和村,648,695,95,401,496,27,523
公投第１４案,屏東縣,瑪家鄉,三和村,649,671,100,328,428,24,452
公投第１４案,屏東縣,瑪家鄉,凉山村,650,1057,154,399,553,17,570
公投第１４案,屏東縣,瑪家鄉,佳義村,651,900,132,362,494,27,521
公投第１４案,屏東縣,瑪家鄉,排灣村,652,429,58,181,239,2,241
公投第１４案,屏東縣,泰武鄉,佳平村,653,669,123,256,379,23,402
公投第１４案,屏東縣,泰武鄉,佳平村,654,190,25,67,92,9,101
公投第１４案,屏東縣,泰武鄉,武潭村,655,922,140,411,551,56,607
公投第１４案,屏東縣,泰武鄉,平和村,656,598,90,323,413,39,452
公投第１４案,屏東縣,泰武鄉,萬安村,657,771,106,358,464,39,503
公投第１４案,屏東縣,泰武鄉,佳興村,658,414,42,229,271,32,303
公投第１４案,屏東縣,泰武鄉,泰武村,659,780,105,304,409,30,439
公投第１４案,屏東縣,來義鄉,來義村,660,917,106,439,545,70,615
公投第１４案,屏東縣,來義鄉,義林村,661,361,55,149,204,7,211
公投第１４案,屏東縣,來義鄉,義林村,662,216,22,96,118,4,122
公投第１４案,屏東縣,來義鄉,丹林村,663,445,47,264,311,25,336
公投第１４案,屏東縣,來義鄉,丹林村,664,280,25,146,171,11,182
公投第１４案,屏東縣,來義鄉,古樓村,665,1097,115,489,604,44,648
公投第１４案,屏東縣,來義鄉,文樂村,666,840,96,438,534,30,564
公投第１４案,屏東縣,來義鄉,望嘉村,667,889,133,306,439,23,462
公投第１４案,屏東縣,來義鄉,南和村,668,1212,189,365,554,40,594
公投第１４案,屏東縣,春日鄉,春日村,669,909,97,189,286,8,294
公投第１４案,屏東縣,春日鄉,古華村,670,663,90,146,236,13,249
公投第１４案,屏東縣,春日鄉,士文村,671,304,21,61,82,2,84
公投第１４案,屏東縣,春日鄉,七佳村,672,928,103,292,395,15,410
公投第１４案,屏東縣,春日鄉,歸崇村,673,641,63,123,186,9,195
公投第１４案,屏東縣,春日鄉,力里村,674,478,58,86,144,5,149
公投第１４案,屏東縣,獅子鄉,楓林村,675,751,73,307,380,10,390
公投第１４案,屏東縣,獅子鄉,丹路村,676,776,106,321,427,26,453
公投第１４案,屏東縣,獅子鄉,草埔村,677,711,63,262,325,8,333
公投第１４案,屏東縣,獅子鄉,內文村,678,243,47,112,159,29,188
公投第１４案,屏東縣,獅子鄉,竹坑村,679,325,45,143,188,7,195
公投第１４案,屏東縣,獅子鄉,獅子村,680,476,53,137,190,5,195
公投第１４案,屏東縣,獅子鄉,內獅村,681,602,84,276,360,8,368
公投第１４案,屏東縣,獅子鄉,南世村,682,346,44,116,160,7,167
公投第１４案,屏東縣,牡丹鄉,石門村,683,342,37,100,137,6,143
公投第１４案,屏東縣,牡丹鄉,石門村,684,1306,194,432,626,37,663
公投第１４案,屏東縣,牡丹鄉,牡丹村,685,693,60,112,172,4,176
公投第１４案,屏東縣,牡丹鄉,東源村,686,437,48,122,170,6,176
公投第１４案,屏東縣,牡丹鄉,旭海村,687,392,57,133,190,7,197
公投第１４案,屏東縣,牡丹鄉,高士村,688,593,99,201,300,10,310
公投第１４案,屏東縣,牡丹鄉,四林村,689,551,32,96,128,6,134
公投第１４案,臺東縣,臺東市,文化里,1,874,101,316,417,19,436
公投第１４案,臺東縣,臺東市,民族里,2,1469,242,609,851,56,907
公投第１４案,臺東縣,臺東市,自強里,3,1259,175,499,674,23,697
公投第１４案,臺東縣,臺東市,自強里,4,1399,228,532,760,30,790
公投第１４案,臺東縣,臺東市,自強里,5,1363,235,579,814,28,842
公投第１４案,臺東縣,臺東市,民生里,6,1651,200,674,874,29,903
公投第１４案,臺東縣,臺東市,民生里,7,1490,220,658,878,41,919
公投第１４案,臺東縣,臺東市,寶桑里,8,859,120,309,429,29,458
公投第１４案,臺東縣,臺東市,民權里,9,890,169,346,515,29,544
公投第１４案,臺東縣,臺東市,四維里,10,651,86,258,344,32,376
公投第１４案,臺東縣,臺東市,中華里,11,1650,204,591,795,64,859
公投第１４案,臺東縣,臺東市,仁愛里,12,724,122,308,430,23,453
公投第１４案,臺東縣,臺東市,強國里,13,632,108,244,352,31,383
公投第１４案,臺東縣,臺東市,大同里,14,771,121,306,427,36,463
公投第１４案,臺東縣,臺東市,成功里,15,798,127,271,398,14,412
公投第１４案,臺東縣,臺東市,建國里,16,1299,178,465,643,76,719
公投第１４案,臺東縣,臺東市,中正里,17,811,131,329,460,28,488
公投第１４案,臺東縣,臺東市,中山里,18,764,131,335,466,25,491
公投第１４案,臺東縣,臺東市,興國里,19,784,131,266,397,13,410
公投第１４案,臺東縣,臺東市,鐵花里,20,427,59,149,208,10,218
公投第１４案,臺東縣,臺東市,東海里,21,1292,114,528,642,31,673
公投第１４案,臺東縣,臺東市,東海里,22,1501,233,624,857,12,869
公投第１４案,臺東縣,臺東市,復國里,23,601,88,204,292,13,305
公投第１４案,臺東縣,臺東市,復興里,24,417,69,137,206,8,214
公投第１４案,臺東縣,臺東市,新興里,25,1001,136,390,526,41,567
公投第１４案,臺東縣,臺東市,新生里,26,1638,241,679,920,33,953
公投第１４案,臺東縣,臺東市,新生里,27,1576,202,633,835,38,873
公投第１４案,臺東縣,臺東市,新生里,28,1595,228,617,845,52,897
公投第１４案,臺東縣,臺東市,新生里,29,1734,246,691,937,34,971
公投第１４案,臺東縣,臺東市,中心里,30,1476,223,584,807,45,852
公投第１４案,臺東縣,臺東市,中心里,31,1545,269,625,894,30,924
公投第１４案,臺東縣,臺東市,馬蘭里,32,1313,189,569,758,40,798
公投第１４案,臺東縣,臺東市,馬蘭里,33,1338,188,594,782,35,817
公投第１４案,臺東縣,臺東市,光明里,34,1312,184,516,700,28,728
公投第１４案,臺東縣,臺東市,光明里,35,1265,194,514,708,33,741
公投第１４案,臺東縣,臺東市,豐年里,36,1407,185,444,629,51,680
公投第１４案,臺東縣,臺東市,豐年里,37,1552,175,542,717,41,758
公投第１４案,臺東縣,臺東市,豐樂里,38,1445,179,575,754,60,814
公投第１４案,臺東縣,臺東市,永樂里,39,2098,327,832,1159,56,1215
公投第１４案,臺東縣,臺東市,康樂里,40,1324,182,552,734,59,793
公投第１４案,臺東縣,臺東市,豐榮里,41,1598,202,639,841,29,870
公投第１４案,臺東縣,臺東市,豐榮里,42,1513,206,576,782,23,805
公投第１４案,臺東縣,臺東市,豐榮里,43,1679,246,574,820,63,883
公投第１４案,臺東縣,臺東市,豐榮里,44,1414,209,502,711,41,752
公投第１４案,臺東縣,臺東市,豐榮里,45,1798,243,657,900,50,950
公投第１４案,臺東縣,臺東市,豐谷里,46,1749,217,563,780,48,828
公投第１４案,臺東縣,臺東市,豐谷里,47,1709,226,649,875,63,938
公投第１４案,臺東縣,臺東市,豐谷里,48,1629,198,620,818,44,862
公投第１４案,臺東縣,臺東市,豐里里,49,1116,149,393,542,54,596
公投第１４案,臺東縣,臺東市,豐里里,50,1259,156,388,544,30,574
公投第１４案,臺東縣,臺東市,豐原里,51,1232,146,383,529,40,569
公投第１４案,臺東縣,臺東市,富岡里,52,1505,154,525,679,98,777
公投第１４案,臺東縣,臺東市,富豐里,53,836,89,263,352,52,404
公投第１４案,臺東縣,臺東市,南榮里,54,1294,165,532,697,39,736
公投第１４案,臺東縣,臺東市,南榮里,55,1350,174,498,672,51,723
公投第１４案,臺東縣,臺東市,岩灣里,56,2162,258,877,1135,60,1195
公投第１４案,臺東縣,臺東市,卑南里,57,1627,269,648,917,47,964
公投第１４案,臺東縣,臺東市,卑南里,58,1140,161,491,652,30,682
公投第１４案,臺東縣,臺東市,南王里,59,1359,186,514,700,32,732
公投第１４案,臺東縣,臺東市,南王里,60,1329,194,499,693,46,739
公投第１４案,臺東縣,臺東市,豐田里,61,990,115,372,487,28,515
公投第１４案,臺東縣,臺東市,豐田里,62,1038,127,416,543,46,589
公投第１４案,臺東縣,臺東市,新園里,63,1597,198,581,779,63,842
公投第１４案,臺東縣,臺東市,建和里,64,1385,216,470,686,59,745
公投第１４案,臺東縣,臺東市,建興里,65,939,133,291,424,13,437
公投第１４案,臺東縣,臺東市,建業里,66,1258,141,382,523,48,571
公投第１４案,臺東縣,臺東市,知本里,67,1350,194,461,655,6,661
公投第１４案,臺東縣,臺東市,建農里,68,1058,124,340,464,33,497
公投第１４案,臺東縣,臺東市,建農里,69,895,81,292,373,28,401
公投第１４案,臺東縣,成功鎮,信義里,70,516,45,167,212,46,258
公投第１４案,臺東縣,成功鎮,信義里,71,960,112,410,522,57,579
公投第１４案,臺東縣,成功鎮,信義里,72,365,18,104,122,16,138
公投第１４案,臺東縣,成功鎮,和平里,73,747,60,236,296,49,345
公投第１４案,臺東縣,成功鎮,忠仁里,74,339,19,121,140,20,160
公投第１４案,臺東縣,成功鎮,忠仁里,75,995,112,336,448,23,471
公投第１４案,臺東縣,成功鎮,忠仁里,76,863,106,329,435,47,482
公投第１４案,臺東縣,成功鎮,忠智里,77,931,116,364,480,28,508
公投第１４案,臺東縣,成功鎮,忠智里,78,970,105,365,470,24,494
公投第１４案,臺東縣,成功鎮,三民里,79,1365,121,505,626,68,694
公投第１４案,臺東縣,成功鎮,三民里,80,1366,124,517,641,74,715
公投第１４案,臺東縣,成功鎮,三仙里,81,516,39,175,214,46,260
公投第１４案,臺東縣,成功鎮,三仙里,82,887,82,255,337,60,397
公投第１４案,臺東縣,成功鎮,忠孝里,83,488,39,142,181,38,219
公投第１４案,臺東縣,成功鎮,忠孝里,84,481,47,120,167,28,195
公投第１４案,臺東縣,成功鎮,博愛里,85,373,15,72,87,1,88
公投第１４案,臺東縣,成功鎮,博愛里,86,264,29,91,120,24,144
公投第１４案,臺東縣,關山鎮,里壠里,87,909,143,370,513,27,540
公投第１４案,臺東縣,關山鎮,里壠里,88,790,91,229,320,21,341
公投第１４案,臺東縣,關山鎮,中福里,89,828,129,339,468,33,501
公投第１４案,臺東縣,關山鎮,新福里,90,887,90,282,372,23,395
公投第１４案,臺東縣,關山鎮,豐泉里,91,1137,152,442,594,30,624
公投第１４案,臺東縣,關山鎮,月眉里,92,732,78,246,324,30,354
公投第１４案,臺東縣,關山鎮,德高里,93,912,102,339,441,32,473
公投第１４案,臺東縣,關山鎮,德高里,94,779,77,219,296,17,313
公投第１４案,臺東縣,關山鎮,電光里,95,535,62,130,192,14,206
公投第１４案,臺東縣,卑南鄉,賓朗村,96,1041,145,404,549,50,599
公投第１４案,臺東縣,卑南鄉,賓朗村,97,1165,142,404,546,30,576
公投第１４案,臺東縣,卑南鄉,美農村,98,219,23,55,78,19,97
公投第１４案,臺東縣,卑南鄉,美農村,99,460,61,136,197,25,222
公投第１４案,臺東縣,卑南鄉,美農村,100,387,36,107,143,12,155
公投第１４案,臺東縣,卑南鄉,初鹿村,101,767,82,239,321,28,349
公投第１４案,臺東縣,卑南鄉,初鹿村,102,503,68,170,238,34,272
公投第１４案,臺東縣,卑南鄉,明峰村,103,727,94,211,305,47,352
公投第１４案,臺東縣,卑南鄉,明峰村,104,436,41,154,195,32,227
公投第１４案,臺東縣,卑南鄉,嘉豐村,105,261,26,58,84,12,96
公投第１４案,臺東縣,卑南鄉,嘉豐村,106,215,28,79,107,11,118
公投第１４案,臺東縣,卑南鄉,太平村,107,1442,203,549,752,52,804
公投第１４案,臺東縣,卑南鄉,太平村,108,527,66,183,249,14,263
公投第１４案,臺東縣,卑南鄉,太平村,109,1046,143,396,539,43,582
公投第１４案,臺東縣,卑南鄉,泰安村,110,1110,179,374,553,52,605
公投第１４案,臺東縣,卑南鄉,利嘉村,111,1105,175,418,593,39,632
公投第１４案,臺東縣,卑南鄉,東興村,112,1167,163,461,624,103,727
公投第１４案,臺東縣,卑南鄉,溫泉村,113,968,117,307,424,47,471
公投第１４案,臺東縣,卑南鄉,溫泉村,114,159,20,41,61,4,65
公投第１４案,臺東縣,卑南鄉,富山村,115,488,43,156,199,19,218
公投第１４案,臺東縣,卑南鄉,富源村,116,347,47,139,186,16,202
公投第１４案,臺東縣,卑南鄉,利吉村,117,436,54,163,217,19,236
公投第１４案,臺東縣,鹿野鄉,鹿野村,118,522,57,134,191,5,196
公投第１４案,臺東縣,鹿野鄉,鹿野村,119,574,84,205,289,19,308
公投第１４案,臺東縣,鹿野鄉,龍田村,120,1055,124,265,389,24,413
公投第１４案,臺東縣,鹿野鄉,永安村,121,1104,151,337,488,30,518
公投第１４案,臺東縣,鹿野鄉,永安村,122,342,33,112,145,10,155
公投第１４案,臺東縣,鹿野鄉,瑞隆村,123,895,102,305,407,18,425
公投第１４案,臺東縣,鹿野鄉,瑞源村,124,864,123,261,384,38,422
公投第１４案,臺東縣,鹿野鄉,瑞和村,125,675,74,176,250,38,288
公投第１４案,臺東縣,鹿野鄉,瑞豐村,126,435,52,146,198,17,215
公投第１４案,臺東縣,鹿野鄉,瑞豐村,127,470,64,103,167,21,188
公投第１４案,臺東縣,池上鄉,福原村,128,992,120,332,452,28,480
公投第１４案,臺東縣,池上鄉,福原村,129,929,139,334,473,39,512
公投第１４案,臺東縣,池上鄉,福文村,130,434,51,136,187,24,211
公投第１４案,臺東縣,池上鄉,福文村,131,703,86,190,276,30,306
公投第１４案,臺東縣,池上鄉,慶豐村,132,654,64,203,267,21,288
公投第１４案,臺東縣,池上鄉,大坡村,133,324,25,87,112,17,129
公投第１４案,臺東縣,池上鄉,大埔村,134,794,89,245,334,26,360
公投第１４案,臺東縣,池上鄉,新興村,135,856,94,268,362,50,412
公投第１４案,臺東縣,池上鄉,錦園村,136,344,35,89,124,17,141
公投第１４案,臺東縣,池上鄉,萬安村,137,311,42,119,161,17,178
公投第１４案,臺東縣,池上鄉,富興村,138,386,35,89,124,13,137
公投第１４案,臺東縣,池上鄉,振興村,139,435,38,95,133,19,152
公投第１４案,臺東縣,東河鄉,都蘭村,140,290,38,69,107,17,124
公投第１４案,臺東縣,東河鄉,都蘭村,141,620,102,206,308,42,350
公投第１４案,臺東縣,東河鄉,都蘭村,142,1196,199,458,657,82,739
公投第１４案,臺東縣,東河鄉,興昌村,143,918,87,268,355,80,435
公投第１４案,臺東縣,東河鄉,隆昌村,144,555,48,173,221,39,260
公投第１４案,臺東縣,東河鄉,東河村,145,977,103,294,397,29,426
公投第１４案,臺東縣,東河鄉,泰源村,146,1197,81,278,359,10,369
公投第１４案,臺東縣,東河鄉,北源村,147,867,29,162,191,20,211
公投第１４案,臺東縣,東河鄉,北源村,148,345,38,97,135,13,148
公投第１４案,臺東縣,東河鄉,北源村,149,408,36,120,156,17,173
公投第１４案,臺東縣,東河鄉,尚德村,150,262,27,78,105,9,114
公投第１４案,臺東縣,長濱鄉,寧埔村,151,536,82,171,253,56,309
公投第１４案,臺東縣,長濱鄉,寧埔村,152,689,45,161,206,25,231
公投第１４案,臺東縣,長濱鄉,竹湖村,153,913,108,299,407,85,492
公投第１４案,臺東縣,長濱鄉,長濱村,154,1268,102,330,432,28,460
公投第１４案,臺東縣,長濱鄉,長濱村,155,725,59,231,290,51,341
公投第１４案,臺東縣,長濱鄉,忠勇村,156,532,37,104,141,8,149
公投第１４案,臺東縣,長濱鄉,三間村,157,660,51,167,218,61,279
公投第１４案,臺東縣,長濱鄉,三間村,158,336,15,93,108,4,112
公投第１４案,臺東縣,長濱鄉,三間村,159,195,13,39,52,12,64
公投第１４案,臺東縣,長濱鄉,樟原村,160,25,4,8,12,1,13
公投第１４案,臺東縣,長濱鄉,樟原村,161,605,46,190,236,32,268
公投第１４案,臺東縣,太麻里鄉,美和村,162,722,95,254,349,35,384
公投第１４案,臺東縣,太麻里鄉,美和村,163,575,51,220,271,24,295
公投第１４案,臺東縣,太麻里鄉,三和村,164,623,80,208,288,26,314
公投第１４案,臺東縣,太麻里鄉,華源村,165,622,55,213,268,35,303
公投第１４案,臺東縣,太麻里鄉,北里村,166,560,56,157,213,12,225
公投第１４案,臺東縣,太麻里鄉,大王村,167,957,109,360,469,71,540
公投第１４案,臺東縣,太麻里鄉,大王村,168,809,96,251,347,39,386
公投第１４案,臺東縣,太麻里鄉,泰和村,169,673,122,261,383,32,415
公投第１４案,臺東縣,太麻里鄉,泰和村,170,737,81,262,343,36,379
公投第１４案,臺東縣,太麻里鄉,香蘭村,171,424,53,161,214,27,241
公投第１４案,臺東縣,太麻里鄉,香蘭村,172,374,46,112,158,21,179
公投第１４案,臺東縣,太麻里鄉,金崙村,173,829,88,231,319,14,333
公投第１４案,臺東縣,太麻里鄉,金崙村,174,869,79,268,347,6,353
公投第１４案,臺東縣,太麻里鄉,多良村,175,223,13,60,73,3,76
公投第１４案,臺東縣,太麻里鄉,多良村,176,669,75,250,325,39,364
公投第１４案,臺東縣,大武鄉,南興村,177,568,52,253,305,38,343
公投第１４案,臺東縣,大武鄉,尚武村,178,1474,185,442,627,104,731
公投第１４案,臺東縣,大武鄉,大武村,179,1327,171,450,621,87,708
公投第１４案,臺東縣,大武鄉,大鳥村,180,1134,138,326,464,71,535
公投第１４案,臺東縣,大武鄉,大竹村,181,386,35,121,156,57,213
公投第１４案,臺東縣,大武鄉,大竹村,182,377,40,121,161,19,180
公投第１４案,臺東縣,綠島鄉,南寮村,183,1474,169,433,602,21,623
公投第１４案,臺東縣,綠島鄉,中寮村,184,1082,149,305,454,19,473
公投第１４案,臺東縣,綠島鄉,公舘村,185,813,126,238,364,17,381
公投第１４案,臺東縣,綠島鄉,公舘村,186,210,37,64,101,1,102
公投第１４案,臺東縣,海端鄉,加拿村,187,497,48,195,243,20,263
公投第１４案,臺東縣,海端鄉,崁頂村,188,569,51,265,316,14,330
公投第１４案,臺東縣,海端鄉,海端村,189,971,126,322,448,35,483
公投第１４案,臺東縣,海端鄉,廣原村,190,728,65,300,365,28,393
公投第１４案,臺東縣,海端鄉,霧鹿村,191,259,33,98,131,16,147
公投第１４案,臺東縣,海端鄉,利稻村,192,254,28,101,129,11,140
公投第１４案,臺東縣,延平鄉,桃源村,193,1014,132,386,518,29,547
公投第１４案,臺東縣,延平鄉,紅葉村,194,426,58,202,260,38,298
公投第１４案,臺東縣,延平鄉,永康村,195,315,36,156,192,17,209
公投第１４案,臺東縣,延平鄉,武陵村,196,579,65,195,260,15,275
公投第１４案,臺東縣,延平鄉,鸞山村,197,596,61,196,257,18,275
公投第１４案,臺東縣,金峰鄉,嘉蘭村,198,1241,154,406,560,43,603
公投第１４案,臺東縣,金峰鄉,正興村,199,601,95,278,373,26,399
公投第１４案,臺東縣,金峰鄉,新興村,200,520,125,241,366,27,393
公投第１４案,臺東縣,金峰鄉,賓茂村,201,336,34,138,172,21,193
公投第１４案,臺東縣,金峰鄉,歷坵村,202,330,45,154,199,28,227
公投第１４案,臺東縣,達仁鄉,安朔村,203,246,33,114,147,7,154
公投第１４案,臺東縣,達仁鄉,安朔村,204,340,24,174,198,20,218
公投第１４案,臺東縣,達仁鄉,南田村,205,296,40,139,179,16,195
公投第１４案,臺東縣,達仁鄉,森永村,206,429,54,213,267,14,281
公投第１４案,臺東縣,達仁鄉,新化村,207,331,37,157,194,24,218
公投第１４案,臺東縣,達仁鄉,台坂村,208,628,69,197,266,21,287
公投第１４案,臺東縣,達仁鄉,土坂村,209,867,116,318,434,42,476
公投第１４案,臺東縣,蘭嶼鄉,椰油村,210,943,84,284,368,18,386
公投第１４案,臺東縣,蘭嶼鄉,紅頭村,211,1238,141,357,498,30,528
公投第１４案,臺東縣,蘭嶼鄉,東清村,212,1240,105,286,391,16,407
公投第１４案,臺東縣,蘭嶼鄉,朗島村,213,760,87,166,253,26,279
公投第１４案,花蓮縣,花蓮市,民德里,1,1522,264,581,845,23,868
公投第１４案,花蓮縣,花蓮市,民勤里,2,1114,171,456,627,24,651
公投第１４案,花蓮縣,花蓮市,民勤里,3,670,100,256,356,21,377
公投第１４案,花蓮縣,花蓮市,民勤里,4,1397,217,501,718,20,738
公投第１４案,花蓮縣,花蓮市,民意里,5,470,59,158,217,22,239
公投第１４案,花蓮縣,花蓮市,民意里,6,838,97,308,405,27,432
公投第１４案,花蓮縣,花蓮市,民意里,7,721,65,224,289,18,307
公投第１４案,花蓮縣,花蓮市,民心里,8,918,140,351,491,41,532
公投第１４案,花蓮縣,花蓮市,民享里,9,1539,247,531,778,31,809
公投第１４案,花蓮縣,花蓮市,民享里,10,1403,191,521,712,35,747
公投第１４案,花蓮縣,花蓮市,民孝里,11,1068,143,395,538,26,564
公投第１４案,花蓮縣,花蓮市,民孝里,12,1167,172,450,622,25,647
公投第１４案,花蓮縣,花蓮市,民孝里,13,1259,190,508,698,54,752
公投第１４案,花蓮縣,花蓮市,民運里,14,1071,152,390,542,54,596
公投第１４案,花蓮縣,花蓮市,民運里,15,925,148,354,502,27,529
公投第１４案,花蓮縣,花蓮市,民政里,16,1141,184,479,663,50,713
公投第１４案,花蓮縣,花蓮市,民政里,17,1163,162,435,597,17,614
公投第１４案,花蓮縣,花蓮市,民政里,18,1279,185,523,708,38,746
公投第１４案,花蓮縣,花蓮市,民立里,19,1512,216,509,725,20,745
公投第１４案,花蓮縣,花蓮市,民樂里,20,615,99,213,312,22,334
公投第１４案,花蓮縣,花蓮市,民有里,21,606,113,226,339,19,358
公投第１４案,花蓮縣,花蓮市,民主里,22,559,71,205,276,13,289
公投第１４案,花蓮縣,花蓮市,民族里,23,442,64,173,237,10,247
公投第１４案,花蓮縣,花蓮市,民生里,24,1114,163,385,548,26,574
公投第１４案,花蓮縣,花蓮市,民權里,25,416,59,170,229,10,239
公投第１４案,花蓮縣,花蓮市,主商里,26,577,94,246,340,15,355
公投第１４案,花蓮縣,花蓮市,主勤里,27,810,154,313,467,28,495
公投第１４案,花蓮縣,花蓮市,主工里,28,538,80,212,292,17,309
公投第１４案,花蓮縣,花蓮市,主信里,29,566,77,207,284,26,310
公投第１４案,花蓮縣,花蓮市,主義里,30,469,81,172,253,8,261
公投第１４案,花蓮縣,花蓮市,主睦里,31,565,95,206,301,23,324
公投第１４案,花蓮縣,花蓮市,主計里,32,816,98,286,384,25,409
公投第１４案,花蓮縣,花蓮市,主和里,33,911,124,332,456,24,480
公投第１４案,花蓮縣,花蓮市,主和里,34,1029,114,384,498,41,539
公投第１４案,花蓮縣,花蓮市,主和里,35,1043,165,417,582,33,615
公投第１４案,花蓮縣,花蓮市,主學里,36,856,138,345,483,12,495
公投第１４案,花蓮縣,花蓮市,主學里,37,979,159,361,520,18,538
公投第１４案,花蓮縣,花蓮市,主農里,38,1331,217,498,715,37,752
公投第１４案,花蓮縣,花蓮市,主農里,39,1228,198,472,670,25,695
公投第１４案,花蓮縣,花蓮市,主農里,40,955,141,386,527,20,547
公投第１４案,花蓮縣,花蓮市,主安里,41,1268,181,433,614,27,641
公投第１４案,花蓮縣,花蓮市,主安里,42,1230,166,448,614,30,644
公投第１４案,花蓮縣,花蓮市,主權里,43,1369,205,541,746,29,775
公投第１４案,花蓮縣,花蓮市,主權里,44,1435,189,442,631,36,667
公投第１４案,花蓮縣,花蓮市,主權里,45,1164,173,443,616,23,639
公投第１４案,花蓮縣,花蓮市,主權里,46,1249,188,510,698,42,740
公投第１４案,花蓮縣,花蓮市,主力里,47,1184,180,422,602,54,656
公投第１４案,花蓮縣,花蓮市,主力里,48,1490,225,530,755,18,773
公投第１４案,花蓮縣,花蓮市,國風里,49,1022,165,437,602,42,644
公投第１４案,花蓮縣,花蓮市,國風里,50,1135,151,444,595,46,641
公投第１４案,花蓮縣,花蓮市,國風里,51,1084,129,454,583,27,610
公投第１４案,花蓮縣,花蓮市,國威里,52,1339,145,329,474,25,499
公投第１４案,花蓮縣,花蓮市,國威里,53,501,82,205,287,15,302
公投第１４案,花蓮縣,花蓮市,國治里,54,904,134,352,486,18,504
公投第１４案,花蓮縣,花蓮市,國安里,55,490,88,202,290,14,304
公投第１４案,花蓮縣,花蓮市,國光里,56,1192,152,397,549,27,576
公投第１４案,花蓮縣,花蓮市,國防里,57,869,116,290,406,29,435
公投第１４案,花蓮縣,花蓮市,國華里,58,1267,189,458,647,29,676
公投第１４案,花蓮縣,花蓮市,國華里,59,959,148,379,527,29,556
公投第１４案,花蓮縣,花蓮市,國魂里,60,993,120,392,512,32,544
公投第１４案,花蓮縣,花蓮市,國魂里,61,982,156,360,516,36,552
公投第１４案,花蓮縣,花蓮市,國聯里,62,1311,181,438,619,24,643
公投第１４案,花蓮縣,花蓮市,國聯里,63,1455,202,509,711,37,748
公投第１４案,花蓮縣,花蓮市,國盛里,64,1151,130,381,511,25,536
公投第１４案,花蓮縣,花蓮市,國盛里,65,1237,161,435,596,18,614
公投第１４案,花蓮縣,花蓮市,國盛里,66,1339,215,400,615,29,644
公投第１４案,花蓮縣,花蓮市,國強里,67,715,117,280,397,18,415
公投第１４案,花蓮縣,花蓮市,國強里,68,1000,160,372,532,26,558
公投第１４案,花蓮縣,花蓮市,國富里,69,1410,163,492,655,45,700
公投第１４案,花蓮縣,花蓮市,國富里,70,1303,119,496,615,61,676
公投第１４案,花蓮縣,花蓮市,國富里,71,1256,162,482,644,27,671
公投第１４案,花蓮縣,花蓮市,國富里,72,1105,146,475,621,16,637
公投第１４案,花蓮縣,花蓮市,國裕里,73,1089,156,380,536,21,557
公投第１４案,花蓮縣,花蓮市,國裕里,74,1043,136,361,497,31,528
公投第１４案,花蓮縣,花蓮市,國裕里,75,1080,146,455,601,18,619
公投第１４案,花蓮縣,花蓮市,國裕里,76,971,149,349,498,32,530
公投第１４案,花蓮縣,花蓮市,國慶里,77,1068,187,392,579,33,612
公投第１４案,花蓮縣,花蓮市,國興里,78,1379,180,477,657,35,692
公投第１４案,花蓮縣,花蓮市,國興里,79,1362,195,497,692,25,717
公投第１４案,花蓮縣,花蓮市,國興里,80,1323,227,503,730,26,756
公投第１４案,花蓮縣,花蓮市,國福里,81,1482,177,474,651,28,679
公投第１４案,花蓮縣,新城鄉,新城村,82,367,61,134,195,16,211
公投第１４案,花蓮縣,新城鄉,新城村,83,929,119,334,453,16,469
公投第１４案,花蓮縣,新城鄉,順安村,84,590,96,209,305,50,355
公投第１４案,花蓮縣,新城鄉,順安村,85,307,47,105,152,21,173
公投第１４案,花蓮縣,新城鄉,康樂村,86,260,30,113,143,17,160
公投第１４案,花蓮縣,新城鄉,康樂村,87,1283,202,455,657,62,719
公投第１４案,花蓮縣,新城鄉,康樂村,88,885,83,342,425,25,450
公投第１４案,花蓮縣,新城鄉,大漢村,89,770,98,314,412,34,446
公投第１４案,花蓮縣,新城鄉,大漢村,90,1363,170,518,688,53,741
公投第１４案,花蓮縣,新城鄉,大漢村,91,366,55,124,179,18,197
公投第１４案,花蓮縣,新城鄉,北埔村,92,1163,149,396,545,49,594
公投第１４案,花蓮縣,新城鄉,北埔村,93,1605,224,593,817,31,848
公投第１４案,花蓮縣,新城鄉,北埔村,94,1194,166,453,619,38,657
公投第１４案,花蓮縣,新城鄉,佳林村,95,979,139,377,516,36,552
公投第１４案,花蓮縣,新城鄉,嘉里村,96,1485,207,578,785,44,829
公投第１４案,花蓮縣,新城鄉,嘉里村,97,1070,145,383,528,30,558
公投第１４案,花蓮縣,新城鄉,嘉里村,98,1164,179,433,612,21,633
公投第１４案,花蓮縣,新城鄉,嘉新村,99,880,113,308,421,47,468
公投第１４案,花蓮縣,新城鄉,嘉新村,100,369,53,124,177,9,186
公投第１４案,花蓮縣,秀林鄉,和平村,101,867,80,349,429,22,451
公投第１４案,花蓮縣,秀林鄉,和平村,102,575,87,187,274,26,300
公投第１４案,花蓮縣,秀林鄉,崇德村,103,1373,135,409,544,35,579
公投第１４案,花蓮縣,秀林鄉,富世村,104,1644,173,547,720,71,791
公投第１４案,花蓮縣,秀林鄉,富世村,105,162,15,70,85,5,90
公投第１４案,花蓮縣,秀林鄉,秀林村,106,384,48,124,172,23,195
公投第１４案,花蓮縣,秀林鄉,秀林村,107,1382,174,437,611,44,655
公投第１４案,花蓮縣,秀林鄉,景美村,108,1125,150,364,514,38,552
公投第１４案,花蓮縣,秀林鄉,景美村,109,627,108,185,293,17,310
公投第１４案,花蓮縣,秀林鄉,佳民村,110,987,145,412,557,49,606
公投第１４案,花蓮縣,秀林鄉,水源村,111,1139,183,440,623,78,701
公投第１４案,花蓮縣,秀林鄉,銅門村,112,1213,165,482,647,11,658
公投第１４案,花蓮縣,秀林鄉,文蘭村,113,754,109,274,383,23,406
公投第１４案,花蓮縣,秀林鄉,文蘭村,114,330,30,122,152,7,159
公投第１４案,花蓮縣,吉安鄉,永安村,115,1059,150,378,528,33,561
公投第１４案,花蓮縣,吉安鄉,永安村,116,983,147,372,519,28,547
公投第１４案,花蓮縣,吉安鄉,永安村,117,1031,138,399,537,27,564
公投第１４案,花蓮縣,吉安鄉,永安村,118,1105,158,382,540,31,571
公投第１４案,花蓮縣,吉安鄉,太昌村,119,1107,165,384,549,29,578
公投第１４案,花蓮縣,吉安鄉,太昌村,120,1179,155,405,560,30,590
公投第１４案,花蓮縣,吉安鄉,太昌村,121,1453,167,447,614,51,665
公投第１４案,花蓮縣,吉安鄉,慶豐村,122,1432,229,572,801,39,840
公投第１４案,花蓮縣,吉安鄉,慶豐村,123,1320,190,516,706,21,727
公投第１４案,花蓮縣,吉安鄉,慶豐村,124,1356,189,493,682,21,703
公投第１４案,花蓮縣,吉安鄉,慶豐村,125,1295,164,483,647,31,678
公投第１４案,花蓮縣,吉安鄉,慶豐村,126,1467,190,547,737,61,798
公投第１４案,花蓮縣,吉安鄉,吉安村,127,1515,195,569,764,28,792
公投第１４案,花蓮縣,吉安鄉,吉安村,128,1063,159,428,587,44,631
公投第１４案,花蓮縣,吉安鄉,吉安村,129,1284,165,393,558,19,577
公投第１４案,花蓮縣,吉安鄉,吉安村,130,1380,209,540,749,24,773
公投第１４案,花蓮縣,吉安鄉,福興村,131,1297,191,501,692,49,741
公投第１４案,花蓮縣,吉安鄉,福興村,132,1662,247,544,791,65,856
公投第１４案,花蓮縣,吉安鄉,南華村,133,1563,163,526,689,65,754
公投第１４案,花蓮縣,吉安鄉,干城村,134,1288,128,446,574,49,623
公投第１４案,花蓮縣,吉安鄉,永興村,135,907,133,354,487,28,515
公投第１４案,花蓮縣,吉安鄉,永興村,136,917,102,333,435,38,473
公投第１４案,花蓮縣,吉安鄉,永興村,137,1021,132,360,492,34,526
公投第１４案,花蓮縣,吉安鄉,稻香村,138,1033,160,423,583,31,614
公投第１４案,花蓮縣,吉安鄉,稻香村,139,966,135,374,509,43,552
公投第１４案,花蓮縣,吉安鄉,稻香村,140,1188,153,423,576,48,624
公投第１４案,花蓮縣,吉安鄉,南昌村,141,1480,180,563,743,30,773
公投第１４案,花蓮縣,吉安鄉,南昌村,142,1393,149,489,638,36,674
公投第１４案,花蓮縣,吉安鄉,南昌村,143,1193,150,432,582,32,614
公投第１４案,花蓮縣,吉安鄉,宜昌村,144,1445,179,498,677,25,702
公投第１４案,花蓮縣,吉安鄉,宜昌村,145,1301,158,491,649,73,722
公投第１４案,花蓮縣,吉安鄉,宜昌村,146,1215,171,464,635,55,690
公投第１４案,花蓮縣,吉安鄉,北昌村,147,1135,170,415,585,25,610
公投第１４案,花蓮縣,吉安鄉,北昌村,148,1223,165,501,666,29,695
公投第１４案,花蓮縣,吉安鄉,北昌村,149,1274,156,519,675,29,704
公投第１４案,花蓮縣,吉安鄉,北昌村,150,1124,145,422,567,27,594
公投第１４案,花蓮縣,吉安鄉,北昌村,151,1158,190,436,626,25,651
公投第１４案,花蓮縣,吉安鄉,北昌村,152,1157,177,456,633,14,647
公投第１４案,花蓮縣,吉安鄉,勝安村,153,1258,175,487,662,31,693
公投第１４案,花蓮縣,吉安鄉,勝安村,154,1257,166,470,636,36,672
公投第１４案,花蓮縣,吉安鄉,勝安村,155,1245,166,461,627,26,653
公投第１４案,花蓮縣,吉安鄉,勝安村,156,1166,178,458,636,14,650
公投第１４案,花蓮縣,吉安鄉,仁里村,157,1358,162,498,660,54,714
公投第１４案,花蓮縣,吉安鄉,仁里村,158,1214,127,469,596,33,629
公投第１４案,花蓮縣,吉安鄉,仁里村,159,1151,147,438,585,35,620
公投第１４案,花蓮縣,吉安鄉,仁里村,160,1157,153,464,617,26,643
公投第１４案,花蓮縣,吉安鄉,仁里村,161,1161,168,457,625,30,655
公投第１４案,花蓮縣,吉安鄉,東昌村,162,1304,177,517,694,43,737
公投第１４案,花蓮縣,吉安鄉,東昌村,163,1367,188,484,672,45,717
公投第１４案,花蓮縣,吉安鄉,東昌村,164,1411,157,472,629,37,666
公投第１４案,花蓮縣,吉安鄉,東昌村,165,1409,146,482,628,39,667
公投第１４案,花蓮縣,吉安鄉,仁安村,166,1125,129,379,508,31,539
公投第１４案,花蓮縣,吉安鄉,仁安村,167,1213,144,468,612,59,671
公投第１４案,花蓮縣,吉安鄉,仁和村,168,1141,142,453,595,31,626
公投第１４案,花蓮縣,吉安鄉,仁和村,169,1156,117,401,518,25,543
公投第１４案,花蓮縣,吉安鄉,仁和村,170,1092,130,405,535,33,568
公投第１４案,花蓮縣,吉安鄉,仁和村,171,1026,108,320,428,40,468
公投第１４案,花蓮縣,吉安鄉,光華村,172,804,81,334,415,14,429
公投第１４案,花蓮縣,吉安鄉,光華村,173,1132,128,467,595,32,627
公投第１４案,花蓮縣,壽豐鄉,溪口村,174,1052,120,350,470,46,516
公投第１４案,花蓮縣,壽豐鄉,樹湖村,175,357,47,138,185,33,218
公投第１４案,花蓮縣,壽豐鄉,豐山村,176,1022,115,348,463,52,515
公投第１４案,花蓮縣,壽豐鄉,豐山村,177,875,134,373,507,41,548
公投第１４案,花蓮縣,壽豐鄉,豐裡村,178,691,115,277,392,32,424
公投第１４案,花蓮縣,壽豐鄉,豐裡村,179,708,81,240,321,24,345
公投第１４案,花蓮縣,壽豐鄉,豐坪村,180,894,129,296,425,49,474
公投第１４案,花蓮縣,壽豐鄉,壽豐村,181,746,109,275,384,26,410
公投第１４案,花蓮縣,壽豐鄉,壽豐村,182,881,101,328,429,40,469
公投第１４案,花蓮縣,壽豐鄉,共和村,183,695,113,294,407,30,437
公投第１４案,花蓮縣,壽豐鄉,光榮村,184,816,112,345,457,64,521
公投第１４案,花蓮縣,壽豐鄉,池南村,185,773,100,255,355,40,395
公投第１４案,花蓮縣,壽豐鄉,平和村,186,1029,153,395,548,40,588
公投第１４案,花蓮縣,壽豐鄉,平和村,187,407,48,186,234,24,258
公投第１４案,花蓮縣,壽豐鄉,志學村,188,1139,160,454,614,39,653
公投第１４案,花蓮縣,壽豐鄉,志學村,189,996,205,337,542,32,574
公投第１４案,花蓮縣,壽豐鄉,志學村,190,414,52,125,177,11,188
公投第１４案,花蓮縣,壽豐鄉,米棧村,191,270,29,115,144,13,157
公投第１４案,花蓮縣,壽豐鄉,月眉村,192,836,97,342,439,50,489
公投第１４案,花蓮縣,壽豐鄉,鹽寮村,193,507,76,208,284,25,309
公投第１４案,花蓮縣,壽豐鄉,水璉村,194,739,65,204,269,47,316
公投第１４案,花蓮縣,鳳林鎮,鳳仁里,195,1192,156,526,682,51,733
公投第１４案,花蓮縣,鳳林鎮,鳳義里,196,639,67,240,307,18,325
公投第１４案,花蓮縣,鳳林鎮,鳳禮里,197,601,96,270,366,35,401
公投第１４案,花蓮縣,鳳林鎮,鳳智里,198,1137,183,505,688,43,731
公投第１４案,花蓮縣,鳳林鎮,鳳信里,199,742,101,276,377,41,418
公投第１４案,花蓮縣,鳳林鎮,鳳信里,200,610,79,250,329,22,351
公投第１４案,花蓮縣,鳳林鎮,山興里,201,295,38,115,153,39,192
公投第１４案,花蓮縣,鳳林鎮,山興里,202,218,17,44,61,6,67
公投第１４案,花蓮縣,鳳林鎮,大榮里,203,720,82,215,297,17,314
公投第１４案,花蓮縣,鳳林鎮,大榮里,204,528,72,189,261,29,290
公投第１４案,花蓮縣,鳳林鎮,北林里,205,560,83,189,272,19,291
公投第１４案,花蓮縣,鳳林鎮,南平里,206,541,67,179,246,45,291
公投第１４案,花蓮縣,鳳林鎮,林榮里,207,818,95,318,413,51,464
公投第１４案,花蓮縣,鳳林鎮,長橋里,208,984,93,296,389,41,430
公投第１４案,花蓮縣,鳳林鎮,森榮里,209,91,13,26,39,11,50
公投第１４案,花蓮縣,光復鄉,大華村,210,1295,162,495,657,75,732
公投第１４案,花蓮縣,光復鄉,大安村,211,859,119,341,460,41,501
公投第１４案,花蓮縣,光復鄉,大平村,212,958,102,366,468,102,570
公投第１４案,花蓮縣,光復鄉,大馬村,213,1011,106,394,500,88,588
公投第１４案,花蓮縣,光復鄉,大同村,214,1041,121,413,534,69,603
公投第１４案,花蓮縣,光復鄉,東富村,215,821,89,280,369,81,450
公投第１４案,花蓮縣,光復鄉,東富村,216,188,8,33,41,3,44
公投第１４案,花蓮縣,光復鄉,西富村,217,514,55,190,245,36,281
公投第１４案,花蓮縣,光復鄉,西富村,218,446,41,127,168,7,175
公投第１４案,花蓮縣,光復鄉,南富村,219,851,78,301,379,52,431
公投第１４案,花蓮縣,光復鄉,北富村,220,932,98,226,324,20,344
公投第１４案,花蓮縣,光復鄉,大進村,221,471,62,191,253,17,270
公投第１４案,花蓮縣,光復鄉,大全村,222,640,91,228,319,36,355
公投第１４案,花蓮縣,光復鄉,大全村,223,116,8,34,42,3,45
公投第１４案,花蓮縣,光復鄉,大興村,224,496,40,118,158,7,165
公投第１４案,花蓮縣,光復鄉,大富村,225,324,38,100,138,8,146
公投第１４案,花蓮縣,光復鄉,大豐村,226,454,28,129,157,24,181
公投第１４案,花蓮縣,豐濱鄉,靜浦村,227,717,68,206,274,70,344
公投第１４案,花蓮縣,豐濱鄉,港口村,228,751,89,176,265,47,312
公投第１４案,花蓮縣,豐濱鄉,豐濱村,229,613,65,178,243,49,292
公投第１４案,花蓮縣,豐濱鄉,豐濱村,230,809,100,283,383,30,413
公投第１４案,花蓮縣,豐濱鄉,豐濱村,231,357,23,63,86,2,88
公投第１４案,花蓮縣,豐濱鄉,新社村,232,669,77,200,277,64,341
公投第１４案,花蓮縣,豐濱鄉,磯崎村,233,479,63,142,205,11,216
公投第１４案,花蓮縣,萬榮鄉,西林村,234,1072,155,379,534,67,601
公投第１４案,花蓮縣,萬榮鄉,見晴村,235,560,69,190,259,4,263
公投第１４案,花蓮縣,萬榮鄉,萬榮村,236,773,107,339,446,28,474
公投第１４案,花蓮縣,萬榮鄉,明利村,237,661,70,192,262,15,277
公投第１４案,花蓮縣,萬榮鄉,馬遠村,238,442,41,186,227,12,239
公投第１４案,花蓮縣,萬榮鄉,馬遠村,239,675,53,247,300,49,349
公投第１４案,花蓮縣,萬榮鄉,紅葉村,240,1086,172,481,653,87,740
公投第１４案,花蓮縣,瑞穗鄉,瑞穗村,241,813,98,345,443,32,475
公投第１４案,花蓮縣,瑞穗鄉,瑞穗村,242,1091,121,434,555,54,609
公投第１４案,花蓮縣,瑞穗鄉,瑞美村,243,839,99,343,442,35,477
公投第１４案,花蓮縣,瑞穗鄉,瑞美村,244,975,97,396,493,64,557
公投第１４案,花蓮縣,瑞穗鄉,瑞良村,245,546,54,184,238,22,260
公投第１４案,花蓮縣,瑞穗鄉,瑞祥村,246,1002,139,365,504,68,572
公投第１４案,花蓮縣,瑞穗鄉,瑞北村,247,593,65,187,252,28,280
公投第１４案,花蓮縣,瑞穗鄉,舞鶴村,248,965,118,338,456,76,532
公投第１４案,花蓮縣,瑞穗鄉,鶴岡村,249,863,94,323,417,60,477
公投第１４案,花蓮縣,瑞穗鄉,奇美村,250,340,14,63,77,8,85
公投第１４案,花蓮縣,瑞穗鄉,富源村,251,764,66,247,313,41,354
公投第１４案,花蓮縣,瑞穗鄉,富民村,252,868,33,158,191,13,204
公投第１４案,花蓮縣,瑞穗鄉,富興村,253,620,31,149,180,15,195
公投第１４案,花蓮縣,玉里鎮,中城里,254,1008,141,373,514,35,549
公投第１４案,花蓮縣,玉里鎮,中城里,255,939,121,399,520,38,558
公投第１４案,花蓮縣,玉里鎮,中城里,256,1256,152,447,599,59,658
公投第１４案,花蓮縣,玉里鎮,中城里,257,929,122,347,469,37,506
公投第１４案,花蓮縣,玉里鎮,中城里,258,979,129,365,494,41,535
公投第１４案,花蓮縣,玉里鎮,國武里,259,1244,193,499,692,36,728
公投第１４案,花蓮縣,玉里鎮,啟模里,260,847,97,278,375,43,418
公投第１４案,花蓮縣,玉里鎮,啟模里,261,772,93,238,331,49,380
公投第１４案,花蓮縣,玉里鎮,泰昌里,262,558,68,192,260,19,279
公投第１４案,花蓮縣,玉里鎮,泰昌里,263,800,49,187,236,24,260
公投第１４案,花蓮縣,玉里鎮,永昌里,264,1286,113,415,528,68,596
公投第１４案,花蓮縣,玉里鎮,源城里,265,1246,152,375,527,71,598
公投第１４案,花蓮縣,玉里鎮,長良里,266,647,80,212,292,56,348
公投第１４案,花蓮縣,玉里鎮,樂合里,267,990,53,170,223,20,243
公投第１４案,花蓮縣,玉里鎮,東豐里,268,530,57,146,203,59,262
公投第１４案,花蓮縣,玉里鎮,觀音里,269,979,77,258,335,39,374
公投第１４案,花蓮縣,玉里鎮,觀音里,270,557,58,186,244,76,320
公投第１４案,花蓮縣,玉里鎮,松浦里,271,434,36,121,157,20,177
公投第１４案,花蓮縣,玉里鎮,松浦里,272,1065,94,217,311,70,381
公投第１４案,花蓮縣,玉里鎮,春日里,273,866,91,286,377,94,471
公投第１４案,花蓮縣,玉里鎮,德武里,274,769,72,211,283,52,335
公投第１４案,花蓮縣,玉里鎮,三民里,275,869,109,227,336,36,372
公投第１４案,花蓮縣,玉里鎮,大禹里,276,1080,122,283,405,41,446
公投第１４案,花蓮縣,富里鄉,吳江村,277,467,39,146,185,15,200
公投第１４案,花蓮縣,富里鄉,東里村,278,1032,103,257,360,52,412
公投第１４案,花蓮縣,富里鄉,萬寧村,279,638,38,217,255,24,279
公投第１４案,花蓮縣,富里鄉,新興村,280,591,72,188,260,61,321
公投第１４案,花蓮縣,富里鄉,竹田村,281,1087,120,416,536,58,594
公投第１４案,花蓮縣,富里鄉,羅山村,282,431,63,149,212,12,224
公投第１４案,花蓮縣,富里鄉,石牌村,283,893,115,282,397,39,436
公投第１４案,花蓮縣,富里鄉,明里村,284,361,32,101,133,16,149
公投第１４案,花蓮縣,富里鄉,富里村,285,1362,129,383,512,35,547
公投第１４案,花蓮縣,富里鄉,永豐村,286,458,45,167,212,27,239
公投第１４案,花蓮縣,富里鄉,豐南村,287,621,32,138,170,37,207
公投第１４案,花蓮縣,富里鄉,富南村,288,493,50,170,220,24,244
公投第１４案,花蓮縣,富里鄉,學田村,289,631,75,196,271,34,305
公投第１４案,花蓮縣,卓溪鄉,崙山村,290,533,58,220,278,25,303
公投第１４案,花蓮縣,卓溪鄉,立山村,291,522,75,203,278,54,332
公投第１４案,花蓮縣,卓溪鄉,立山村,292,493,77,183,260,20,280
公投第１４案,花蓮縣,卓溪鄉,太平村,293,701,57,344,401,40,441
公投第１４案,花蓮縣,卓溪鄉,卓溪村,294,746,85,313,398,45,443
公投第１４案,花蓮縣,卓溪鄉,卓清村,295,616,73,261,334,56,390
公投第１４案,花蓮縣,卓溪鄉,卓清村,296,405,35,104,139,12,151
公投第１４案,花蓮縣,卓溪鄉,古風村,297,329,39,129,168,11,179
公投第１４案,花蓮縣,卓溪鄉,古風村,298,428,37,175,212,20,232
公投第１４案,花蓮縣,卓溪鄉,古風村,299,174,15,75,90,8,98
公投第１４案,澎湖縣,馬公市,復興里,1,481,68,149,217,10,227
公投第１４案,澎湖縣,馬公市,長安里,2,558,69,204,273,18,291
公投第１４案,澎湖縣,馬公市,中央里,3,533,52,173,225,38,263
公投第１４案,澎湖縣,馬公市,啟明里,4,922,135,300,435,30,465
公投第１４案,澎湖縣,馬公市,重慶里,5,1021,171,341,512,35,547
公投第１４案,澎湖縣,馬公市,中興里,6,793,125,252,377,29,406
公投第１４案,澎湖縣,馬公市,光復里,7,954,125,344,469,41,510
公投第１４案,澎湖縣,馬公市,光復里,8,1001,145,338,483,21,504
公投第１４案,澎湖縣,馬公市,光明里,9,1192,152,354,506,28,534
公投第１４案,澎湖縣,馬公市,光榮里,10,1402,154,459,613,49,662
公投第１４案,澎湖縣,馬公市,光榮里,11,1389,198,494,692,25,717
公投第１４案,澎湖縣,馬公市,光榮里,12,1339,173,485,658,38,696
公投第１４案,澎湖縣,馬公市,朝陽里,13,1254,152,412,564,38,602
公投第１４案,澎湖縣,馬公市,朝陽里,14,1194,149,410,559,42,601
公投第１４案,澎湖縣,馬公市,朝陽里,15,1393,173,457,630,43,673
公投第１４案,澎湖縣,馬公市,朝陽里,16,1440,207,520,727,27,754
公投第１４案,澎湖縣,馬公市,陽明里,17,1215,170,382,552,44,596
公投第１４案,澎湖縣,馬公市,陽明里,18,1284,145,441,586,46,632
公投第１４案,澎湖縣,馬公市,重光里,19,1512,196,500,696,53,749
公投第１４案,澎湖縣,馬公市,西衛里,20,1181,148,373,521,47,568
公投第１４案,澎湖縣,馬公市,西衛里,21,1348,162,470,632,44,676
公投第１４案,澎湖縣,馬公市,西衛里,22,1391,238,459,697,20,717
公投第１４案,澎湖縣,馬公市,西衛里,23,2124,650,274,924,14,938
公投第１４案,澎湖縣,馬公市,西文里,24,1500,174,532,706,42,748
公投第１４案,澎湖縣,馬公市,西文里,25,1582,180,568,748,32,780
公投第１４案,澎湖縣,馬公市,東文里,26,1638,197,578,775,22,797
公投第１４案,澎湖縣,馬公市,東文里,27,1554,212,563,775,36,811
公投第１４案,澎湖縣,馬公市,案山里,28,980,100,260,360,23,383
公投第１４案,澎湖縣,馬公市,案山里,29,892,118,310,428,24,452
公投第１４案,澎湖縣,馬公市,光華里,30,778,101,208,309,13,322
公投第１４案,澎湖縣,馬公市,前寮里,31,930,119,332,451,22,473
公投第１４案,澎湖縣,馬公市,石泉里,32,1481,226,605,831,31,862
公投第１４案,澎湖縣,馬公市,石泉里,33,1128,158,429,587,14,601
公投第１４案,澎湖縣,馬公市,菜園里,34,415,43,161,204,20,224
公投第１４案,澎湖縣,馬公市,東衛里,35,1120,148,379,527,32,559
公投第１４案,澎湖縣,馬公市,東衛里,36,950,116,382,498,17,515
公投第１４案,澎湖縣,馬公市,安宅里,37,627,69,193,262,20,282
公投第１４案,澎湖縣,馬公市,興仁里,38,1055,128,389,517,20,537
公投第１４案,澎湖縣,馬公市,烏崁里,39,989,121,363,484,33,517
公投第１４案,澎湖縣,馬公市,鐵線里,40,591,87,208,295,35,330
公投第１４案,澎湖縣,馬公市,鎖港里,41,1387,171,427,598,59,657
公投第１４案,澎湖縣,馬公市,鎖港里,42,1079,125,295,420,47,467
公投第１４案,澎湖縣,馬公市,山水里,43,797,82,279,361,37,398
公投第１４案,澎湖縣,馬公市,山水里,44,903,112,279,391,23,414
公投第１４案,澎湖縣,馬公市,五德里,45,376,67,91,158,19,177
公投第１４案,澎湖縣,馬公市,井垵里,46,371,52,131,183,12,195
公投第１４案,澎湖縣,馬公市,嵵裡里,47,1173,98,338,436,19,455
公投第１４案,澎湖縣,馬公市,風櫃里,48,1389,132,327,459,21,480
公投第１４案,澎湖縣,馬公市,虎井里,49,761,56,103,159,54,213
公投第１４案,澎湖縣,馬公市,桶盤里,50,288,50,111,161,15,176
公投第１４案,澎湖縣,湖西鄉,湖西村,51,1120,135,405,540,48,588
公投第１４案,澎湖縣,湖西鄉,湖東村,52,332,40,96,136,6,142
公投第１４案,澎湖縣,湖西鄉,青螺村,53,242,25,64,89,6,95
公投第１４案,澎湖縣,湖西鄉,白坑村,54,293,36,63,99,6,105
公投第１４案,澎湖縣,湖西鄉,南寮村,55,666,56,177,233,41,274
公投第１４案,澎湖縣,湖西鄉,北寮村,56,326,39,109,148,14,162
公投第１４案,澎湖縣,湖西鄉,紅羅村,57,732,88,197,285,12,297
公投第１４案,澎湖縣,湖西鄉,西溪村,58,651,62,221,283,18,301
公投第１４案,澎湖縣,湖西鄉,成功村,59,744,88,224,312,12,324
公投第１４案,澎湖縣,湖西鄉,東石村,60,134,23,49,72,1,73
公投第１４案,澎湖縣,湖西鄉,沙港村,61,794,83,167,250,24,274
公投第１４案,澎湖縣,湖西鄉,中西村,62,216,21,54,75,3,78
公投第１４案,澎湖縣,湖西鄉,鼎灣村,63,664,54,140,194,4,198
公投第１４案,澎湖縣,湖西鄉,潭邊村,64,279,32,93,125,7,132
公投第１４案,澎湖縣,湖西鄉,許家村,65,296,27,118,145,5,150
公投第１４案,澎湖縣,湖西鄉,城北村,66,257,42,76,118,4,122
公投第１４案,澎湖縣,湖西鄉,太武村,67,89,2,26,28,1,29
公投第１４案,澎湖縣,湖西鄉,隘門村,68,815,119,240,359,31,390
公投第１４案,澎湖縣,湖西鄉,林投村,69,975,94,276,370,19,389
公投第１４案,澎湖縣,湖西鄉,尖山村,70,648,84,204,288,28,316
公投第１４案,澎湖縣,湖西鄉,龍門村,71,893,103,246,349,25,374
公投第１４案,澎湖縣,湖西鄉,龍門村,72,846,113,276,389,49,438
公投第１４案,澎湖縣,湖西鄉,菓葉村,73,729,79,180,259,14,273
公投第１４案,澎湖縣,白沙鄉,中屯村,74,514,64,176,240,16,256
公投第１４案,澎湖縣,白沙鄉,講美村,75,657,83,242,325,14,339
公投第１４案,澎湖縣,白沙鄉,城前村,76,109,13,55,68,4,72
公投第１４案,澎湖縣,白沙鄉,鎮海村,77,156,16,47,63,3,66
公投第１４案,澎湖縣,白沙鄉,港子村,78,293,31,85,116,5,121
公投第１４案,澎湖縣,白沙鄉,岐頭村,79,231,19,53,72,1,73
公投第１４案,澎湖縣,白沙鄉,小赤村,80,161,27,53,80,7,87
公投第１４案,澎湖縣,白沙鄉,赤崁村,81,1705,183,566,749,42,791
公投第１４案,澎湖縣,白沙鄉,瓦硐村,82,285,31,88,119,6,125
公投第１４案,澎湖縣,白沙鄉,後寮村,83,723,56,152,208,13,221
公投第１４案,澎湖縣,白沙鄉,通梁村,84,774,79,178,257,29,286
公投第１４案,澎湖縣,白沙鄉,吉貝村,85,1429,140,284,424,77,501
公投第１４案,澎湖縣,白沙鄉,鳥嶼村,86,1084,76,374,450,50,500
公投第１４案,澎湖縣,白沙鄉,員貝村,87,251,36,83,119,7,126
公投第１４案,澎湖縣,白沙鄉,大倉村,88,253,32,47,79,13,92
公投第１４案,澎湖縣,西嶼鄉,橫礁村,89,283,14,33,47,0,47
公投第１４案,澎湖縣,西嶼鄉,合界村,90,424,42,70,112,12,124
公投第１４案,澎湖縣,西嶼鄉,竹灣村,91,826,82,160,242,42,284
公投第１４案,澎湖縣,西嶼鄉,小門村,92,282,24,77,101,10,111
公投第１４案,澎湖縣,西嶼鄉,大池村,93,661,75,148,223,38,261
公投第１４案,澎湖縣,西嶼鄉,二崁村,94,141,8,20,28,2,30
公投第１４案,澎湖縣,西嶼鄉,池東村,95,635,46,139,185,12,197
公投第１４案,澎湖縣,西嶼鄉,池西村,96,216,18,51,69,5,74
公投第１４案,澎湖縣,西嶼鄉,赤馬村,97,572,41,78,119,23,142
公投第１４案,澎湖縣,西嶼鄉,內垵村,98,1267,118,348,466,53,519
公投第１４案,澎湖縣,西嶼鄉,外垵村,99,942,71,218,289,26,315
公投第１４案,澎湖縣,西嶼鄉,外垵村,100,1133,127,276,403,47,450
公投第１４案,澎湖縣,望安鄉,東安村,101,734,95,202,297,35,332
公投第１４案,澎湖縣,望安鄉,西安村,102,454,30,146,176,14,190
公投第１４案,澎湖縣,望安鄉,中社村,103,300,24,71,95,9,104
公投第１４案,澎湖縣,望安鄉,水垵村,104,471,54,155,209,30,239
公投第１４案,澎湖縣,望安鄉,將軍村,105,672,69,137,206,14,220
公投第１４案,澎湖縣,望安鄉,將軍村,106,742,84,186,270,32,302
公投第１４案,澎湖縣,望安鄉,東吉村,107,264,33,62,95,14,109
公投第１４案,澎湖縣,望安鄉,東坪村,108,476,64,135,199,2,201
公投第１４案,澎湖縣,望安鄉,西坪村,109,208,21,32,53,3,56
公投第１４案,澎湖縣,望安鄉,花嶼村,110,307,21,67,88,3,91
公投第１４案,澎湖縣,七美鄉,東湖村,111,248,26,38,64,3,67
公投第１４案,澎湖縣,七美鄉,西湖村,112,581,59,124,183,21,204
公投第１４案,澎湖縣,七美鄉,中和村,113,641,77,125,202,25,227
公投第１４案,澎湖縣,七美鄉,平和村,114,382,32,82,114,4,118
公投第１４案,澎湖縣,七美鄉,海豐村,115,351,23,56,79,6,85
公投第１４案,澎湖縣,七美鄉,南港村,116,1171,100,200,300,20,320
公投第１４案,基隆市,中正區,長潭里,1,466,72,165,237,19,256
公投第１４案,基隆市,中正區,砂子里,2,1262,155,365,520,24,544
公投第１４案,基隆市,中正區,砂子里,3,1171,151,360,511,45,556
公投第１４案,基隆市,中正區,砂子里,4,2823,353,686,1039,18,1057
公投第１４案,基隆市,中正區,八斗里,5,1474,212,388,600,47,647
公投第１４案,基隆市,中正區,碧砂里,6,1271,173,329,502,56,558
公投第１４案,基隆市,中正區,新富里,7,2707,353,753,1106,64,1170
公投第１４案,基隆市,中正區,新富里,8,1545,188,489,677,80,757
公投第１４案,基隆市,中正區,新富里,9,761,96,196,292,13,305
公投第１４案,基隆市,中正區,新豐里,10,1352,220,417,637,18,655
公投第１４案,基隆市,中正區,新豐里,11,1413,181,459,640,22,662
公投第１４案,基隆市,中正區,新豐里,12,2665,370,740,1110,40,1150
公投第１４案,基隆市,中正區,平寮里,13,1261,175,348,523,64,587
公投第１４案,基隆市,中正區,社寮里,14,1753,182,620,802,74,876
公投第１４案,基隆市,中正區,和憲里,15,984,116,277,393,48,441
公投第１４案,基隆市,中正區,海濱里,16,1166,142,380,522,31,553
公投第１４案,基隆市,中正區,正濱里,17,973,149,294,443,28,471
公投第１４案,基隆市,中正區,中正里,18,1694,230,380,610,18,628
公投第１４案,基隆市,中正區,中濱里,19,1270,194,416,610,27,637
公投第１４案,基隆市,中正區,建國里,20,1090,151,389,540,37,577
公投第１４案,基隆市,中正區,建國里,21,870,135,304,439,18,457
公投第１４案,基隆市,中正區,砂灣里,22,1138,179,353,532,41,573
公投第１４案,基隆市,中正區,砂灣里,23,862,120,268,388,35,423
公投第１４案,基隆市,中正區,真砂里,24,1341,229,454,683,56,739
公投第１４案,基隆市,中正區,正砂里,25,859,138,276,414,38,452
公投第１４案,基隆市,中正區,正砂里,26,1457,199,448,647,22,669
公投第１４案,基隆市,中正區,中砂里,27,1594,326,278,604,51,655
公投第１４案,基隆市,中正區,入船里,28,802,128,263,391,38,429
公投第１４案,基隆市,中正區,正船里,29,1267,165,417,582,42,624
公投第１４案,基隆市,中正區,中船里,30,1175,210,354,564,58,622
公投第１４案,基隆市,中正區,港通里,31,1210,188,441,629,42,671
公投第１４案,基隆市,中正區,義重里,32,1037,176,329,505,42,547
公投第１４案,基隆市,中正區,正義里,33,1219,192,404,596,43,639
公投第１４案,基隆市,中正區,信義里,34,904,149,281,430,27,457
公投第１４案,基隆市,中正區,德義里,35,709,100,312,412,29,441
公投第１４案,基隆市,信義區,仁壽里,36,1096,223,367,590,27,617
公投第１４案,基隆市,信義區,仁義里,37,1232,239,459,698,33,731
公投第１４案,基隆市,信義區,義昭里,38,1184,249,388,637,21,658
公投第１４案,基隆市,信義區,義幸里,39,1133,183,443,626,39,665
公投第１４案,基隆市,信義區,義幸里,40,1188,210,427,637,29,666
公投第１４案,基隆市,信義區,義民里,41,725,133,261,394,31,425
公投第１４案,基隆市,信義區,義和里,42,1524,214,474,688,36,724
公投第１４案,基隆市,信義區,智慧里,43,736,140,248,388,24,412
公投第１４案,基隆市,信義區,智誠里,44,611,97,213,310,15,325
公投第１４案,基隆市,信義區,智誠里,45,951,135,301,436,13,449
公投第１４案,基隆市,信義區,禮儀里,46,1616,265,557,822,31,853
公投第１４案,基隆市,信義區,禮東里,47,1516,241,553,794,28,822
公投第１４案,基隆市,信義區,信綠里,48,1049,168,343,511,28,539
公投第１４案,基隆市,信義區,信綠里,49,1069,206,334,540,18,558
公投第１４案,基隆市,信義區,東信里,50,727,125,276,401,22,423
公投第１４案,基隆市,信義區,東信里,51,929,177,354,531,18,549
公投第１４案,基隆市,信義區,東信里,52,1118,240,430,670,19,689
公投第１４案,基隆市,信義區,東信里,53,1339,269,449,718,33,751
公投第１４案,基隆市,信義區,東光里,54,999,169,331,500,18,518
公投第１４案,基隆市,信義區,東光里,55,764,126,253,379,13,392
公投第１４案,基隆市,信義區,東明里,56,1555,223,492,715,36,751
公投第１４案,基隆市,信義區,東明里,57,2015,332,626,958,25,983
公投第１４案,基隆市,信義區,東安里,58,1268,219,464,683,39,722
公投第１４案,基隆市,信義區,東安里,59,1569,259,546,805,29,834
公投第１４案,基隆市,信義區,孝賢里,60,1985,309,615,924,32,956
公投第１４案,基隆市,信義區,孝賢里,61,1476,232,562,794,18,812
公投第１４案,基隆市,信義區,孝忠里,62,1493,309,503,812,26,838
公投第１４案,基隆市,信義區,孝忠里,63,1249,265,478,743,17,760
公投第１４案,基隆市,信義區,孝忠里,64,1559,256,512,768,22,790
公投第１４案,基隆市,信義區,孝忠里,65,1168,196,363,559,10,569
公投第１４案,基隆市,信義區,孝忠里,66,1602,237,566,803,26,829
公投第１４案,基隆市,信義區,孝德里,67,1485,199,451,650,37,687
公投第１４案,基隆市,信義區,孝德里,68,1009,160,340,500,22,522
公投第１４案,基隆市,信義區,孝深里,69,2016,263,563,826,41,867
公投第１４案,基隆市,信義區,孝深里,70,1764,221,497,718,32,750
公投第１４案,基隆市,信義區,孝岡里,71,1295,199,466,665,36,701
公投第１４案,基隆市,仁愛區,林泉里,72,1782,264,486,750,78,828
公投第１４案,基隆市,仁愛區,花崗里,73,1055,179,376,555,44,599
公投第１４案,基隆市,仁愛區,虹橋里,74,1558,217,482,699,34,733
公投第１４案,基隆市,仁愛區,水錦里,75,1736,248,591,839,43,882
公投第１４案,基隆市,仁愛區,智仁里,76,1243,210,489,699,34,733
公投第１４案,基隆市,仁愛區,智仁里,77,1109,187,408,595,28,623
公投第１４案,基隆市,仁愛區,和明里,78,1684,281,643,924,42,966
公投第１４案,基隆市,仁愛區,忠勇里,79,919,168,311,479,29,508
公投第１４案,基隆市,仁愛區,玉田里,80,991,181,310,491,14,505
公投第１４案,基隆市,仁愛區,仁德里,81,876,154,306,460,10,470
公投第１４案,基隆市,仁愛區,博愛里,82,1046,182,391,573,39,612
公投第１４案,基隆市,仁愛區,博愛里,83,434,78,165,243,20,263
公投第１４案,基隆市,仁愛區,福仁里,84,764,142,160,302,46,348
公投第１４案,基隆市,仁愛區,誠仁里,85,968,186,291,477,27,504
公投第１４案,基隆市,仁愛區,吉仁里,86,1326,210,427,637,47,684
公投第１４案,基隆市,仁愛區,吉仁里,87,1315,172,365,537,36,573
公投第１４案,基隆市,仁愛區,育仁里,88,775,138,273,411,38,449
公投第１４案,基隆市,仁愛區,英仁里,89,652,113,211,324,50,374
公投第１４案,基隆市,仁愛區,英仁里,90,674,124,234,358,20,378
公投第１４案,基隆市,仁愛區,龍門里,91,789,128,245,373,36,409
公投第１４案,基隆市,仁愛區,德厚里,92,1715,284,559,843,59,902
公投第１４案,基隆市,仁愛區,曲水里,93,849,143,277,420,39,459
公投第１４案,基隆市,仁愛區,崇文里,94,875,137,328,465,20,485
公投第１４案,基隆市,仁愛區,文安里,95,851,148,248,396,40,436
公投第１４案,基隆市,仁愛區,兆連里,96,735,140,253,393,34,427
公投第１４案,基隆市,仁愛區,獅球里,97,1009,152,329,481,56,537
公投第１４案,基隆市,仁愛區,書院里,98,1082,159,327,486,46,532
公投第１４案,基隆市,仁愛區,朝棟里,99,1278,212,386,598,64,662
公投第１４案,基隆市,仁愛區,朝棟里,100,1519,284,546,830,42,872
公投第１４案,基隆市,仁愛區,光華里,101,1336,198,366,564,36,600
公投第１４案,基隆市,仁愛區,光華里,102,1178,209,451,660,41,701
公投第１４案,基隆市,仁愛區,明德里,103,708,128,222,350,33,383
公投第１４案,基隆市,仁愛區,同風里,104,567,113,219,332,24,356
公投第１４案,基隆市,仁愛區,文昌里,105,751,153,221,374,40,414
公投第１４案,基隆市,仁愛區,新店里,106,589,129,204,333,20,353
公投第１４案,基隆市,中山區,新建里,107,796,128,258,386,23,409
公投第１４案,基隆市,中山區,安民里,108,1036,192,403,595,45,640
公投第１４案,基隆市,中山區,安平里,109,756,128,271,399,37,436
公投第１４案,基隆市,中山區,中山里,110,957,164,254,418,20,438
公投第１４案,基隆市,中山區,民治里,111,802,138,283,421,17,438
公投第１４案,基隆市,中山區,中興里,112,1263,214,419,633,37,670
公投第１４案,基隆市,中山區,仁正里,113,778,143,283,426,19,445
公投第１４案,基隆市,中山區,健民里,114,1180,191,387,578,83,661
公投第１４案,基隆市,中山區,通化里,115,990,150,305,455,23,478
公投第１４案,基隆市,中山區,居仁里,116,1332,181,350,531,23,554
公投第１４案,基隆市,中山區,通明里,117,848,128,255,383,21,404
公投第１４案,基隆市,中山區,通明里,118,922,146,273,419,20,439
公投第１４案,基隆市,中山區,和平里,119,459,79,183,262,11,273
公投第１４案,基隆市,中山區,仙洞里,120,574,73,193,266,21,287
公投第１４案,基隆市,中山區,太白里,121,877,147,269,416,39,455
公投第１４案,基隆市,中山區,協和里,122,1584,246,437,683,34,717
公投第１４案,基隆市,中山區,文化里,123,1319,145,323,468,26,494
公投第１４案,基隆市,中山區,德安里,124,1938,293,611,904,66,970
公投第１４案,基隆市,中山區,德安里,125,1877,348,539,887,21,908
公投第１４案,基隆市,中山區,德和里,126,2088,373,714,1087,31,1118
公投第１４案,基隆市,中山區,德和里,127,1946,351,673,1024,29,1053
公投第１４案,基隆市,中山區,德和里,128,1353,234,486,720,49,769
公投第１４案,基隆市,中山區,中和里,129,1317,202,438,640,46,686
公投第１４案,基隆市,中山區,中和里,130,870,155,312,467,30,497
公投第１４案,基隆市,中山區,中和里,131,1322,211,484,695,28,723
公投第１４案,基隆市,中山區,中和里,132,1295,218,365,583,24,607
公投第１４案,基隆市,中山區,中和里,133,756,145,291,436,24,460
公投第１４案,基隆市,中山區,和慶里,134,1602,227,470,697,26,723
公投第１４案,基隆市,中山區,和慶里,135,1568,234,475,709,32,741
公投第１４案,基隆市,中山區,和慶里,136,1404,242,459,701,38,739
公投第１４案,基隆市,中山區,和慶里,137,1909,277,611,888,25,913
公投第１４案,基隆市,中山區,西康里,138,1642,221,471,692,66,758
公投第１４案,基隆市,中山區,西定里,139,932,132,292,424,22,446
公投第１４案,基隆市,中山區,西華里,140,849,145,328,473,40,513
公投第１４案,基隆市,中山區,西榮里,141,715,148,231,379,45,424
公投第１４案,基隆市,安樂區,新西里,142,1361,176,442,618,52,670
公投第１４案,基隆市,安樂區,西川里,143,1213,161,403,564,26,590
公投第１４案,基隆市,安樂區,定國里,144,1026,115,325,440,26,466
公投第１４案,基隆市,安樂區,定邦里,145,1038,188,386,574,55,629
公投第１４案,基隆市,安樂區,慈仁里,146,897,177,291,468,47,515
公投第１４案,基隆市,安樂區,干城里,147,1401,227,461,688,57,745
公投第１４案,基隆市,安樂區,干城里,148,641,68,158,226,11,237
公投第１４案,基隆市,安樂區,永康里,149,1472,224,478,702,44,746
公投第１４案,基隆市,安樂區,永康里,150,472,75,175,250,13,263
公投第１４案,基隆市,安樂區,安和里,151,841,154,320,474,26,500
公投第１４案,基隆市,安樂區,樂一里,152,571,99,177,276,29,305
公投第１４案,基隆市,安樂區,嘉仁里,153,1901,292,587,879,38,917
公投第１４案,基隆市,安樂區,嘉仁里,154,1349,224,428,652,47,699
公投第１４案,基隆市,安樂區,三民里,155,1225,168,428,596,32,628
公投第１４案,基隆市,安樂區,三民里,156,1351,231,464,695,53,748
公投第１４案,基隆市,安樂區,壯觀里,157,1601,317,573,890,21,911
公投第１４案,基隆市,安樂區,壯觀里,158,2513,360,896,1256,34,1290
公投第１４案,基隆市,安樂區,四維里,159,1613,280,560,840,32,872
公投第１４案,基隆市,安樂區,四維里,160,1731,497,416,913,28,941
公投第１４案,基隆市,安樂區,四維里,161,1424,296,526,822,24,846
公投第１４案,基隆市,安樂區,五福里,162,1806,265,607,872,54,926
公投第１４案,基隆市,安樂區,五福里,163,1679,280,608,888,49,937
公投第１４案,基隆市,安樂區,六合里,164,1902,347,626,973,42,1015
公投第１４案,基隆市,安樂區,六合里,165,2040,513,562,1075,13,1088
公投第１４案,基隆市,安樂區,七賢里,166,1313,217,459,676,33,709
公投第１４案,基隆市,安樂區,七賢里,167,1243,189,406,595,30,625
公投第１４案,基隆市,安樂區,長樂里,168,1759,322,541,863,36,899
公投第１４案,基隆市,安樂區,長樂里,169,694,157,265,422,16,438
公投第１４案,基隆市,安樂區,長樂里,170,866,212,317,529,22,551
公投第１４案,基隆市,安樂區,鶯歌里,171,1557,226,426,652,23,675
公投第１４案,基隆市,安樂區,鶯歌里,172,1411,235,466,701,16,717
公投第１４案,基隆市,安樂區,鶯安里,173,1568,309,558,867,23,890
公投第１４案,基隆市,安樂區,鶯安里,174,1400,238,453,691,34,725
公投第１４案,基隆市,安樂區,鶯安里,175,1531,265,507,772,16,788
公投第１４案,基隆市,安樂區,興寮里,176,1673,271,533,804,15,819
公投第１４案,基隆市,安樂區,興寮里,177,1054,163,365,528,32,560
公投第１４案,基隆市,安樂區,興寮里,178,1923,273,526,799,31,830
公投第１４案,基隆市,安樂區,外寮里,179,1960,659,336,995,56,1051
公投第１４案,基隆市,安樂區,外寮里,180,1962,301,634,935,43,978
公投第１４案,基隆市,安樂區,新崙里,181,2117,321,719,1040,57,1097
公投第１４案,基隆市,安樂區,新崙里,182,1829,294,564,858,32,890
公投第１４案,基隆市,安樂區,武崙里,183,1529,251,467,718,20,738
公投第１４案,基隆市,安樂區,武崙里,184,1869,310,612,922,27,949
公投第１４案,基隆市,安樂區,武崙里,185,1140,189,440,629,11,640
公投第１４案,基隆市,安樂區,中崙里,186,1641,285,524,809,37,846
公投第１４案,基隆市,安樂區,內寮里,187,1279,207,416,623,37,660
公投第１４案,基隆市,安樂區,內寮里,188,1360,267,409,676,23,699
公投第１４案,基隆市,安樂區,內寮里,189,1399,271,469,740,24,764
公投第１４案,基隆市,安樂區,內寮里,190,1251,228,391,619,23,642
公投第１４案,基隆市,暖暖區,八西里,191,1431,226,453,679,31,710
公投第１４案,基隆市,暖暖區,八中里,192,456,60,153,213,5,218
公投第１４案,基隆市,暖暖區,八堵里,193,637,112,218,330,28,358
公投第１４案,基隆市,暖暖區,八南里,194,735,136,277,413,22,435
公投第１４案,基隆市,暖暖區,過港里,195,1078,152,346,498,21,519
公投第１４案,基隆市,暖暖區,過港里,196,1238,212,391,603,33,636
公投第１４案,基隆市,暖暖區,過港里,197,1325,217,428,645,30,675
公投第１４案,基隆市,暖暖區,暖暖里,198,1475,472,488,960,28,988
公投第１４案,基隆市,暖暖區,暖暖里,199,1179,214,332,546,18,564
公投第１４案,基隆市,暖暖區,暖同里,200,1110,218,410,628,29,657
公投第１４案,基隆市,暖暖區,暖同里,201,1443,222,426,648,24,672
公投第１４案,基隆市,暖暖區,暖東里,202,415,72,132,204,20,224
公投第１４案,基隆市,暖暖區,暖西里,203,1378,249,415,664,15,679
公投第１４案,基隆市,暖暖區,暖西里,204,1570,272,515,787,28,815
公投第１４案,基隆市,暖暖區,暖西里,205,1603,301,582,883,53,936
公投第１４案,基隆市,暖暖區,碇內里,206,1267,230,474,704,28,732
公投第１４案,基隆市,暖暖區,碇內里,207,1359,213,467,680,34,714
公投第１４案,基隆市,暖暖區,碇和里,208,970,139,411,550,20,570
公投第１４案,基隆市,暖暖區,碇和里,209,1002,177,343,520,13,533
公投第１４案,基隆市,暖暖區,碇和里,210,944,166,288,454,27,481
公投第１４案,基隆市,暖暖區,碇祥里,211,1500,279,541,820,24,844
公投第１４案,基隆市,暖暖區,碇祥里,212,1442,173,399,572,21,593
公投第１４案,基隆市,暖暖區,碇祥里,213,1165,214,406,620,12,632
公投第１４案,基隆市,暖暖區,碇祥里,214,1610,265,521,786,33,819
公投第１４案,基隆市,暖暖區,碇安里,215,1328,259,445,704,27,731
公投第１４案,基隆市,暖暖區,碇安里,216,1173,207,394,601,17,618
公投第１４案,基隆市,暖暖區,碇安里,217,1019,218,332,550,51,601
公投第１４案,基隆市,暖暖區,碇安里,218,1373,245,478,723,21,744
公投第１４案,基隆市,七堵區,長興里,219,1258,198,470,668,48,716
公投第１４案,基隆市,七堵區,長興里,220,1237,193,447,640,51,691
公投第１４案,基隆市,七堵區,長興里,221,1259,213,413,626,24,650
公投第１４案,基隆市,七堵區,正光里,222,1120,165,353,518,48,566
公投第１４案,基隆市,七堵區,正光里,223,1344,186,415,601,41,642
公投第１４案,基隆市,七堵區,正明里,224,1011,192,399,591,28,619
公投第１４案,基隆市,七堵區,正明里,225,925,152,317,469,16,485
公投第１４案,基隆市,七堵區,富民里,226,1735,261,653,914,59,973
公投第１４案,基隆市,七堵區,富民里,227,1833,321,659,980,55,1035
公投第１４案,基隆市,七堵區,永平里,228,938,167,340,507,14,521
公投第１４案,基隆市,七堵區,永平里,229,962,170,357,527,45,572
公投第１４案,基隆市,七堵區,永安里,230,1191,208,443,651,26,677
公投第１４案,基隆市,七堵區,永安里,231,999,143,399,542,33,575
公投第１４案,基隆市,七堵區,八德里,232,282,44,87,131,8,139
公投第１４案,基隆市,七堵區,八德里,233,1243,222,385,607,34,641
公投第１４案,基隆市,七堵區,自強里,234,1092,182,344,526,44,570
公投第１４案,基隆市,七堵區,泰安里,235,1246,201,429,630,43,673
公投第１４案,基隆市,七堵區,泰安里,236,1722,297,532,829,38,867
公投第１４案,基隆市,七堵區,泰安里,237,1318,210,468,678,33,711
公投第１４案,基隆市,七堵區,六堵里,238,975,126,315,441,20,461
公投第１４案,基隆市,七堵區,六堵里,239,1285,219,418,637,38,675
公投第１４案,基隆市,七堵區,堵南里,240,1077,163,328,491,31,522
公投第１４案,基隆市,七堵區,堵南里,241,989,155,288,443,30,473
公投第１４案,基隆市,七堵區,長安里,242,1193,187,379,566,34,600
公投第１４案,基隆市,七堵區,長安里,243,1273,222,411,633,31,664
公投第１４案,基隆市,七堵區,堵北里,244,1774,294,586,880,72,952
公投第１４案,基隆市,七堵區,堵北里,245,1689,304,544,848,58,906
公投第１４案,基隆市,七堵區,百福里,246,1355,216,423,639,51,690
公投第１４案,基隆市,七堵區,百福里,247,1512,281,447,728,38,766
公投第１４案,基隆市,七堵區,百福里,248,1486,231,477,708,17,725
公投第１４案,基隆市,七堵區,百福里,249,1706,276,550,826,27,853
公投第１４案,基隆市,七堵區,實踐里,250,1384,426,288,714,42,756
公投第１４案,基隆市,七堵區,實踐里,251,1045,216,372,588,38,626
公投第１４案,基隆市,七堵區,實踐里,252,1374,249,445,694,39,733
公投第１４案,基隆市,七堵區,瑪南里,253,428,76,147,223,8,231
公投第１４案,基隆市,七堵區,瑪東里,254,326,53,116,169,28,197
公投第１４案,基隆市,七堵區,瑪西里,255,351,65,170,235,16,251
公投第１４案,基隆市,七堵區,友一里,256,1871,291,583,874,21,895
公投第１４案,基隆市,七堵區,友二里,257,448,50,145,195,13,208
公投第１４案,新竹市,東區,育賢里,1,1512,178,324,502,14,516
公投第１４案,新竹市,東區,親仁里,2,953,213,356,569,16,585
公投第１４案,新竹市,東區,親仁里,3,729,140,268,408,15,423
公投第１４案,新竹市,東區,東門里,4,566,111,219,330,23,353
公投第１４案,新竹市,東區,成功里,5,640,126,240,366,12,378
公投第１４案,新竹市,東區,榮光里,6,305,65,92,157,16,173
公投第１４案,新竹市,東區,中正里,7,563,106,216,322,24,346
公投第１４案,新竹市,東區,錦華里,8,741,128,278,406,15,421
公投第１４案,新竹市,東區,錦華里,9,1041,233,356,589,18,607
公投第１４案,新竹市,東區,文華里,10,1615,302,548,850,29,879
公投第１４案,新竹市,東區,文華里,11,1287,245,464,709,38,747
公投第１４案,新竹市,東區,文華里,12,1554,261,596,857,26,883
公投第１４案,新竹市,東區,復中里,13,1388,286,520,806,16,822
公投第１４案,新竹市,東區,復中里,14,1419,274,538,812,33,845
公投第１４案,新竹市,東區,復中里,15,1355,265,453,718,38,756
公投第１４案,新竹市,東區,復興里,16,1490,284,530,814,27,841
公投第１４案,新竹市,東區,復興里,17,1615,304,593,897,23,920
公投第１４案,新竹市,東區,復興里,18,1672,454,479,933,37,970
公投第１４案,新竹市,東區,三民里,19,1062,234,363,597,25,622
公投第１４案,新竹市,東區,三民里,20,1315,273,451,724,30,754
公投第１４案,新竹市,東區,三民里,21,1000,183,381,564,33,597
公投第１４案,新竹市,東區,三民里,22,1337,265,498,763,36,799
公投第１４案,新竹市,東區,東園里,23,1747,372,551,923,26,949
公投第１４案,新竹市,東區,東園里,24,1600,376,558,934,25,959
公投第１４案,新竹市,東區,東園里,25,1158,210,414,624,32,656
公投第１４案,新竹市,東區,東園里,26,828,191,327,518,22,540
公投第１４案,新竹市,東區,公園里,27,1573,309,525,834,39,873
公投第１４案,新竹市,東區,公園里,28,1550,297,562,859,30,889
公投第１４案,新竹市,東區,建華里,29,1317,244,483,727,29,756
公投第１４案,新竹市,東區,建華里,30,1040,254,361,615,32,647
公投第１４案,新竹市,東區,東山里,31,935,162,381,543,21,564
公投第１４案,新竹市,東區,東山里,32,1074,209,385,594,19,613
公投第１４案,新竹市,東區,東山里,33,1133,213,447,660,35,695
公投第１４案,新竹市,東區,綠水里,34,1262,251,468,719,35,754
公投第１４案,新竹市,東區,綠水里,35,1199,221,452,673,18,691
公投第１４案,新竹市,東區,綠水里,36,1226,257,477,734,28,762
公投第１４案,新竹市,東區,綠水里,37,1377,327,531,858,31,889
公投第１４案,新竹市,東區,綠水里,38,991,233,385,618,17,635
公投第１４案,新竹市,東區,東勢里,39,1271,267,445,712,52,764
公投第１４案,新竹市,東區,東勢里,40,1012,240,393,633,19,652
公投第１４案,新竹市,東區,光復里,41,1001,187,356,543,44,587
公投第１４案,新竹市,東區,光復里,42,1603,339,482,821,43,864
公投第１４案,新竹市,東區,前溪里,43,1236,204,464,668,28,696
公投第１４案,新竹市,東區,前溪里,44,1532,206,499,705,37,742
公投第１４案,新竹市,東區,水源里,45,1306,217,498,715,23,738
公投第１４案,新竹市,東區,水源里,46,1073,190,387,577,55,632
公投第１４案,新竹市,東區,水源里,47,952,193,332,525,11,536
公投第１４案,新竹市,東區,千甲里,48,1298,207,400,607,44,651
公投第１４案,新竹市,東區,千甲里,49,778,121,303,424,14,438
公投第１４案,新竹市,東區,豐功里,50,1195,275,396,671,35,706
公投第１４案,新竹市,東區,豐功里,51,1569,292,531,823,45,868
公投第１４案,新竹市,東區,豐功里,52,1533,367,573,940,26,966
公投第１４案,新竹市,東區,武功里,53,1336,204,578,782,32,814
公投第１４案,新竹市,東區,武功里,54,1367,243,541,784,25,809
公投第１４案,新竹市,東區,武功里,55,1289,274,493,767,21,788
公投第１４案,新竹市,東區,軍功里,56,960,174,344,518,24,542
公投第１４案,新竹市,東區,軍功里,57,843,182,338,520,19,539
公投第１４案,新竹市,東區,軍功里,58,948,166,373,539,37,576
公投第１４案,新竹市,東區,立功里,59,915,135,359,494,23,517
公投第１４案,新竹市,東區,建功里,60,1801,314,703,1017,29,1046
公投第１４案,新竹市,東區,建功里,61,1079,195,417,612,24,636
公投第１４案,新竹市,東區,建功里,62,676,139,278,417,9,426
公投第１４案,新竹市,東區,光明里,63,1132,237,401,638,38,676
公投第１４案,新竹市,東區,光明里,64,251,64,78,142,10,152
公投第１４案,新竹市,東區,光明里,65,1620,340,559,899,34,933
公投第１４案,新竹市,東區,龍山里,66,1479,325,450,775,26,801
公投第１４案,新竹市,東區,龍山里,67,1402,325,408,733,23,756
公投第１４案,新竹市,東區,龍山里,68,1280,278,415,693,37,730
公投第１４案,新竹市,東區,龍山里,69,1228,345,375,720,13,733
公投第１４案,新竹市,東區,龍山里,70,1157,342,284,626,5,631
公投第１４案,新竹市,東區,龍山里,71,1354,272,464,736,31,767
公投第１４案,新竹市,東區,科園里,72,1334,333,515,848,29,877
公投第１４案,新竹市,東區,科園里,73,1234,290,438,728,24,752
公投第１４案,新竹市,東區,科園里,74,1398,311,564,875,21,896
公投第１４案,新竹市,東區,科園里,75,928,246,306,552,18,570
公投第１４案,新竹市,東區,科園里,76,1368,296,527,823,26,849
公投第１４案,新竹市,東區,埔頂里,77,1215,224,417,641,25,666
公投第１４案,新竹市,東區,埔頂里,78,1067,170,355,525,31,556
公投第１４案,新竹市,東區,埔頂里,79,1194,349,304,653,9,662
公投第１４案,新竹市,東區,埔頂里,80,1193,321,304,625,17,642
公投第１４案,新竹市,東區,新莊里,81,1388,289,471,760,45,805
公投第１４案,新竹市,東區,新莊里,82,1267,247,480,727,25,752
公投第１４案,新竹市,東區,新莊里,83,1299,261,453,714,22,736
公投第１４案,新竹市,東區,新莊里,84,1288,292,420,712,29,741
公投第１４案,新竹市,東區,關新里,85,1228,350,380,730,19,749
公投第１４案,新竹市,東區,關新里,86,1135,335,341,676,14,690
公投第１４案,新竹市,東區,關新里,87,1237,359,407,766,21,787
公投第１４案,新竹市,東區,關東里,88,1135,199,371,570,37,607
公投第１４案,新竹市,東區,關東里,89,1165,191,391,582,25,607
公投第１４案,新竹市,東區,關東里,90,1124,212,391,603,28,631
公投第１４案,新竹市,東區,關東里,91,1210,242,441,683,29,712
公投第１４案,新竹市,東區,金山里,92,1323,250,435,685,29,714
公投第１４案,新竹市,東區,金山里,93,1207,178,453,631,26,657
公投第１４案,新竹市,東區,金山里,94,1264,211,389,600,29,629
公投第１４案,新竹市,東區,金山里,95,1248,278,391,669,17,686
公投第１４案,新竹市,東區,仙水里,96,1400,308,525,833,38,871
公投第１４案,新竹市,東區,仙水里,97,1473,343,514,857,27,884
公投第１４案,新竹市,東區,仙水里,98,1367,305,437,742,27,769
公投第１４案,新竹市,東區,仙宮里,99,1233,256,454,710,15,725
公投第１４案,新竹市,東區,關帝里,100,507,93,172,265,9,274
公投第１４案,新竹市,東區,南門里,101,714,131,261,392,30,422
公投第１４案,新竹市,東區,南市里,102,875,156,327,483,34,517
公投第１４案,新竹市,東區,福德里,103,1396,236,513,749,41,790
公投第１４案,新竹市,東區,振興里,104,1232,242,389,631,28,659
公投第１４案,新竹市,東區,振興里,105,1323,279,403,682,35,717
公投第１４案,新竹市,東區,振興里,106,1516,253,456,709,17,726
公投第１４案,新竹市,東區,振興里,107,1453,281,435,716,30,746
公投第１４案,新竹市,東區,新興里,108,880,160,323,483,34,517
公投第１４案,新竹市,東區,新興里,109,1058,129,393,522,25,547
公投第１４案,新竹市,東區,新興里,110,1061,187,384,571,28,599
公投第１４案,新竹市,東區,寺前里,111,710,119,256,375,36,411
公投第１４案,新竹市,東區,竹蓮里,112,752,155,262,417,38,455
公投第１４案,新竹市,東區,下竹里,113,475,83,207,290,12,302
公投第１４案,新竹市,東區,頂竹里,114,880,170,278,448,30,478
公投第１４案,新竹市,東區,頂竹里,115,989,209,339,548,28,576
公投第１４案,新竹市,東區,頂竹里,116,1059,191,385,576,35,611
公投第１４案,新竹市,東區,南大里,117,607,128,210,338,34,372
公投第１４案,新竹市,東區,南大里,118,815,164,280,444,32,476
公投第１４案,新竹市,東區,新光里,119,777,150,299,449,33,482
公投第１４案,新竹市,東區,新光里,120,1399,239,431,670,31,701
公投第１４案,新竹市,東區,新光里,121,1216,243,398,641,36,677
公投第１４案,新竹市,東區,光鎮里,122,1062,175,350,525,33,558
公投第１４案,新竹市,東區,光鎮里,123,1046,196,394,590,21,611
公投第１４案,新竹市,東區,光鎮里,124,1332,208,464,672,21,693
公投第１４案,新竹市,東區,高峰里,125,1350,252,487,739,41,780
公投第１４案,新竹市,東區,高峰里,126,1438,237,490,727,29,756
公投第１４案,新竹市,東區,高峰里,127,1414,211,502,713,30,743
公投第１４案,新竹市,東區,高峰里,128,1476,307,525,832,26,858
公投第１４案,新竹市,東區,湖濱里,129,1326,259,506,765,45,810
公投第１４案,新竹市,東區,湖濱里,130,927,238,341,579,17,596
公投第１４案,新竹市,東區,湖濱里,131,1273,238,475,713,21,734
公投第１４案,新竹市,東區,柴橋里,132,1315,229,434,663,35,698
公投第１４案,新竹市,東區,柴橋里,133,1413,292,496,788,26,814
公投第１４案,新竹市,東區,柴橋里,134,1064,225,362,587,26,613
公投第１４案,新竹市,東區,柴橋里,135,1244,305,467,772,15,787
公投第１４案,新竹市,東區,明湖里,136,1160,183,422,605,9,614
公投第１４案,新竹市,東區,明湖里,137,1398,230,452,682,14,696
公投第１４案,新竹市,東區,明湖里,138,1384,197,355,552,20,572
公投第１４案,新竹市,東區,明湖里,139,874,153,354,507,35,542
公投第１４案,新竹市,北區,中央里,140,477,87,163,250,10,260
公投第１４案,新竹市,北區,西門里,141,535,101,205,306,17,323
公投第１４案,新竹市,北區,潛園里,142,746,137,273,410,34,444
公投第１４案,新竹市,北區,石坊里,143,546,91,190,281,17,298
公投第１４案,新竹市,北區,仁德里,144,711,119,296,415,28,443
公投第１４案,新竹市,北區,崇禮里,145,1143,184,376,560,30,590
公投第１４案,新竹市,北區,興南里,146,1370,236,452,688,31,719
公投第１４案,新竹市,北區,育英里,147,1390,252,469,721,34,755
公投第１４案,新竹市,北區,育英里,148,962,184,351,535,20,555
公投第１４案,新竹市,北區,育英里,149,1237,262,408,670,16,686
公投第１４案,新竹市,北區,台溪里,150,1604,278,484,762,34,796
公投第１４案,新竹市,北區,曲溪里,151,758,115,249,364,18,382
公投第１４案,新竹市,北區,曲溪里,152,1320,210,463,673,24,697
公投第１４案,新竹市,北區,曲溪里,153,1519,238,484,722,47,769
公投第１４案,新竹市,北區,曲溪里,154,347,44,85,129,4,133
公投第１４案,新竹市,北區,曲溪里,155,1212,126,554,680,35,715
公投第１４案,新竹市,北區,西雅里,156,1484,259,498,757,38,795
公投第１４案,新竹市,北區,西雅里,157,1428,261,480,741,45,786
公投第１４案,新竹市,北區,客雅里,158,1128,170,429,599,39,638
公投第１４案,新竹市,北區,客雅里,159,638,109,239,348,13,361
公投第１４案,新竹市,北區,中雅里,160,1222,195,478,673,41,714
公投第１４案,新竹市,北區,中雅里,161,1076,206,350,556,16,572
公投第１４案,新竹市,北區,中雅里,162,937,181,395,576,25,601
公投第１４案,新竹市,北區,南勢里,163,1394,218,522,740,35,775
公投第１４案,新竹市,北區,南勢里,164,1568,262,508,770,32,802
公投第１４案,新竹市,北區,南勢里,165,1159,236,435,671,34,705
公投第１４案,新竹市,北區,大鵬里,166,252,36,69,105,0,105
公投第１４案,新竹市,北區,大同里,167,761,163,298,461,20,481
公投第１４案,新竹市,北區,中山里,168,788,155,285,440,31,471
公投第１４案,新竹市,北區,中興里,169,561,108,228,336,26,362
公投第１４案,新竹市,北區,新民里,170,1558,265,507,772,51,823
公投第１４案,新竹市,北區,長和里,171,1398,263,410,673,32,705
公投第１４案,新竹市,北區,北門里,172,957,163,343,506,31,537
公投第１４案,新竹市,北區,民富里,173,1195,211,450,661,26,687
公投第１４案,新竹市,北區,民富里,174,1236,227,363,590,23,613
公投第１４案,新竹市,北區,民富里,175,1255,191,439,630,39,669
公投第１４案,新竹市,北區,民富里,176,1114,210,409,619,22,641
公投第１４案,新竹市,北區,磐石里,177,1396,262,492,754,26,780
公投第１４案,新竹市,北區,磐石里,178,1456,259,540,799,41,840
公投第１４案,新竹市,北區,磐石里,179,1374,245,471,716,27,743
公投第１４案,新竹市,北區,磐石里,180,1070,178,369,547,32,579
公投第１４案,新竹市,北區,新雅里,181,1142,174,422,596,45,641
公投第１４案,新竹市,北區,新雅里,182,1103,184,382,566,21,587
公投第１４案,新竹市,北區,新雅里,183,1190,212,420,632,49,681
公投第１４案,新竹市,北區,新雅里,184,1089,198,459,657,21,678
公投第１４案,新竹市,北區,文雅里,185,1272,212,386,598,21,619
公投第１４案,新竹市,北區,文雅里,186,1306,203,500,703,44,747
公投第１４案,新竹市,北區,文雅里,187,1328,259,456,715,32,747
公投第１４案,新竹市,北區,水田里,188,1457,259,483,742,28,770
公投第１４案,新竹市,北區,水田里,189,1492,279,519,798,34,832
公投第１４案,新竹市,北區,光田里,190,1160,225,439,664,40,704
公投第１４案,新竹市,北區,光田里,191,971,158,370,528,46,574
公投第１４案,新竹市,北區,光華里,192,1401,161,283,444,17,461
公投第１４案,新竹市,北區,光華里,193,1340,296,459,755,24,779
公投第１４案,新竹市,北區,光華里,194,1371,278,503,781,28,809
公投第１４案,新竹市,北區,金華里,195,1267,242,434,676,27,703
公投第１４案,新竹市,北區,金華里,196,1073,234,421,655,25,680
公投第１４案,新竹市,北區,金華里,197,1159,212,442,654,25,679
公投第１４案,新竹市,北區,金華里,198,1294,279,428,707,15,722
公投第１４案,新竹市,北區,湳雅里,199,1442,286,494,780,25,805
公投第１４案,新竹市,北區,湳雅里,200,1270,259,457,716,27,743
公投第１４案,新竹市,北區,金雅里,201,1179,145,569,714,46,760
公投第１４案,新竹市,北區,金雅里,202,949,189,377,566,31,597
公投第１４案,新竹市,北區,湳中里,203,1163,249,396,645,30,675
公投第１４案,新竹市,北區,湳中里,204,1334,273,453,726,16,742
公投第１４案,新竹市,北區,湳中里,205,1415,301,460,761,34,795
公投第１４案,新竹市,北區,湳中里,206,1305,321,454,775,21,796
公投第１４案,新竹市,北區,湳中里,207,1200,256,406,662,20,682
公投第１４案,新竹市,北區,舊社里,208,1106,222,392,614,22,636
公投第１４案,新竹市,北區,舊社里,209,1044,209,399,608,22,630
公投第１４案,新竹市,北區,舊社里,210,1061,225,379,604,26,630
公投第１４案,新竹市,北區,舊社里,211,1518,290,552,842,57,899
公投第１４案,新竹市,北區,舊社里,212,1220,247,475,722,38,760
公投第１４案,新竹市,北區,金竹里,213,1475,321,517,838,16,854
公投第１４案,新竹市,北區,金竹里,214,1373,215,496,711,39,750
公投第１４案,新竹市,北區,金竹里,215,1450,253,560,813,22,835
公投第１４案,新竹市,北區,金竹里,216,1423,271,529,800,30,830
公投第１４案,新竹市,北區,武陵里,217,1059,157,417,574,23,597
公投第１４案,新竹市,北區,武陵里,218,1130,175,476,651,35,686
公投第１４案,新竹市,北區,武陵里,219,1208,226,493,719,31,750
公投第１４案,新竹市,北區,武陵里,220,1226,185,563,748,15,763
公投第１４案,新竹市,北區,福林里,221,1175,243,407,650,29,679
公投第１４案,新竹市,北區,福林里,222,1371,283,486,769,23,792
公投第１４案,新竹市,北區,福林里,223,1306,211,465,676,46,722
公投第１４案,新竹市,北區,境福里,224,1340,203,489,692,25,717
公投第１４案,新竹市,北區,境福里,225,1111,227,412,639,46,685
公投第１４案,新竹市,北區,境福里,226,1197,242,494,736,31,767
公投第１４案,新竹市,北區,境福里,227,1008,143,405,548,30,578
公投第１４案,新竹市,北區,士林里,228,946,173,329,502,21,523
公投第１４案,新竹市,北區,士林里,229,705,122,268,390,33,423
公投第１４案,新竹市,北區,古賢里,230,848,138,314,452,55,507
公投第１４案,新竹市,北區,南寮里,231,1295,220,448,668,25,693
公投第１４案,新竹市,北區,南寮里,232,1467,222,499,721,33,754
公投第１４案,新竹市,北區,南寮里,233,1659,254,497,751,30,781
公投第１４案,新竹市,北區,南寮里,234,1297,216,436,652,34,686
公投第１４案,新竹市,北區,康樂里,235,1374,249,482,731,60,791
公投第１４案,新竹市,北區,康樂里,236,1457,274,520,794,52,846
公投第１４案,新竹市,北區,中寮里,237,1072,180,421,601,29,630
公投第１４案,新竹市,北區,中寮里,238,1350,228,456,684,43,727
公投第１４案,新竹市,北區,中寮里,239,971,209,381,590,21,611
公投第１４案,新竹市,北區,海濱里,240,1450,234,558,792,59,851
公投第１４案,新竹市,北區,海濱里,241,895,135,351,486,27,513
公投第１４案,新竹市,北區,海濱里,242,1378,239,484,723,33,756
公投第１４案,新竹市,北區,港北里,243,1609,246,530,776,69,845
公投第１４案,新竹市,北區,舊港里,244,594,101,216,317,30,347
公投第１４案,新竹市,香山區,頂埔里,245,1443,243,494,737,47,784
公投第１４案,新竹市,香山區,頂埔里,246,1241,300,359,659,26,685
公投第１４案,新竹市,香山區,頂埔里,247,1194,204,428,632,27,659
公投第１４案,新竹市,香山區,頂埔里,248,1081,220,373,593,12,605
公投第１４案,新竹市,香山區,頂福里,249,807,145,309,454,21,475
公投第１４案,新竹市,香山區,頂福里,250,1760,281,632,913,47,960
公投第１４案,新竹市,香山區,頂福里,251,1635,293,582,875,39,914
公投第１４案,新竹市,香山區,中埔里,252,1473,273,540,813,42,855
公投第１４案,新竹市,香山區,中埔里,253,1408,271,546,817,15,832
公投第１４案,新竹市,香山區,牛埔里,254,1318,196,419,615,25,640
公投第１４案,新竹市,香山區,牛埔里,255,1337,254,471,725,26,751
公投第１４案,新竹市,香山區,牛埔里,256,1862,285,627,912,25,937
公投第１４案,新竹市,香山區,埔前里,257,1067,204,370,574,21,595
公投第１４案,新竹市,香山區,埔前里,258,863,162,333,495,36,531
公投第１４案,新竹市,香山區,埔前里,259,1198,220,466,686,55,741
公投第１４案,新竹市,香山區,樹下里,260,1138,211,437,648,46,694
公投第１４案,新竹市,香山區,樹下里,261,957,177,398,575,48,623
公投第１４案,新竹市,香山區,浸水里,262,1348,220,516,736,65,801
公投第１４案,新竹市,香山區,浸水里,263,1023,205,428,633,54,687
公投第１４案,新竹市,香山區,虎林里,264,970,145,377,522,32,554
公投第１４案,新竹市,香山區,虎林里,265,1318,231,489,720,43,763
公投第１４案,新竹市,香山區,虎山里,266,1088,166,401,567,41,608
公投第１４案,新竹市,香山區,虎山里,267,903,153,289,442,16,458
公投第１４案,新竹市,香山區,虎山里,268,1012,192,363,555,36,591
公投第１４案,新竹市,香山區,虎山里,269,1014,146,384,530,40,570
公投第１４案,新竹市,香山區,虎山里,270,1238,215,472,687,27,714
公投第１４案,新竹市,香山區,港南里,271,1182,187,411,598,60,658
公投第１４案,新竹市,香山區,港南里,272,1331,225,572,797,57,854
公投第１４案,新竹市,香山區,東香里,273,976,245,366,611,21,632
公投第１４案,新竹市,香山區,東香里,274,834,142,297,439,15,454
公投第１４案,新竹市,香山區,東香里,275,919,161,339,500,29,529
公投第１４案,新竹市,香山區,東香里,276,1188,250,418,668,35,703
公投第１４案,新竹市,香山區,香村里,277,1086,174,409,583,44,627
公投第１４案,新竹市,香山區,香村里,278,1144,234,445,679,33,712
公投第１４案,新竹市,香山區,香村里,279,1112,208,414,622,30,652
公投第１４案,新竹市,香山區,香山里,280,1476,275,542,817,37,854
公投第１４案,新竹市,香山區,香山里,281,1291,221,468,689,32,721
公投第１４案,新竹市,香山區,香山里,282,1464,269,585,854,50,904
公投第１４案,新竹市,香山區,大庄里,283,1427,231,566,797,51,848
公投第１４案,新竹市,香山區,大庄里,284,1336,135,477,612,31,643
公投第１４案,新竹市,香山區,美山里,285,1131,173,359,532,35,567
公投第１４案,新竹市,香山區,朝山里,286,1070,195,398,593,56,649
公投第１４案,新竹市,香山區,朝山里,287,1006,164,399,563,57,620
公投第１４案,新竹市,香山區,海山里,288,1223,157,393,550,30,580
公投第１４案,新竹市,香山區,海山里,289,1119,195,415,610,24,634
公投第１４案,新竹市,香山區,鹽水里,290,1400,212,447,659,40,699
公投第１４案,新竹市,香山區,內湖里,291,1627,234,513,747,31,778
公投第１４案,新竹市,香山區,內湖里,292,1289,207,403,610,40,650
公投第１４案,新竹市,香山區,內湖里,293,1409,213,456,669,46,715
公投第１４案,新竹市,香山區,南港里,294,814,126,268,394,29,423
公投第１４案,新竹市,香山區,中隘里,295,719,107,271,378,26,404
公投第１４案,新竹市,香山區,中隘里,296,1065,174,330,504,16,520
公投第１４案,新竹市,香山區,南隘里,297,776,121,278,399,35,434
公投第１４案,新竹市,香山區,大湖里,298,890,154,335,489,26,515
公投第１４案,新竹市,香山區,茄苳里,299,896,127,319,446,22,468
公投第１４案,嘉義市,東區,短竹里,1,1025,207,362,569,22,591
公投第１４案,嘉義市,東區,短竹里,2,1276,235,431,666,15,681
公投第１４案,嘉義市,東區,蘭潭里,3,974,137,332,469,30,499
公投第１４案,嘉義市,東區,蘭潭里,4,1175,224,466,690,32,722
公投第１４案,嘉義市,東區,東川里,5,702,143,273,416,22,438
公投第１４案,嘉義市,東區,東川里,6,1092,195,382,577,27,604
公投第１４案,嘉義市,東區,鹿寮里,7,1023,145,316,461,21,482
公投第１４案,嘉義市,東區,盧厝里,8,1816,277,613,890,46,936
公投第１４案,嘉義市,東區,文雅里,9,1936,370,659,1029,37,1066
公投第１４案,嘉義市,東區,文雅里,10,1698,363,584,947,16,963
公投第１４案,嘉義市,東區,王田里,11,1221,248,454,702,19,721
公投第１４案,嘉義市,東區,王田里,12,1113,216,399,615,13,628
公投第１４案,嘉義市,東區,長竹里,13,1452,278,528,806,23,829
公投第１４案,嘉義市,東區,長竹里,14,1395,277,552,829,29,858
公投第１４案,嘉義市,東區,後庄里,15,1453,243,459,702,42,744
公投第１４案,嘉義市,東區,後庄里,16,1094,175,397,572,19,591
公投第１４案,嘉義市,東區,後庄里,17,1420,236,534,770,30,800
公投第１４案,嘉義市,東區,新店里,18,1552,273,603,876,38,914
公投第１４案,嘉義市,東區,新店里,19,1558,296,547,843,48,891
公投第１４案,嘉義市,東區,新店里,20,1062,181,411,592,30,622
公投第１４案,嘉義市,東區,圳頭里,21,1199,174,438,612,39,651
公投第１４案,嘉義市,東區,圳頭里,22,1236,180,480,660,25,685
公投第１４案,嘉義市,東區,圳頭里,23,890,151,323,474,18,492
公投第１４案,嘉義市,東區,圳頭里,24,880,153,353,506,29,535
公投第１４案,嘉義市,東區,中山里,25,1189,230,416,646,14,660
公投第１４案,嘉義市,東區,中山里,26,669,123,260,383,14,397
公投第１４案,嘉義市,東區,太平里,27,1435,271,486,757,32,789
公投第１４案,嘉義市,東區,太平里,28,1349,265,522,787,28,815
公投第１４案,嘉義市,東區,太平里,29,1455,260,488,748,22,770
公投第１４案,嘉義市,東區,東興里,30,915,163,347,510,24,534
公投第１４案,嘉義市,東區,東興里,31,952,174,340,514,22,536
公投第１４案,嘉義市,東區,華南里,32,941,153,335,488,43,531
公投第１４案,嘉義市,東區,華南里,33,1080,208,349,557,25,582
公投第１４案,嘉義市,東區,中央里,34,1157,173,384,557,24,581
公投第１４案,嘉義市,東區,中央里,35,1053,214,370,584,25,609
公投第１４案,嘉義市,東區,朝陽里,36,967,161,307,468,22,490
公投第１４案,嘉義市,東區,朝陽里,37,1091,303,258,561,25,586
公投第１４案,嘉義市,東區,民族里,38,961,160,386,546,31,577
公投第１４案,嘉義市,東區,民族里,39,863,111,224,335,20,355
公投第１４案,嘉義市,東區,過溝里,40,1023,188,385,573,41,614
公投第１４案,嘉義市,東區,過溝里,41,1078,180,397,577,66,643
公投第１４案,嘉義市,東區,新開里,42,938,167,324,491,16,507
公投第１４案,嘉義市,東區,新開里,43,1049,182,381,563,20,583
公投第１４案,嘉義市,東區,宣信里,44,1360,206,445,651,61,712
公投第１４案,嘉義市,東區,興南里,45,1615,273,465,738,63,801
公投第１４案,嘉義市,東區,豐年里,46,1267,222,425,647,34,681
公投第１４案,嘉義市,東區,芳草里,47,1579,215,499,714,50,764
公投第１４案,嘉義市,東區,芳草里,48,1831,317,554,871,71,942
公投第１４案,嘉義市,東區,芳安里,49,977,164,382,546,26,572
公投第１４案,嘉義市,東區,芳安里,50,1169,208,390,598,28,626
公投第１４案,嘉義市,東區,頂寮里,51,1238,220,452,672,66,738
公投第１４案,嘉義市,東區,頂寮里,52,1266,221,471,692,18,710
公投第１４案,嘉義市,東區,安寮里,53,1429,175,464,639,43,682
公投第１４案,嘉義市,東區,安寮里,54,1288,215,485,700,14,714
公投第１４案,嘉義市,東區,安業里,55,980,185,320,505,37,542
公投第１４案,嘉義市,東區,安業里,56,922,157,304,461,20,481
公投第１４案,嘉義市,東區,興村里,57,1133,192,439,631,32,663
公投第１４案,嘉義市,東區,興村里,58,1235,231,422,653,42,695
公投第１４案,嘉義市,東區,興村里,59,1525,281,509,790,19,809
公投第１４案,嘉義市,東區,興安里,60,1170,198,364,562,44,606
公投第１４案,嘉義市,東區,興安里,61,1177,232,459,691,51,742
公投第１４案,嘉義市,東區,興仁里,62,1207,197,436,633,50,683
公投第１４案,嘉義市,東區,興仁里,63,1272,298,400,698,33,731
公投第１４案,嘉義市,東區,興仁里,64,1188,193,416,609,67,676
公投第１４案,嘉義市,東區,北門里,65,1172,200,373,573,21,594
公投第１４案,嘉義市,東區,北門里,66,1020,191,369,560,42,602
公投第１４案,嘉義市,東區,林森里,67,1332,269,461,730,35,765
公投第１４案,嘉義市,東區,林森里,68,1011,211,377,588,35,623
公投第１４案,嘉義市,東區,中庄里,69,1682,267,555,822,60,882
公投第１４案,嘉義市,東區,中庄里,70,1567,260,551,811,52,863
公投第１４案,嘉義市,東區,頂庄里,71,1207,243,416,659,17,676
公投第１４案,嘉義市,東區,頂庄里,72,981,183,388,571,21,592
公投第１４案,嘉義市,東區,義教里,73,1395,268,450,718,32,750
公投第１４案,嘉義市,東區,義教里,74,1434,234,436,670,22,692
公投第１４案,嘉義市,東區,仁義里,75,1404,231,396,627,18,645
公投第１４案,嘉義市,東區,仁義里,76,1428,261,515,776,20,796
公投第１４案,嘉義市,東區,後湖里,77,1823,270,495,765,18,783
公投第１４案,嘉義市,東區,後湖里,78,1570,260,484,744,36,780
公投第１４案,嘉義市,東區,荖藤里,79,1282,215,426,641,48,689
公投第１４案,嘉義市,東區,荖藤里,80,1571,269,612,881,44,925
公投第１４案,嘉義市,東區,荖藤里,81,1533,262,508,770,25,795
公投第１４案,嘉義市,西區,書院里,82,885,137,329,466,18,484
公投第１４案,嘉義市,西區,書院里,83,1109,187,358,545,60,605
公投第１４案,嘉義市,西區,永和里,84,1020,146,345,491,44,535
公投第１４案,嘉義市,西區,永和里,85,925,158,383,541,42,583
公投第１４案,嘉義市,西區,新富里,86,1671,266,478,744,27,771
公投第１４案,嘉義市,西區,文化里,87,1215,212,445,657,22,679
公投第１４案,嘉義市,西區,文化里,88,1036,199,342,541,20,561
公投第１４案,嘉義市,西區,西榮里,89,1129,190,365,555,28,583
公投第１４案,嘉義市,西區,西榮里,90,1127,180,394,574,30,604
公投第１４案,嘉義市,西區,番社里,91,1415,275,478,753,42,795
公投第１４案,嘉義市,西區,國華里,92,1366,197,488,685,24,709
公投第１４案,嘉義市,西區,大溪里,93,1053,178,419,597,48,645
公投第１４案,嘉義市,西區,大溪里,94,1067,161,411,572,18,590
公投第１４案,嘉義市,西區,磚磘里,95,1575,231,502,733,28,761
公投第１４案,嘉義市,西區,磚磘里,96,1865,310,633,943,39,982
公投第１４案,嘉義市,西區,福全里,97,1196,206,387,593,31,624
公投第１４案,嘉義市,西區,福全里,98,1280,215,400,615,21,636
公投第１４案,嘉義市,西區,福全里,99,1629,268,566,834,44,878
公投第１４案,嘉義市,西區,福安里,100,1393,247,491,738,55,793
公投第１４案,嘉義市,西區,福安里,101,1077,200,409,609,39,648
公投第１４案,嘉義市,西區,福安里,102,1694,296,488,784,17,801
公投第１４案,嘉義市,西區,新西里,103,841,173,275,448,78,526
公投第１４案,嘉義市,西區,新西里,104,1183,182,405,587,4,591
公投第１４案,嘉義市,西區,港坪里,105,1000,194,418,612,17,629
公投第１４案,嘉義市,西區,港坪里,106,1095,203,431,634,22,656
公投第１４案,嘉義市,西區,港坪里,107,1256,258,466,724,27,751
公投第１４案,嘉義市,西區,頭港里,108,962,169,350,519,43,562
公投第１４案,嘉義市,西區,頭港里,109,865,188,358,546,10,556
公投第１４案,嘉義市,西區,西平里,110,1396,203,564,767,53,820
公投第１４案,嘉義市,西區,西平里,111,1799,300,641,941,47,988
公投第１４案,嘉義市,西區,劉厝里,112,1505,223,519,742,20,762
公投第１４案,嘉義市,西區,劉厝里,113,1698,257,600,857,43,900
公投第１４案,嘉義市,西區,劉厝里,114,1854,289,688,977,28,1005
公投第１４案,嘉義市,西區,劉厝里,115,1537,225,452,677,9,686
公投第１４案,嘉義市,西區,自強里,116,1604,270,498,768,56,824
公投第１４案,嘉義市,西區,美源里,117,944,163,388,551,48,599
公投第１４案,嘉義市,西區,美源里,118,1627,251,625,876,55,931
公投第１４案,嘉義市,西區,美源里,119,1144,207,445,652,28,680
公投第１４案,嘉義市,西區,湖內里,120,1362,217,486,703,45,748
公投第１４案,嘉義市,西區,湖內里,121,1279,231,475,706,32,738
公投第１４案,嘉義市,西區,湖內里,122,1702,266,626,892,54,946
公投第１４案,嘉義市,西區,獅子里,123,1358,255,508,763,41,804
公投第１４案,嘉義市,西區,獅子里,124,1360,234,526,760,72,832
公投第１４案,嘉義市,西區,紅瓦里,125,1589,248,606,854,54,908
公投第１４案,嘉義市,西區,光路里,126,1280,217,513,730,35,765
公投第１４案,嘉義市,西區,光路里,127,1220,186,397,583,26,609
公投第１４案,嘉義市,西區,光路里,128,1172,199,468,667,23,690
公投第１４案,嘉義市,西區,光路里,129,1320,241,463,704,38,742
公投第１４案,嘉義市,西區,福民里,130,1185,243,494,737,29,766
公投第１４案,嘉義市,西區,福民里,131,1278,242,513,755,32,787
公投第１４案,嘉義市,西區,福民里,132,1394,210,396,606,25,631
公投第１４案,嘉義市,西區,福民里,133,1540,270,571,841,41,882
公投第１４案,嘉義市,西區,車店里,134,1548,263,548,811,63,874
公投第１４案,嘉義市,西區,車店里,135,1295,224,435,659,38,697
公投第１４案,嘉義市,西區,車店里,136,1318,225,528,753,44,797
公投第１４案,嘉義市,西區,車店里,137,1545,247,568,815,46,861
公投第１４案,嘉義市,西區,垂楊里,138,736,144,215,359,21,380
公投第１４案,嘉義市,西區,垂楊里,139,1168,174,409,583,28,611
公投第１４案,嘉義市,西區,培元里,140,756,146,313,459,27,486
公投第１４案,嘉義市,西區,培元里,141,869,121,353,474,18,492
公投第１４案,嘉義市,西區,育英里,142,983,182,363,545,41,586
公投第１４案,嘉義市,西區,育英里,143,828,119,329,448,29,477
公投第１４案,嘉義市,西區,致遠里,144,1775,144,791,935,42,977
公投第１４案,嘉義市,西區,翠岱里,145,1419,185,550,735,31,766
公投第１４案,嘉義市,西區,導明里,146,779,129,266,395,21,416
公投第１４案,嘉義市,西區,導明里,147,855,136,297,433,14,447
公投第１４案,嘉義市,西區,北榮里,148,1146,206,418,624,49,673
公投第１４案,嘉義市,西區,北榮里,149,1111,169,433,602,34,636
公投第１４案,嘉義市,西區,慶安里,150,767,142,316,458,38,496
公投第１４案,嘉義市,西區,慶安里,151,817,131,265,396,19,415
公投第１４案,嘉義市,西區,香湖里,152,770,132,285,417,35,452
公投第１４案,嘉義市,西區,重興里,153,1135,156,357,513,14,527
公投第１４案,嘉義市,西區,重興里,154,835,150,243,393,63,456
公投第１４案,嘉義市,西區,後驛里,155,1182,154,392,546,32,578
公投第１４案,嘉義市,西區,後驛里,156,944,132,316,448,27,475
公投第１４案,嘉義市,西區,湖邊里,157,997,181,309,490,39,529
公投第１４案,嘉義市,西區,湖邊里,158,1074,180,390,570,26,596
公投第１４案,嘉義市,西區,竹圍里,159,1460,235,410,645,16,661
公投第１４案,嘉義市,西區,竹圍里,160,1352,207,466,673,48,721
公投第１４案,嘉義市,西區,竹圍里,161,1499,273,500,773,37,810
公投第１４案,嘉義市,西區,保生里,162,1262,234,417,651,66,717
公投第１４案,嘉義市,西區,保生里,163,1299,214,461,675,25,700
公投第１４案,嘉義市,西區,保生里,164,1734,259,599,858,44,902
公投第１４案,嘉義市,西區,保安里,165,1674,234,561,795,28,823
公投第１４案,嘉義市,西區,保安里,166,1540,294,475,769,23,792
公投第１４案,嘉義市,西區,北新里,167,1056,189,426,615,17,632
公投第１４案,嘉義市,西區,新厝里,168,1467,260,528,788,70,858
公投第１４案,嘉義市,西區,新厝里,169,1431,226,463,689,56,745
公投第１４案,嘉義市,西區,新厝里,170,1234,223,494,717,57,774
公投第１４案,嘉義市,西區,保福里,171,1266,211,444,655,22,677
公投第１４案,嘉義市,西區,保福里,172,1211,231,441,672,18,690
公投第１４案,嘉義市,西區,保福里,173,1121,208,422,630,14,644
公投第１４案,嘉義市,西區,竹村里,174,1155,172,396,568,21,589
公投第１４案,嘉義市,西區,北湖里,175,1546,269,559,828,77,905
公投第１４案,嘉義市,西區,北湖里,176,1322,204,468,672,24,696
公投第１４案,嘉義市,西區,下埤里,177,1549,231,578,809,76,885
公投第１４案,臺北市,北投區,建民里,1,1313,276,474,750,53,803
公投第１４案,臺北市,北投區,建民里,2,1403,335,500,835,35,870
公投第１４案,臺北市,北投區,建民里,3,1081,269,362,631,35,666
公投第１４案,臺北市,北投區,文林里,4,1209,276,405,681,50,731
公投第１４案,臺北市,北投區,文林里,5,1326,301,429,730,48,778
公投第１４案,臺北市,北投區,文林里,6,1263,295,431,726,43,769
公投第１４案,臺北市,北投區,石牌里,7,1580,362,550,912,55,967
公投第１４案,臺北市,北投區,石牌里,8,1577,322,569,891,43,934
公投第１４案,臺北市,北投區,石牌里,9,1483,324,512,836,50,886
公投第１４案,臺北市,北投區,福興里,10,1461,307,485,792,32,824
公投第１４案,臺北市,北投區,福興里,11,1466,310,476,786,51,837
公投第１４案,臺北市,北投區,福興里,12,1620,335,587,922,45,967
公投第１４案,臺北市,北投區,福興里,13,1543,294,500,794,32,826
公投第１４案,臺北市,北投區,榮光里,14,1513,273,493,766,56,822
公投第１４案,臺北市,北投區,榮光里,15,1534,300,560,860,33,893
公投第１４案,臺北市,北投區,榮光里,16,1650,339,584,923,61,984
公投第１４案,臺北市,北投區,榮光里,17,1533,338,519,857,39,896
公投第１４案,臺北市,北投區,榮華里,18,1702,344,557,901,37,938
公投第１４案,臺北市,北投區,榮華里,19,1721,432,511,943,35,978
公投第１４案,臺北市,北投區,榮華里,20,1575,402,519,921,44,965
公投第１４案,臺北市,北投區,榮華里,21,1530,314,258,572,62,634
公投第１４案,臺北市,北投區,裕民里,22,1728,359,605,964,50,1014
公投第１４案,臺北市,北投區,裕民里,23,1702,328,580,908,58,966
公投第１４案,臺北市,北投區,裕民里,24,1696,350,556,906,57,963
公投第１４案,臺北市,北投區,裕民里,25,1684,260,498,758,34,792
公投第１４案,臺北市,北投區,振華里,26,1717,382,609,991,39,1030
公投第１４案,臺北市,北投區,振華里,27,1605,359,545,904,38,942
公投第１４案,臺北市,北投區,振華里,28,1723,324,608,932,58,990
公投第１４案,臺北市,北投區,振華里,29,1597,367,585,952,39,991
公投第１４案,臺北市,北投區,永和里,30,1700,349,594,943,36,979
公投第１４案,臺北市,北投區,永和里,31,1544,346,430,776,35,811
公投第１４案,臺北市,北投區,永和里,32,1635,318,519,837,39,876
公投第１４案,臺北市,北投區,永和里,33,1495,330,520,850,23,873
公投第１４案,臺北市,北投區,永和里,34,1619,343,552,895,43,938
公投第１４案,臺北市,北投區,永欣里,35,1683,407,517,924,35,959
公投第１４案,臺北市,北投區,永欣里,36,1662,339,525,864,38,902
公投第１４案,臺北市,北投區,永欣里,37,1850,358,525,883,24,907
公投第１４案,臺北市,北投區,永欣里,38,1674,370,487,857,19,876
公投第１４案,臺北市,北投區,永明里,39,1511,314,557,871,47,918
公投第１４案,臺北市,北投區,永明里,40,1393,268,503,771,19,790
公投第１４案,臺北市,北投區,永明里,41,1279,290,475,765,45,810
公投第１４案,臺北市,北投區,東華里,42,1122,241,366,607,29,636
公投第１４案,臺北市,北投區,東華里,43,1238,296,509,805,47,852
公投第１４案,臺北市,北投區,東華里,44,1477,334,526,860,59,919
公投第１４案,臺北市,北投區,吉利里,45,1495,331,538,869,43,912
公投第１４案,臺北市,北投區,吉利里,46,1469,337,551,888,40,928
公投第１４案,臺北市,北投區,吉利里,47,1462,274,540,814,45,859
公投第１４案,臺北市,北投區,吉利里,48,1431,275,531,806,47,853
公投第１４案,臺北市,北投區,吉慶里,49,1486,356,477,833,32,865
公投第１４案,臺北市,北投區,吉慶里,50,1449,321,507,828,55,883
公投第１４案,臺北市,北投區,吉慶里,51,1456,342,489,831,28,859
公投第１４案,臺北市,北投區,尊賢里,52,1311,274,453,727,36,763
公投第１４案,臺北市,北投區,尊賢里,53,1356,272,483,755,51,806
公投第１４案,臺北市,北投區,尊賢里,54,1338,299,456,755,27,782
公投第１４案,臺北市,北投區,立賢里,55,1525,324,524,848,34,882
公投第１４案,臺北市,北投區,立賢里,56,1620,338,522,860,31,891
公投第１４案,臺北市,北投區,立賢里,57,1499,308,484,792,20,812
公投第１４案,臺北市,北投區,立農里,58,1497,299,566,865,31,896
公投第１４案,臺北市,北投區,立農里,59,1624,355,520,875,43,918
公投第１４案,臺北市,北投區,立農里,60,1536,305,493,798,56,854
公投第１４案,臺北市,北投區,立農里,61,1469,346,517,863,59,922
公投第１４案,臺北市,北投區,立農里,62,1598,318,529,847,45,892
公投第１４案,臺北市,北投區,八仙里,63,1690,348,551,899,34,933
公投第１４案,臺北市,北投區,八仙里,64,1599,255,526,781,82,863
公投第１４案,臺北市,北投區,八仙里,65,1634,355,533,888,49,937
公投第１４案,臺北市,北投區,洲美里,66,1660,335,509,844,42,886
公投第１４案,臺北市,北投區,奇岩里,67,1900,403,548,951,50,1001
公投第１４案,臺北市,北投區,奇岩里,68,1797,399,585,984,50,1034
公投第１４案,臺北市,北投區,奇岩里,69,1832,392,628,1020,46,1066
公投第１４案,臺北市,北投區,奇岩里,70,1784,370,619,989,56,1045
公投第１４案,臺北市,北投區,奇岩里,71,1732,366,593,959,57,1016
公投第１４案,臺北市,北投區,清江里,72,2035,206,317,523,38,561
公投第１４案,臺北市,北投區,清江里,73,1504,329,472,801,57,858
公投第１４案,臺北市,北投區,清江里,74,1683,317,624,941,63,1004
公投第１４案,臺北市,北投區,清江里,75,1635,318,516,834,70,904
公投第１４案,臺北市,北投區,清江里,76,1613,336,524,860,57,917
公投第１４案,臺北市,北投區,中央里,77,1483,303,471,774,26,800
公投第１４案,臺北市,北投區,中央里,78,1500,301,505,806,41,847
公投第１４案,臺北市,北投區,中央里,79,1483,334,494,828,45,873
公投第１４案,臺北市,北投區,中央里,80,1544,313,496,809,65,874
公投第１４案,臺北市,北投區,中央里,81,1532,278,448,726,50,776
公投第１４案,臺北市,北投區,長安里,82,1819,372,589,961,66,1027
公投第１４案,臺北市,北投區,長安里,83,1863,306,589,895,62,957
公投第１４案,臺北市,北投區,長安里,84,1872,377,537,914,25,939
公投第１４案,臺北市,北投區,大同里,85,1627,309,588,897,48,945
公投第１４案,臺北市,北投區,大同里,86,1696,316,559,875,25,900
公投第１４案,臺北市,北投區,大同里,87,1841,401,583,984,43,1027
公投第１４案,臺北市,北投區,溫泉里,88,1324,303,411,714,39,753
公投第１４案,臺北市,北投區,溫泉里,89,1504,285,511,796,26,822
公投第１４案,臺北市,北投區,溫泉里,90,1511,305,519,824,35,859
公投第１４案,臺北市,北投區,溫泉里,91,1615,352,563,915,40,955
公投第１４案,臺北市,北投區,林泉里,92,1270,245,395,640,31,671
公投第１４案,臺北市,北投區,林泉里,93,1492,294,420,714,34,748
公投第１４案,臺北市,北投區,中心里,94,1429,318,438,756,26,782
公投第１４案,臺北市,北投區,中心里,95,1567,330,467,797,21,818
公投第１４案,臺北市,北投區,中心里,96,1388,286,466,752,34,786
公投第１４案,臺北市,北投區,中心里,97,1448,295,458,753,15,768
公投第１４案,臺北市,北投區,中庸里,98,1356,261,433,694,39,733
公投第１４案,臺北市,北投區,中庸里,99,1308,253,450,703,34,737
公投第１４案,臺北市,北投區,中庸里,100,1165,256,416,672,41,713
公投第１４案,臺北市,北投區,開明里,101,1429,281,528,809,57,866
公投第１４案,臺北市,北投區,開明里,102,1472,260,523,783,23,806
公投第１４案,臺北市,北投區,開明里,103,1508,350,563,913,35,948
公投第１４案,臺北市,北投區,開明里,104,1480,268,525,793,47,840
公投第１４案,臺北市,北投區,中和里,105,1142,237,352,589,32,621
公投第１４案,臺北市,北投區,中和里,106,1554,304,496,800,29,829
公投第１４案,臺北市,北投區,中和里,107,1669,357,582,939,63,1002
公投第１４案,臺北市,北投區,智仁里,108,1823,327,640,967,50,1017
公投第１４案,臺北市,北投區,智仁里,109,1739,338,575,913,51,964
公投第１４案,臺北市,北投區,智仁里,110,1771,321,566,887,56,943
公投第１４案,臺北市,北投區,秀山里,111,1468,240,489,729,48,777
公投第１４案,臺北市,北投區,秀山里,112,1469,282,511,793,32,825
公投第１４案,臺北市,北投區,文化里,113,1094,222,459,681,30,711
公投第１４案,臺北市,北投區,文化里,114,1101,198,461,659,35,694
公投第１４案,臺北市,北投區,文化里,115,1422,296,536,832,35,867
公投第１４案,臺北市,北投區,豐年里,116,1390,328,404,732,46,778
公投第１４案,臺北市,北投區,豐年里,117,1307,278,463,741,42,783
公投第１４案,臺北市,北投區,豐年里,118,1215,284,429,713,59,772
公投第１４案,臺北市,北投區,稻香里,119,1642,316,528,844,58,902
公投第１４案,臺北市,北投區,稻香里,120,1623,288,531,819,43,862
公投第１４案,臺北市,北投區,稻香里,121,1621,334,520,854,51,905
公投第１４案,臺北市,北投區,桃源里,122,1367,314,428,742,19,761
公投第１４案,臺北市,北投區,桃源里,123,1309,284,403,687,37,724
公投第１４案,臺北市,北投區,桃源里,124,1356,313,447,760,27,787
公投第１４案,臺北市,北投區,桃源里,125,1365,287,444,731,37,768
公投第１４案,臺北市,北投區,一德里,126,1613,347,499,846,29,875
公投第１４案,臺北市,北投區,一德里,127,1590,308,441,749,34,783
公投第１４案,臺北市,北投區,一德里,128,1662,339,584,923,48,971
公投第１４案,臺北市,北投區,一德里,129,1622,370,511,881,57,938
公投第１４案,臺北市,北投區,關渡里,130,1820,404,569,973,29,1002
公投第１４案,臺北市,北投區,關渡里,131,1615,312,583,895,52,947
公投第１４案,臺北市,北投區,關渡里,132,1612,243,448,691,64,755
公投第１４案,臺北市,北投區,關渡里,133,1652,342,521,863,61,924
公投第１４案,臺北市,北投區,關渡里,134,1666,345,576,921,21,942
公投第１４案,臺北市,北投區,關渡里,135,1641,328,528,856,45,901
公投第１４案,臺北市,北投區,泉源里,136,528,141,163,304,19,323
公投第１４案,臺北市,北投區,泉源里,137,1642,274,452,726,61,787
公投第１４案,臺北市,北投區,湖山里,138,829,156,278,434,37,471
公投第１４案,臺北市,北投區,湖山里,139,690,101,256,357,26,383
公投第１４案,臺北市,北投區,大屯里,140,1067,180,361,541,43,584
公投第１４案,臺北市,北投區,湖田里,141,892,153,302,455,52,507
公投第１４案,臺北市,士林區,仁勇里,142,1695,362,544,906,55,961
公投第１４案,臺北市,士林區,仁勇里,143,1720,362,584,946,79,1025
公投第１４案,臺北市,士林區,義信里,144,1288,239,442,681,62,743
公投第１４案,臺北市,士林區,義信里,145,1546,314,508,822,46,868
公投第１４案,臺北市,士林區,福林里,146,652,148,241,389,22,411
公投第１４案,臺北市,士林區,福林里,147,870,176,281,457,23,480
公投第１４案,臺北市,士林區,福林里,148,1137,248,430,678,41,719
公投第１４案,臺北市,士林區,福德里,149,1050,223,402,625,40,665
公投第１４案,臺北市,士林區,福德里,150,1031,209,387,596,46,642
公投第１４案,臺北市,士林區,福德里,151,1075,246,397,643,18,661
公投第１４案,臺北市,士林區,福德里,152,2175,201,284,485,36,521
公投第１４案,臺北市,士林區,福志里,153,1775,324,566,890,66,956
公投第１４案,臺北市,士林區,福志里,154,1669,352,586,938,45,983
公投第１４案,臺北市,士林區,福志里,155,1665,394,557,951,60,1011
公投第１４案,臺北市,士林區,福志里,156,1648,391,588,979,47,1026
公投第１４案,臺北市,士林區,舊佳里,157,1246,241,462,703,23,726
公投第１４案,臺北市,士林區,舊佳里,158,1419,308,459,767,53,820
公投第１４案,臺北市,士林區,舊佳里,159,1327,286,436,722,58,780
公投第１４案,臺北市,士林區,舊佳里,160,1573,359,557,916,62,978
公投第１４案,臺北市,士林區,福佳里,161,1470,303,516,819,55,874
公投第１４案,臺北市,士林區,福佳里,162,1775,361,625,986,34,1020
公投第１４案,臺北市,士林區,福佳里,163,1692,390,569,959,37,996
公投第１４案,臺北市,士林區,福佳里,164,1842,365,657,1022,53,1075
公投第１４案,臺北市,士林區,後港里,165,1166,248,426,674,42,716
公投第１４案,臺北市,士林區,後港里,166,1687,309,513,822,68,890
公投第１４案,臺北市,士林區,後港里,167,1624,350,530,880,49,929
公投第１４案,臺北市,士林區,後港里,168,1477,328,523,851,77,928
公投第１４案,臺北市,士林區,後港里,169,1250,295,435,730,39,769
公投第１４案,臺北市,士林區,福中里,170,1434,313,477,790,66,856
公投第１４案,臺北市,士林區,福中里,171,1452,319,493,812,61,873
公投第１４案,臺北市,士林區,福中里,172,1533,351,556,907,54,961
公投第１４案,臺北市,士林區,福中里,173,1515,328,540,868,62,930
公投第１４案,臺北市,士林區,前港里,174,1203,291,396,687,44,731
公投第１４案,臺北市,士林區,前港里,175,1487,357,510,867,60,927
公投第１４案,臺北市,士林區,前港里,176,1252,255,437,692,37,729
公投第１４案,臺北市,士林區,百齡里,177,1536,300,543,843,39,882
公投第１４案,臺北市,士林區,百齡里,178,1556,326,575,901,48,949
公投第１４案,臺北市,士林區,百齡里,179,1511,340,503,843,61,904
公投第１４案,臺北市,士林區,百齡里,180,1572,400,542,942,55,997
公投第１４案,臺北市,士林區,承德里,181,1668,319,593,912,57,969
公投第１４案,臺北市,士林區,承德里,182,1685,319,568,887,82,969
公投第１４案,臺北市,士林區,承德里,183,1568,347,507,854,53,907
公投第１４案,臺北市,士林區,福華里,184,1327,261,422,683,49,732
公投第１４案,臺北市,士林區,福華里,185,1338,260,443,703,60,763
公投第１４案,臺北市,士林區,福華里,186,1515,288,457,745,61,806
公投第１４案,臺北市,士林區,福華里,187,1452,325,503,828,48,876
公投第１４案,臺北市,士林區,明勝里,188,1448,307,487,794,44,838
公投第１４案,臺北市,士林區,明勝里,189,1521,320,557,877,35,912
公投第１４案,臺北市,士林區,明勝里,190,1461,329,482,811,33,844
公投第１４案,臺北市,士林區,福順里,191,1541,327,458,785,54,839
公投第１４案,臺北市,士林區,福順里,192,1611,307,413,720,43,763
公投第１４案,臺北市,士林區,福順里,193,1595,312,526,838,60,898
公投第１４案,臺北市,士林區,富光里,194,1685,323,527,850,33,883
公投第１４案,臺北市,士林區,富光里,195,1816,315,550,865,62,927
公投第１４案,臺北市,士林區,富光里,196,1687,327,575,902,61,963
公投第１４案,臺北市,士林區,葫蘆里,197,1646,320,556,876,61,937
公投第１４案,臺北市,士林區,葫蘆里,198,1643,306,536,842,44,886
公投第１４案,臺北市,士林區,葫蘆里,199,1687,321,610,931,43,974
公投第１４案,臺北市,士林區,葫蘆里,200,1655,333,581,914,54,968
公投第１４案,臺北市,士林區,葫東里,201,1779,461,460,921,40,961
公投第１４案,臺北市,士林區,葫東里,202,1855,415,626,1041,48,1089
公投第１４案,臺北市,士林區,社子里,203,1350,298,446,744,43,787
公投第１４案,臺北市,士林區,社子里,204,1455,260,470,730,34,764
公投第１４案,臺北市,士林區,社子里,205,1497,262,405,667,56,723
公投第１４案,臺北市,士林區,社子里,206,1398,245,388,633,41,674
公投第１４案,臺北市,士林區,社新里,207,1747,349,622,971,56,1027
公投第１４案,臺北市,士林區,社新里,208,1465,287,460,747,73,820
公投第１４案,臺北市,士林區,社新里,209,1530,288,513,801,65,866
公投第１４案,臺北市,士林區,社新里,210,1855,346,563,909,62,971
公投第１４案,臺北市,士林區,社新里,211,1444,312,461,773,57,830
公投第１４案,臺北市,士林區,社園里,212,1563,317,469,786,49,835
公投第１４案,臺北市,士林區,社園里,213,1482,305,486,791,67,858
公投第１４案,臺北市,士林區,社園里,214,1552,326,474,800,69,869
公投第１４案,臺北市,士林區,社園里,215,1790,349,608,957,58,1015
公投第１４案,臺北市,士林區,永倫里,216,1628,281,502,783,75,858
公投第１４案,臺北市,士林區,永倫里,217,1337,258,441,699,59,758
公投第１４案,臺北市,士林區,永倫里,218,1750,353,576,929,65,994
公投第１４案,臺北市,士林區,永倫里,219,1668,309,496,805,95,900
公投第１４案,臺北市,士林區,福安里,220,1403,238,369,607,60,667
公投第１４案,臺北市,士林區,福安里,221,1468,262,396,658,42,700
公投第１４案,臺北市,士林區,福安里,222,1471,224,463,687,41,728
公投第１４案,臺北市,士林區,富洲里,223,1666,305,504,809,65,874
公投第１４案,臺北市,士林區,富洲里,224,1587,307,476,783,50,833
公投第１４案,臺北市,士林區,富洲里,225,1987,322,556,878,68,946
公投第１４案,臺北市,士林區,岩山里,226,1271,299,334,633,21,654
公投第１４案,臺北市,士林區,岩山里,227,1728,363,617,980,58,1038
公投第１４案,臺北市,士林區,名山里,228,1630,337,587,924,55,979
公投第１４案,臺北市,士林區,名山里,229,1619,362,568,930,40,970
公投第１４案,臺北市,士林區,名山里,230,1425,294,504,798,14,812
公投第１４案,臺北市,士林區,名山里,231,1623,389,572,961,50,1011
公投第１４案,臺北市,士林區,聖山里,232,1564,344,530,874,53,927
公投第１４案,臺北市,士林區,聖山里,233,1376,265,590,855,42,897
公投第１４案,臺北市,士林區,聖山里,234,1517,314,596,910,31,941
公投第１４案,臺北市,士林區,芝山里,235,1729,344,546,890,39,929
公投第１４案,臺北市,士林區,芝山里,236,1511,349,542,891,37,928
公投第１４案,臺北市,士林區,芝山里,237,1811,389,655,1044,39,1083
公投第１４案,臺北市,士林區,芝山里,238,1533,368,513,881,31,912
公投第１４案,臺北市,士林區,東山里,239,1657,381,644,1025,49,1074
公投第１４案,臺北市,士林區,東山里,240,1499,317,510,827,32,859
公投第１４案,臺北市,士林區,東山里,241,1402,249,513,762,47,809
公投第１４案,臺北市,士林區,德行里,242,1273,308,460,768,62,830
公投第１４案,臺北市,士林區,德行里,243,1273,297,433,730,37,767
公投第１４案,臺北市,士林區,德行里,244,1316,308,437,745,40,785
公投第１４案,臺北市,士林區,德華里,245,1659,343,568,911,52,963
公投第１４案,臺北市,士林區,德華里,246,1749,420,521,941,48,989
公投第１４案,臺北市,士林區,德華里,247,1552,328,504,832,57,889
公投第１４案,臺北市,士林區,忠誠里,248,1529,296,576,872,41,913
公投第１４案,臺北市,士林區,忠誠里,249,1644,272,612,884,35,919
公投第１４案,臺北市,士林區,忠誠里,250,1779,363,603,966,40,1006
公投第１４案,臺北市,士林區,蘭雅里,251,1597,359,520,879,39,918
公投第１４案,臺北市,士林區,蘭雅里,252,1454,321,487,808,36,844
公投第１４案,臺北市,士林區,蘭雅里,253,1582,381,531,912,55,967
公投第１４案,臺北市,士林區,蘭雅里,254,1518,357,510,867,41,908
公投第１４案,臺北市,士林區,蘭雅里,255,1501,323,463,786,25,811
公投第１４案,臺北市,士林區,蘭興里,256,1420,323,495,818,42,860
公投第１４案,臺北市,士林區,蘭興里,257,1494,337,495,832,45,877
公投第１４案,臺北市,士林區,蘭興里,258,1568,370,570,940,35,975
公投第１４案,臺北市,士林區,蘭興里,259,1208,306,425,731,38,769
公投第１４案,臺北市,士林區,三玉里,260,1826,372,615,987,49,1036
公投第１４案,臺北市,士林區,三玉里,261,1647,369,534,903,40,943
公投第１４案,臺北市,士林區,三玉里,262,1654,351,537,888,53,941
公投第１４案,臺北市,士林區,天福里,263,1550,363,538,901,34,935
公投第１４案,臺北市,士林區,天福里,264,1298,338,455,793,27,820
公投第１４案,臺北市,士林區,天福里,265,1297,300,471,771,40,811
公投第１４案,臺北市,士林區,天福里,266,1352,313,413,726,42,768
公投第１４案,臺北市,士林區,天祿里,267,1522,313,525,838,38,876
公投第１４案,臺北市,士林區,天祿里,268,1602,383,474,857,67,924
公投第１４案,臺北市,士林區,天祿里,269,1441,343,461,804,36,840
公投第１４案,臺北市,士林區,天壽里,270,1325,316,392,708,15,723
公投第１４案,臺北市,士林區,天壽里,271,1567,342,522,864,42,906
公投第１４案,臺北市,士林區,天壽里,272,1518,332,496,828,14,842
公投第１４案,臺北市,士林區,天和里,273,1549,357,554,911,36,947
公投第１４案,臺北市,士林區,天和里,274,1652,386,545,931,26,957
公投第１４案,臺北市,士林區,天和里,275,1766,417,574,991,50,1041
公投第１４案,臺北市,士林區,天和里,276,1638,360,525,885,26,911
公投第１４案,臺北市,士林區,天山里,277,1491,306,479,785,40,825
公投第１４案,臺北市,士林區,天山里,278,1521,328,540,868,22,890
公投第１４案,臺北市,士林區,天山里,279,1351,291,483,774,49,823
公投第１４案,臺北市,士林區,天山里,280,1742,349,566,915,21,936
公投第１４案,臺北市,士林區,天玉里,281,1585,493,387,880,32,912
公投第１４案,臺北市,士林區,天玉里,282,1521,302,551,853,38,891
公投第１４案,臺北市,士林區,天玉里,283,1543,335,490,825,30,855
公投第１４案,臺北市,士林區,天玉里,284,1404,297,519,816,21,837
公投第１４案,臺北市,士林區,天玉里,285,1541,332,527,859,35,894
公投第１４案,臺北市,士林區,天母里,286,1584,300,545,845,39,884
公投第１４案,臺北市,士林區,天母里,287,1519,349,519,868,43,911
公投第１４案,臺北市,士林區,天母里,288,1482,295,469,764,18,782
公投第１４案,臺北市,士林區,天母里,289,1243,273,447,720,34,754
公投第１４案,臺北市,士林區,永福里,290,1156,209,415,624,41,665
公投第１４案,臺北市,士林區,公館里,291,1262,251,355,606,76,682
公投第１４案,臺北市,士林區,新安里,292,889,181,319,500,33,533
公投第１４案,臺北市,士林區,新安里,293,858,211,287,498,41,539
公投第１４案,臺北市,士林區,陽明里,294,945,184,295,479,55,534
公投第１４案,臺北市,士林區,陽明里,295,960,192,316,508,48,556
公投第１４案,臺北市,士林區,陽明里,296,876,154,295,449,43,492
公投第１４案,臺北市,士林區,菁山里,297,556,129,200,329,34,363
公投第１４案,臺北市,士林區,菁山里,298,919,158,364,522,55,577
公投第１４案,臺北市,士林區,平等里,299,1360,291,531,822,80,902
公投第１４案,臺北市,士林區,溪山里,300,1355,257,514,771,63,834
公投第１４案,臺北市,士林區,翠山里,301,1252,260,452,712,32,744
公投第１４案,臺北市,士林區,翠山里,302,1182,239,462,701,40,741
公投第１４案,臺北市,士林區,臨溪里,303,1431,255,418,673,29,702
公投第１４案,臺北市,士林區,臨溪里,304,1240,249,397,646,36,682
公投第１４案,臺北市,內湖區,西湖里,305,1661,323,532,855,17,872
公投第１４案,臺北市,內湖區,西湖里,306,1602,340,494,834,56,890
公投第１４案,臺北市,內湖區,西湖里,307,1655,343,608,951,62,1013
公投第１４案,臺北市,內湖區,西湖里,308,1582,385,540,925,33,958
公投第１４案,臺北市,內湖區,西康里,309,1688,357,543,900,33,933
公投第１４案,臺北市,內湖區,西康里,310,1737,413,535,948,51,999
公投第１４案,臺北市,內湖區,西康里,311,1809,426,601,1027,51,1078
公投第１４案,臺北市,內湖區,西康里,312,1376,289,472,761,28,789
公投第１４案,臺北市,內湖區,西康里,313,1747,450,539,989,72,1061
公投第１４案,臺北市,內湖區,西安里,314,1389,327,495,822,29,851
公投第１４案,臺北市,內湖區,西安里,315,1454,383,509,892,26,918
公投第１４案,臺北市,內湖區,西安里,316,1468,379,510,889,32,921
公投第１４案,臺北市,內湖區,西安里,317,1603,362,610,972,38,1010
公投第１４案,臺北市,內湖區,港墘里,318,1795,368,614,982,28,1010
公投第１４案,臺北市,內湖區,港墘里,319,1737,432,610,1042,46,1088
公投第１４案,臺北市,內湖區,港墘里,320,1744,389,617,1006,45,1051
公投第１４案,臺北市,內湖區,港都里,321,1661,356,585,941,41,982
公投第１４案,臺北市,內湖區,港都里,322,1577,369,518,887,31,918
公投第１４案,臺北市,內湖區,港都里,323,1494,354,546,900,22,922
公投第１４案,臺北市,內湖區,港富里,324,1626,339,579,918,38,956
公投第１４案,臺北市,內湖區,港富里,325,1641,343,576,919,58,977
公投第１４案,臺北市,內湖區,港富里,326,1554,353,536,889,29,918
公投第１４案,臺北市,內湖區,港富里,327,1728,393,601,994,52,1046
公投第１４案,臺北市,內湖區,港富里,328,1736,345,618,963,35,998
公投第１４案,臺北市,內湖區,港華里,329,1461,339,566,905,38,943
公投第１４案,臺北市,內湖區,港華里,330,1509,314,556,870,34,904
公投第１４案,臺北市,內湖區,港華里,331,1358,304,459,763,21,784
公投第１４案,臺北市,內湖區,港華里,332,1761,388,577,965,34,999
公投第１４案,臺北市,內湖區,港華里,333,1651,379,574,953,25,978
公投第１４案,臺北市,內湖區,內湖里,334,1809,373,654,1027,59,1086
公投第１４案,臺北市,內湖區,內湖里,335,1773,383,614,997,39,1036
公投第１４案,臺北市,內湖區,內湖里,336,1890,367,657,1024,36,1060
公投第１４案,臺北市,內湖區,湖濱里,337,1760,438,647,1085,49,1134
公投第１４案,臺北市,內湖區,湖濱里,338,1645,356,601,957,24,981
公投第１４案,臺北市,內湖區,湖濱里,339,1324,310,500,810,20,830
公投第１４案,臺北市,內湖區,湖濱里,340,1072,200,442,642,30,672
公投第１４案,臺北市,內湖區,湖濱里,341,1509,305,524,829,29,858
公投第１４案,臺北市,內湖區,紫星里,342,1715,374,588,962,43,1005
公投第１４案,臺北市,內湖區,紫星里,343,1774,381,632,1013,41,1054
公投第１４案,臺北市,內湖區,紫星里,344,1796,414,684,1098,35,1133
公投第１４案,臺北市,內湖區,紫星里,345,1784,324,668,992,31,1023
公投第１４案,臺北市,內湖區,大湖里,346,1417,345,488,833,50,883
公投第１４案,臺北市,內湖區,大湖里,347,1699,435,522,957,26,983
公投第１４案,臺北市,內湖區,大湖里,348,1719,446,602,1048,33,1081
公投第１４案,臺北市,內湖區,金龍里,349,1715,395,581,976,34,1010
公投第１４案,臺北市,內湖區,金龍里,350,1634,317,523,840,26,866
公投第１４案,臺北市,內湖區,金龍里,351,1435,269,482,751,45,796
公投第１４案,臺北市,內湖區,金瑞里,352,1440,300,509,809,22,831
公投第１４案,臺北市,內湖區,金瑞里,353,1446,353,516,869,28,897
公投第１４案,臺北市,內湖區,金瑞里,354,1657,339,517,856,43,899
公投第１４案,臺北市,內湖區,金瑞里,355,1261,272,451,723,59,782
公投第１４案,臺北市,內湖區,碧山里,356,456,73,143,216,24,240
公投第１４案,臺北市,內湖區,碧山里,357,1433,370,543,913,30,943
公投第１４案,臺北市,內湖區,碧山里,358,1485,315,548,863,32,895
公投第１４案,臺北市,內湖區,碧山里,359,1590,346,538,884,35,919
公投第１４案,臺北市,內湖區,碧山里,360,1219,298,445,743,49,792
公投第１４案,臺北市,內湖區,紫雲里,361,1732,328,603,931,46,977
公投第１４案,臺北市,內湖區,紫雲里,362,1727,347,654,1001,28,1029
公投第１４案,臺北市,內湖區,紫雲里,363,1637,344,578,922,46,968
公投第１４案,臺北市,內湖區,清白里,364,1453,322,489,811,28,839
公投第１４案,臺北市,內湖區,清白里,365,1617,325,559,884,33,917
公投第１４案,臺北市,內湖區,清白里,366,1604,331,538,869,37,906
公投第１４案,臺北市,內湖區,清白里,367,1406,340,548,888,10,898
公投第１４案,臺北市,內湖區,清白里,368,1353,336,450,786,32,818
公投第１４案,臺北市,內湖區,葫洲里,369,1724,383,629,1012,34,1046
公投第１４案,臺北市,內湖區,葫洲里,370,1378,317,491,808,30,838
公投第１４案,臺北市,內湖區,葫洲里,371,1403,320,524,844,21,865
公投第１４案,臺北市,內湖區,葫洲里,372,1547,345,515,860,21,881
公投第１４案,臺北市,內湖區,紫陽里,373,1718,424,582,1006,30,1036
公投第１４案,臺北市,內湖區,紫陽里,374,1813,397,607,1004,38,1042
公投第１４案,臺北市,內湖區,紫陽里,375,1791,659,420,1079,39,1118
公投第１４案,臺北市,內湖區,紫陽里,376,1855,434,658,1092,45,1137
公投第１４案,臺北市,內湖區,瑞陽里,377,1731,260,730,990,25,1015
公投第１４案,臺北市,內湖區,瑞陽里,378,1593,405,567,972,51,1023
公投第１４案,臺北市,內湖區,瑞陽里,379,1869,341,627,968,40,1008
公投第１４案,臺北市,內湖區,瑞陽里,380,1687,388,582,970,48,1018
公投第１４案,臺北市,內湖區,瑞光里,381,1530,350,547,897,21,918
公投第１４案,臺北市,內湖區,瑞光里,382,1300,281,486,767,35,802
公投第１４案,臺北市,內湖區,瑞光里,383,1314,233,577,810,35,845
公投第１４案,臺北市,內湖區,五分里,384,1433,293,454,747,13,760
公投第１４案,臺北市,內湖區,五分里,385,1450,315,457,772,26,798
公投第１４案,臺北市,內湖區,五分里,386,1608,348,529,877,44,921
公投第１４案,臺北市,內湖區,五分里,387,1414,328,481,809,35,844
公投第１４案,臺北市,內湖區,五分里,388,1492,371,490,861,29,890
公投第１４案,臺北市,內湖區,五分里,389,1528,320,480,800,27,827
公投第１４案,臺北市,內湖區,東湖里,390,1692,370,579,949,33,982
公投第１４案,臺北市,內湖區,東湖里,391,1556,331,544,875,45,920
公投第１４案,臺北市,內湖區,東湖里,392,1637,349,544,893,22,915
公投第１４案,臺北市,內湖區,東湖里,393,1749,389,546,935,33,968
公投第１４案,臺北市,內湖區,樂康里,394,1220,237,422,659,28,687
公投第１４案,臺北市,內湖區,樂康里,395,1600,344,539,883,42,925
公投第１４案,臺北市,內湖區,樂康里,396,1473,319,498,817,38,855
公投第１４案,臺北市,內湖區,樂康里,397,1498,320,486,806,50,856
公投第１４案,臺北市,內湖區,樂康里,398,1557,333,529,862,36,898
公投第１４案,臺北市,內湖區,內溝里,399,1674,327,548,875,25,900
公投第１４案,臺北市,內湖區,內溝里,400,1728,379,624,1003,39,1042
公投第１４案,臺北市,內湖區,內溝里,401,788,123,250,373,35,408
公投第１４案,臺北市,內湖區,週美里,402,1542,350,479,829,44,873
公投第１４案,臺北市,內湖區,週美里,403,1676,322,480,802,50,852
公投第１４案,臺北市,內湖區,週美里,404,1360,297,416,713,19,732
公投第１４案,臺北市,內湖區,週美里,405,1259,279,500,779,22,801
公投第１４案,臺北市,內湖區,週美里,406,1301,265,445,710,14,724
公投第１４案,臺北市,內湖區,行善里,407,1251,252,359,611,36,647
公投第１４案,臺北市,內湖區,行善里,408,1502,299,507,806,53,859
公投第１４案,臺北市,內湖區,行善里,409,1596,298,568,866,32,898
公投第１４案,臺北市,內湖區,行善里,410,1649,338,592,930,16,946
公投第１４案,臺北市,內湖區,石潭里,411,1774,348,595,943,39,982
公投第１４案,臺北市,內湖區,石潭里,412,1746,364,566,930,26,956
公投第１４案,臺北市,內湖區,湖興里,413,1473,301,505,806,25,831
公投第１４案,臺北市,內湖區,湖興里,414,2824,364,571,935,35,970
公投第１４案,臺北市,內湖區,湖興里,415,1849,424,507,931,31,962
公投第１４案,臺北市,內湖區,湖興里,416,1530,316,492,808,58,866
公投第１４案,臺北市,內湖區,湖元里,417,1656,366,543,909,43,952
公投第１４案,臺北市,內湖區,湖元里,418,1457,341,492,833,29,862
公投第１４案,臺北市,內湖區,湖元里,419,1695,351,626,977,41,1018
公投第１４案,臺北市,內湖區,安湖里,420,1663,380,574,954,31,985
公投第１４案,臺北市,內湖區,安湖里,421,1654,341,572,913,38,951
公投第１４案,臺北市,內湖區,安湖里,422,1642,375,562,937,48,985
公投第１４案,臺北市,內湖區,安湖里,423,1685,397,556,953,23,976
公投第１４案,臺北市,內湖區,秀湖里,424,1862,371,630,1001,42,1043
公投第１４案,臺北市,內湖區,秀湖里,425,1900,453,648,1101,39,1140
公投第１４案,臺北市,內湖區,秀湖里,426,1790,394,697,1091,48,1139
公投第１４案,臺北市,內湖區,安泰里,427,1417,301,469,770,47,817
公投第１４案,臺北市,內湖區,安泰里,428,1694,335,597,932,39,971
公投第１４案,臺北市,內湖區,安泰里,429,1676,319,537,856,48,904
公投第１４案,臺北市,內湖區,金湖里,430,1643,381,531,912,21,933
公投第１４案,臺北市,內湖區,金湖里,431,1588,384,531,915,32,947
公投第１４案,臺北市,內湖區,金湖里,432,1603,364,553,917,46,963
公投第１４案,臺北市,內湖區,金湖里,433,1629,372,546,918,37,955
公投第１４案,臺北市,內湖區,金湖里,434,1646,389,590,979,40,1019
公投第１４案,臺北市,內湖區,康寧里,435,1883,361,652,1013,33,1046
公投第１４案,臺北市,內湖區,康寧里,436,1434,312,490,802,35,837
公投第１４案,臺北市,內湖區,康寧里,437,1418,315,482,797,18,815
公投第１４案,臺北市,內湖區,康寧里,438,1373,290,491,781,46,827
公投第１４案,臺北市,內湖區,康寧里,439,1349,301,469,770,48,818
公投第１４案,臺北市,內湖區,明湖里,440,1511,344,556,900,31,931
公投第１４案,臺北市,內湖區,明湖里,441,1563,359,582,941,38,979
公投第１４案,臺北市,內湖區,明湖里,442,1550,342,536,878,31,909
公投第１４案,臺北市,內湖區,蘆洲里,443,1157,221,390,611,41,652
公投第１４案,臺北市,內湖區,麗山里,444,1768,447,571,1018,32,1050
公投第１４案,臺北市,內湖區,麗山里,445,1664,362,574,936,42,978
公投第１４案,臺北市,內湖區,麗山里,446,1743,410,580,990,38,1028
公投第１４案,臺北市,內湖區,寶湖里,447,1480,335,531,866,19,885
公投第１４案,臺北市,內湖區,寶湖里,448,1589,405,539,944,36,980
公投第１４案,臺北市,內湖區,寶湖里,449,1371,288,477,765,30,795
公投第１４案,臺北市,內湖區,寶湖里,450,1575,383,575,958,26,984
公投第１４案,臺北市,內湖區,寶湖里,451,1377,301,490,791,17,808
公投第１４案,臺北市,內湖區,南湖里,452,1469,403,526,929,40,969
公投第１４案,臺北市,內湖區,南湖里,453,1529,394,554,948,20,968
公投第１４案,臺北市,內湖區,南湖里,454,1649,425,557,982,34,1016
公投第１４案,臺北市,南港區,南港里,455,1280,248,443,691,26,717
公投第１４案,臺北市,南港區,南港里,456,1351,291,467,758,20,778
公投第１４案,臺北市,南港區,南港里,457,1345,308,455,763,30,793
公投第１４案,臺北市,南港區,南港里,458,1679,277,445,722,38,760
公投第１４案,臺北市,南港區,中南里,459,1680,343,520,863,43,906
公投第１４案,臺北市,南港區,中南里,460,1635,287,513,800,49,849
公投第１４案,臺北市,南港區,三重里,461,1459,276,507,783,40,823
公投第１４案,臺北市,南港區,三重里,462,1706,384,574,958,23,981
公投第１４案,臺北市,南港區,三重里,463,1674,304,560,864,41,905
公投第１４案,臺北市,南港區,三重里,464,1491,322,503,825,13,838
公投第１４案,臺北市,南港區,新富里,465,1086,238,431,669,31,700
公投第１４案,臺北市,南港區,新富里,466,1202,285,445,730,46,776
公投第１４案,臺北市,南港區,新富里,467,1198,289,399,688,40,728
公投第１４案,臺北市,南港區,中研里,468,1430,316,438,754,28,782
公投第１４案,臺北市,南港區,中研里,469,1275,340,414,754,41,795
公投第１４案,臺北市,南港區,中研里,470,1344,392,438,830,42,872
公投第１４案,臺北市,南港區,中研里,471,1391,354,456,810,27,837
公投第１４案,臺北市,南港區,中研里,472,1342,347,450,797,25,822
公投第１４案,臺北市,南港區,中研里,473,1389,302,428,730,32,762
公投第１４案,臺北市,南港區,九如里,474,1426,332,509,841,29,870
公投第１４案,臺北市,南港區,九如里,475,1359,234,554,788,24,812
公投第１４案,臺北市,南港區,九如里,476,1366,276,478,754,41,795
公投第１４案,臺北市,南港區,九如里,477,1441,297,530,827,26,853
公投第１４案,臺北市,南港區,舊莊里,478,1529,287,500,787,50,837
公投第１４案,臺北市,南港區,舊莊里,479,1618,321,506,827,44,871
公投第１４案,臺北市,南港區,舊莊里,480,1545,268,448,716,44,760
公投第１４案,臺北市,南港區,舊莊里,481,1569,332,534,866,38,904
公投第１４案,臺北市,南港區,舊莊里,482,1661,318,491,809,36,845
公投第１４案,臺北市,南港區,東新里,483,1518,315,448,763,39,802
公投第１４案,臺北市,南港區,東新里,484,1552,365,555,920,41,961
公投第１４案,臺北市,南港區,東新里,485,1658,340,528,868,25,893
公投第１４案,臺北市,南港區,東新里,486,1608,327,549,876,57,933
公投第１４案,臺北市,南港區,重陽里,487,1475,305,480,785,28,813
公投第１４案,臺北市,南港區,重陽里,488,1722,421,610,1031,40,1071
公投第１４案,臺北市,南港區,重陽里,489,1383,329,534,863,37,900
公投第１４案,臺北市,南港區,東明里,490,1397,301,490,791,39,830
公投第１４案,臺北市,南港區,東明里,491,1352,262,525,787,34,821
公投第１４案,臺北市,南港區,東明里,492,1344,293,477,770,40,810
公投第１４案,臺北市,南港區,西新里,493,1385,313,425,738,26,764
公投第１４案,臺北市,南港區,西新里,494,1399,295,466,761,41,802
公投第１４案,臺北市,南港區,西新里,495,1381,290,439,729,35,764
公投第１４案,臺北市,南港區,玉成里,496,1548,293,529,822,40,862
公投第１４案,臺北市,南港區,玉成里,497,1190,261,395,656,20,676
公投第１４案,臺北市,南港區,玉成里,498,1490,345,501,846,34,880
公投第１４案,臺北市,南港區,合成里,499,1096,252,394,646,28,674
公投第１４案,臺北市,南港區,合成里,500,1238,288,453,741,25,766
公投第１４案,臺北市,南港區,合成里,501,1271,281,475,756,34,790
公投第１４案,臺北市,南港區,合成里,502,1146,231,408,639,31,670
公投第１４案,臺北市,南港區,合成里,503,1232,258,424,682,30,712
公投第１４案,臺北市,南港區,新光里,504,1649,279,527,806,29,835
公投第１４案,臺北市,南港區,新光里,505,1688,338,622,960,34,994
公投第１４案,臺北市,南港區,聯成里,506,1503,309,571,880,30,910
公投第１４案,臺北市,南港區,聯成里,507,1542,364,496,860,34,894
公投第１４案,臺北市,南港區,聯成里,508,1463,276,570,846,37,883
公投第１４案,臺北市,南港區,萬福里,509,1195,273,445,718,47,765
公投第１４案,臺北市,南港區,萬福里,510,1254,302,438,740,9,749
公投第１４案,臺北市,南港區,萬福里,511,1356,284,495,779,27,806
公投第１４案,臺北市,南港區,鴻福里,512,1363,341,436,777,67,844
公投第１４案,臺北市,南港區,鴻福里,513,1317,311,482,793,35,828
公投第１４案,臺北市,南港區,鴻福里,514,1331,290,480,770,20,790
公投第１４案,臺北市,南港區,百福里,515,1610,330,564,894,46,940
公投第１４案,臺北市,南港區,百福里,516,1542,309,532,841,27,868
公投第１４案,臺北市,南港區,百福里,517,1581,328,571,899,43,942
公投第１４案,臺北市,南港區,成福里,518,1225,273,469,742,29,771
公投第１４案,臺北市,南港區,成福里,519,1264,299,449,748,54,802
公投第１４案,臺北市,南港區,成福里,520,1649,360,594,954,56,1010
公投第１４案,臺北市,南港區,成福里,521,1267,306,438,744,24,768
公投第１４案,臺北市,南港區,成福里,522,1336,261,498,759,74,833
公投第１４案,臺北市,南港區,仁福里,523,1162,271,428,699,30,729
公投第１４案,臺北市,南港區,仁福里,524,1045,225,371,596,26,622
公投第１４案,臺北市,南港區,仁福里,525,1351,320,553,873,37,910
公投第１４案,臺北市,南港區,仁福里,526,1358,272,503,775,24,799
公投第１４案,臺北市,松山區,莊敬里,527,1583,359,561,920,33,953
公投第１４案,臺北市,松山區,莊敬里,528,1691,352,579,931,51,982
公投第１４案,臺北市,松山區,莊敬里,529,1386,279,471,750,44,794
公投第１４案,臺北市,松山區,東榮里,530,1362,292,482,774,53,827
公投第１４案,臺北市,松山區,東榮里,531,1399,299,499,798,47,845
公投第１４案,臺北市,松山區,東榮里,532,1324,320,446,766,48,814
公投第１４案,臺北市,松山區,東榮里,533,1296,318,481,799,32,831
公投第１４案,臺北市,松山區,東榮里,534,1386,296,523,819,36,855
公投第１４案,臺北市,松山區,三民里,535,1529,383,542,925,55,980
公投第１４案,臺北市,松山區,三民里,536,1416,282,507,789,34,823
公投第１４案,臺北市,松山區,三民里,537,1619,352,513,865,37,902
公投第１４案,臺北市,松山區,三民里,538,1386,315,485,800,33,833
公投第１４案,臺北市,松山區,新益里,539,1380,354,507,861,29,890
公投第１４案,臺北市,松山區,新益里,540,1357,331,460,791,37,828
公投第１４案,臺北市,松山區,新益里,541,1296,290,495,785,32,817
公投第１４案,臺北市,松山區,富錦里,542,1632,349,567,916,63,979
公投第１４案,臺北市,松山區,富錦里,543,1414,309,488,797,34,831
公投第１４案,臺北市,松山區,富錦里,544,1404,315,510,825,34,859
公投第１４案,臺北市,松山區,新東里,545,1365,266,537,803,51,854
公投第１４案,臺北市,松山區,新東里,546,1431,327,492,819,41,860
公投第１４案,臺北市,松山區,新東里,547,1483,339,529,868,39,907
公投第１４案,臺北市,松山區,富泰里,548,1293,308,477,785,33,818
公投第１４案,臺北市,松山區,富泰里,549,1410,306,468,774,33,807
公投第１４案,臺北市,松山區,富泰里,550,1307,264,486,750,43,793
公投第１４案,臺北市,松山區,介壽里,551,1242,322,441,763,31,794
公投第１４案,臺北市,松山區,介壽里,552,1192,266,448,714,25,739
公投第１４案,臺北市,松山區,介壽里,553,1276,265,491,756,42,798
公投第１４案,臺北市,松山區,精忠里,554,1201,251,441,692,20,712
公投第１４案,臺北市,松山區,精忠里,555,1318,250,525,775,24,799
公投第１４案,臺北市,松山區,精忠里,556,1157,256,439,695,28,723
公投第１４案,臺北市,松山區,東光里,557,1157,245,411,656,18,674
公投第１４案,臺北市,松山區,東光里,558,1357,275,535,810,30,840
公投第１４案,臺北市,松山區,東光里,559,1215,251,378,629,31,660
公投第１４案,臺北市,松山區,東光里,560,1345,294,450,744,34,778
公投第１４案,臺北市,松山區,東光里,561,1237,276,439,715,31,746
公投第１４案,臺北市,松山區,龍田里,562,1393,243,595,838,37,875
公投第１４案,臺北市,松山區,龍田里,563,1331,332,495,827,38,865
公投第１４案,臺北市,松山區,龍田里,564,1550,369,556,925,46,971
公投第１４案,臺北市,松山區,龍田里,565,1308,201,530,731,13,744
公投第１４案,臺北市,松山區,龍田里,566,1490,274,567,841,37,878
公投第１４案,臺北市,松山區,龍田里,567,1406,310,551,861,32,893
公投第１４案,臺北市,松山區,東昌里,568,1191,293,458,751,23,774
公投第１４案,臺北市,松山區,東昌里,569,1095,260,386,646,32,678
公投第１４案,臺北市,松山區,東勢里,570,1198,236,441,677,42,719
公投第１４案,臺北市,松山區,東勢里,571,1265,259,450,709,41,750
公投第１４案,臺北市,松山區,東勢里,572,1225,251,442,693,24,717
公投第１４案,臺北市,松山區,中華里,573,1698,387,615,1002,53,1055
公投第１４案,臺北市,松山區,中華里,574,1819,668,334,1002,44,1046
公投第１４案,臺北市,松山區,中華里,575,1754,387,624,1011,50,1061
公投第１４案,臺北市,松山區,民有里,576,1361,337,477,814,34,848
公投第１４案,臺北市,松山區,民有里,577,1189,258,459,717,25,742
公投第１４案,臺北市,松山區,民有里,578,1214,282,427,709,39,748
公投第１４案,臺北市,松山區,民有里,579,1284,299,441,740,33,773
公投第１４案,臺北市,松山區,民有里,580,1297,303,463,766,41,807
公投第１４案,臺北市,松山區,民有里,581,1330,298,450,748,34,782
公投第１４案,臺北市,松山區,民福里,582,1396,305,523,828,41,869
公投第１４案,臺北市,松山區,民福里,583,1480,277,543,820,26,846
公投第１４案,臺北市,松山區,民福里,584,1419,319,510,829,34,863
公投第１４案,臺北市,松山區,民福里,585,1390,305,503,808,41,849
公投第１４案,臺北市,松山區,松基里,586,1525,362,524,886,34,920
公投第１４案,臺北市,松山區,松基里,587,1633,327,546,873,33,906
公投第１４案,臺北市,松山區,慈祐里,588,2677,369,505,874,24,898
公投第１４案,臺北市,松山區,慈祐里,589,1281,302,418,720,47,767
公投第１４案,臺北市,松山區,慈祐里,590,1469,270,402,672,49,721
公投第１４案,臺北市,松山區,慈祐里,591,1700,381,531,912,59,971
公投第１４案,臺北市,松山區,安平里,592,1503,330,460,790,40,830
公投第１４案,臺北市,松山區,安平里,593,1309,295,431,726,39,765
公投第１４案,臺北市,松山區,安平里,594,1376,280,500,780,55,835
公投第１４案,臺北市,松山區,安平里,595,1654,355,582,937,27,964
公投第１４案,臺北市,松山區,安平里,596,1601,322,537,859,56,915
公投第１４案,臺北市,松山區,鵬程里,597,1496,299,557,856,31,887
公投第１４案,臺北市,松山區,鵬程里,598,1598,372,587,959,55,1014
公投第１４案,臺北市,松山區,鵬程里,599,1751,401,620,1021,43,1064
公投第１４案,臺北市,松山區,自強里,600,1557,329,609,938,34,972
公投第１４案,臺北市,松山區,自強里,601,1686,360,720,1080,35,1115
公投第１４案,臺北市,松山區,自強里,602,1707,263,732,995,54,1049
公投第１４案,臺北市,松山區,自強里,603,1854,392,755,1147,49,1196
公投第１４案,臺北市,松山區,自強里,604,1740,355,586,941,36,977
公投第１４案,臺北市,松山區,吉祥里,605,1494,321,515,836,51,887
公投第１４案,臺北市,松山區,吉祥里,606,1453,296,533,829,45,874
公投第１４案,臺北市,松山區,吉祥里,607,1458,328,524,852,26,878
公投第１４案,臺北市,松山區,吉祥里,608,1536,338,537,875,27,902
公投第１４案,臺北市,松山區,吉祥里,609,1463,312,548,860,26,886
公投第１４案,臺北市,松山區,新聚里,610,1790,389,547,936,23,959
公投第１４案,臺北市,松山區,新聚里,611,1679,359,610,969,42,1011
公投第１４案,臺北市,松山區,新聚里,612,1785,324,551,875,55,930
公投第１４案,臺北市,松山區,新聚里,613,1793,390,579,969,49,1018
公投第１４案,臺北市,松山區,復盛里,614,1381,274,496,770,51,821
公投第１４案,臺北市,松山區,復盛里,615,1279,283,467,750,26,776
公投第１４案,臺北市,松山區,復盛里,616,1681,354,602,956,58,1014
公投第１４案,臺北市,松山區,復盛里,617,1232,291,448,739,40,779
公投第１４案,臺北市,松山區,中正里,618,1533,321,531,852,35,887
公投第１４案,臺北市,松山區,中正里,619,1540,370,552,922,32,954
公投第１４案,臺北市,松山區,中正里,620,1716,359,576,935,28,963
公投第１４案,臺北市,松山區,中正里,621,1664,366,513,879,35,914
公投第１４案,臺北市,松山區,中正里,622,1350,267,487,754,22,776
公投第１４案,臺北市,松山區,中崙里,623,1837,377,634,1011,34,1045
公投第１４案,臺北市,松山區,中崙里,624,1558,317,474,791,63,854
公投第１４案,臺北市,松山區,美仁里,625,1420,324,503,827,49,876
公投第１４案,臺北市,松山區,美仁里,626,1474,292,522,814,38,852
公投第１４案,臺北市,松山區,吉仁里,627,1591,346,526,872,40,912
公投第１４案,臺北市,松山區,吉仁里,628,1726,342,628,970,38,1008
公投第１４案,臺北市,松山區,敦化里,629,1452,345,476,821,30,851
公投第１４案,臺北市,松山區,敦化里,630,1482,319,486,805,38,843
公投第１４案,臺北市,松山區,敦化里,631,1460,321,523,844,35,879
公投第１４案,臺北市,松山區,敦化里,632,1398,309,459,768,41,809
公投第１４案,臺北市,松山區,復源里,633,1423,331,495,826,41,867
公投第１４案,臺北市,松山區,復源里,634,1226,254,459,713,24,737
公投第１４案,臺北市,松山區,復建里,635,1158,248,413,661,37,698
公投第１４案,臺北市,松山區,復建里,636,1426,407,388,795,28,823
公投第１４案,臺北市,松山區,復建里,637,1177,248,436,684,20,704
公投第１４案,臺北市,松山區,復勢里,638,1363,322,429,751,44,795
公投第１４案,臺北市,松山區,復勢里,639,1240,249,477,726,42,768
公投第１４案,臺北市,松山區,復勢里,640,1375,297,524,821,34,855
公投第１４案,臺北市,松山區,復勢里,641,1377,211,582,793,28,821
公投第１４案,臺北市,松山區,福成里,642,1225,257,407,664,20,684
公投第１４案,臺北市,松山區,福成里,643,1017,267,356,623,29,652
公投第１４案,臺北市,信義區,西村里,644,2476,279,506,785,23,808
公投第１４案,臺北市,信義區,西村里,645,1381,276,587,863,21,884
公投第１４案,臺北市,信義區,西村里,646,1294,247,527,774,42,816
公投第１４案,臺北市,信義區,正和里,647,1351,287,484,771,34,805
公投第１４案,臺北市,信義區,正和里,648,1296,277,473,750,23,773
公投第１４案,臺北市,信義區,正和里,649,1302,281,497,778,30,808
公投第１４案,臺北市,信義區,興隆里,650,1025,194,337,531,54,585
公投第１４案,臺北市,信義區,興隆里,651,1421,299,459,758,27,785
公投第１４案,臺北市,信義區,中興里,652,1501,332,491,823,32,855
公投第１４案,臺北市,信義區,中興里,653,1575,324,479,803,24,827
公投第１４案,臺北市,信義區,新仁里,654,1516,314,549,863,22,885
公投第１４案,臺北市,信義區,新仁里,655,1382,333,478,811,30,841
公投第１４案,臺北市,信義區,興雅里,656,1128,228,396,624,37,661
公投第１４案,臺北市,信義區,興雅里,657,1397,265,489,754,48,802
公投第１４案,臺北市,信義區,興雅里,658,1161,253,435,688,43,731
公投第１４案,臺北市,信義區,興雅里,659,1368,296,473,769,36,805
公投第１４案,臺北市,信義區,敦厚里,660,1049,228,390,618,21,639
公投第１４案,臺北市,信義區,敦厚里,661,1308,266,488,754,39,793
公投第１４案,臺北市,信義區,敦厚里,662,1154,275,415,690,40,730
公投第１４案,臺北市,信義區,敦厚里,663,1078,294,353,647,16,663
公投第１４案,臺北市,信義區,廣居里,664,1375,285,497,782,29,811
公投第１４案,臺北市,信義區,廣居里,665,1448,273,547,820,36,856
公投第１４案,臺北市,信義區,廣居里,666,1250,265,479,744,19,763
公投第１４案,臺北市,信義區,廣居里,667,1381,328,481,809,22,831
公投第１４案,臺北市,信義區,廣居里,668,1213,338,458,796,30,826
公投第１４案,臺北市,信義區,安康里,669,1373,292,559,851,30,881
公投第１４案,臺北市,信義區,安康里,670,1226,268,460,728,28,756
公投第１４案,臺北市,信義區,安康里,671,1117,254,396,650,20,670
公投第１４案,臺北市,信義區,安康里,672,1123,214,462,676,31,707
公投第１４案,臺北市,信義區,安康里,673,1200,242,460,702,26,728
公投第１４案,臺北市,信義區,安康里,674,1335,268,421,689,24,713
公投第１４案,臺北市,信義區,安康里,675,1332,273,438,711,23,734
公投第１４案,臺北市,信義區,六藝里,676,1648,314,612,926,60,986
公投第１４案,臺北市,信義區,六藝里,677,1542,308,506,814,57,871
公投第１４案,臺北市,信義區,雅祥里,678,1228,259,416,675,58,733
公投第１４案,臺北市,信義區,雅祥里,679,1731,370,590,960,42,1002
公投第１４案,臺北市,信義區,雅祥里,680,1403,315,496,811,32,843
公投第１４案,臺北市,信義區,五常里,681,1929,353,639,992,70,1062
公投第１４案,臺北市,信義區,五常里,682,1300,299,473,772,34,806
公投第１４案,臺北市,信義區,五全里,683,1486,292,480,772,20,792
公投第１４案,臺北市,信義區,五全里,684,1532,300,449,749,38,787
公投第１４案,臺北市,信義區,五全里,685,1387,279,554,833,37,870
公投第１４案,臺北市,信義區,永吉里,686,1195,211,410,621,40,661
公投第１４案,臺北市,信義區,永吉里,687,1068,227,340,567,42,609
公投第１４案,臺北市,信義區,永吉里,688,1273,241,422,663,35,698
公投第１４案,臺北市,信義區,長春里,689,1329,305,475,780,61,841
公投第１４案,臺北市,信義區,長春里,690,1311,271,423,694,39,733
公投第１４案,臺北市,信義區,長春里,691,1258,262,397,659,48,707
公投第１４案,臺北市,信義區,四育里,692,1277,292,429,721,53,774
公投第１４案,臺北市,信義區,四育里,693,1285,285,480,765,50,815
公投第１４案,臺北市,信義區,四育里,694,1161,274,424,698,41,739
公投第１４案,臺北市,信義區,四育里,695,1299,305,410,715,36,751
公投第１４案,臺北市,信義區,四維里,696,1243,255,429,684,38,722
公投第１４案,臺北市,信義區,四維里,697,1197,255,415,670,24,694
公投第１４案,臺北市,信義區,四維里,698,1224,308,456,764,21,785
公投第１４案,臺北市,信義區,四維里,699,1147,227,394,621,32,653
公投第１４案,臺北市,信義區,永春里,700,1045,224,381,605,22,627
公投第１４案,臺北市,信義區,永春里,701,1096,235,425,660,31,691
公投第１４案,臺北市,信義區,永春里,702,1115,240,394,634,13,647
公投第１４案,臺北市,信義區,永春里,703,1117,206,398,604,42,646
公投第１４案,臺北市,信義區,富台里,704,1019,223,293,516,22,538
公投第１４案,臺北市,信義區,富台里,705,1346,291,466,757,38,795
公投第１４案,臺北市,信義區,富台里,706,1405,275,504,779,25,804
公投第１４案,臺北市,信義區,國業里,707,1356,268,490,758,41,799
公投第１４案,臺北市,信義區,國業里,708,1250,293,481,774,32,806
公投第１４案,臺北市,信義區,國業里,709,1254,252,490,742,27,769
公投第１４案,臺北市,信義區,國業里,710,1317,287,461,748,19,767
公投第１４案,臺北市,信義區,國業里,711,1271,274,488,762,42,804
公投第１４案,臺北市,信義區,松隆里,712,979,203,326,529,33,562
公投第１４案,臺北市,信義區,松隆里,713,1025,199,345,544,30,574
公投第１４案,臺北市,信義區,松友里,714,1512,270,482,752,23,775
公投第１４案,臺北市,信義區,松友里,715,1483,357,505,862,33,895
公投第１４案,臺北市,信義區,松友里,716,1359,317,493,810,25,835
公投第１４案,臺北市,信義區,松友里,717,1387,302,529,831,12,843
公投第１４案,臺北市,信義區,松光里,718,1455,288,493,781,29,810
公投第１４案,臺北市,信義區,松光里,719,1461,299,533,832,31,863
公投第１４案,臺北市,信義區,松光里,720,1532,350,533,883,34,917
公投第１４案,臺北市,信義區,中坡里,721,1043,261,376,637,31,668
公投第１４案,臺北市,信義區,中坡里,722,875,209,320,529,26,555
公投第１４案,臺北市,信義區,中坡里,723,927,203,315,518,20,538
公投第１４案,臺北市,信義區,中坡里,724,1119,224,411,635,52,687
公投第１４案,臺北市,信義區,中行里,725,1463,313,503,816,55,871
公投第１４案,臺北市,信義區,中行里,726,1293,308,480,788,43,831
公投第１４案,臺北市,信義區,中行里,727,1553,328,518,846,34,880
公投第１４案,臺北市,信義區,中行里,728,1360,316,453,769,23,792
公投第１４案,臺北市,信義區,中行里,729,1392,301,495,796,39,835
公投第１４案,臺北市,信義區,大道里,730,1377,290,500,790,19,809
公投第１４案,臺北市,信義區,大道里,731,1377,298,483,781,21,802
公投第１４案,臺北市,信義區,大道里,732,1269,234,425,659,22,681
公投第１４案,臺北市,信義區,大道里,733,1407,285,491,776,68,844
公投第１４案,臺北市,信義區,大仁里,734,1172,237,427,664,27,691
公投第１４案,臺北市,信義區,大仁里,735,1182,249,429,678,22,700
公投第１４案,臺北市,信義區,大仁里,736,1255,263,442,705,53,758
公投第１４案,臺北市,信義區,景新里,737,1689,326,552,878,31,909
公投第１４案,臺北市,信義區,景新里,738,1605,316,552,868,23,891
公投第１４案,臺北市,信義區,景新里,739,1143,205,425,630,25,655
公投第１４案,臺北市,信義區,惠安里,740,1440,282,472,754,26,780
公投第１４案,臺北市,信義區,惠安里,741,1495,301,519,820,38,858
公投第１４案,臺北市,信義區,惠安里,742,1514,323,528,851,48,899
公投第１４案,臺北市,信義區,惠安里,743,1449,282,495,777,40,817
公投第１４案,臺北市,信義區,三張里,744,1401,299,514,813,45,858
公投第１４案,臺北市,信義區,三張里,745,1181,240,398,638,20,658
公投第１４案,臺北市,信義區,三張里,746,1376,317,538,855,17,872
公投第１４案,臺北市,信義區,三張里,747,1422,274,559,833,42,875
公投第１４案,臺北市,信義區,三張里,748,1267,261,459,720,18,738
公投第１４案,臺北市,信義區,三張里,749,1220,266,387,653,20,673
公投第１４案,臺北市,信義區,三犁里,750,1562,272,528,800,24,824
公投第１４案,臺北市,信義區,三犁里,751,1455,320,483,803,27,830
公投第１４案,臺北市,信義區,三犁里,752,1605,322,536,858,34,892
公投第１４案,臺北市,信義區,六合里,753,1626,334,652,986,32,1018
公投第１４案,臺北市,信義區,六合里,754,1561,361,555,916,25,941
公投第１４案,臺北市,信義區,六合里,755,1547,289,467,756,18,774
公投第１４案,臺北市,信義區,六合里,756,1336,291,455,746,22,768
公投第１４案,臺北市,信義區,泰和里,757,1314,252,408,660,32,692
公投第１４案,臺北市,信義區,泰和里,758,1297,261,436,697,30,727
公投第１４案,臺北市,信義區,泰和里,759,1366,257,478,735,34,769
公投第１４案,臺北市,信義區,泰和里,760,1472,300,494,794,51,845
公投第１４案,臺北市,信義區,泰和里,761,1450,289,513,802,35,837
公投第１４案,臺北市,信義區,景聯里,762,1328,269,460,729,44,773
公投第１４案,臺北市,信義區,景聯里,763,1399,307,515,822,39,861
公投第１４案,臺北市,信義區,景聯里,764,1373,303,498,801,48,849
公投第１４案,臺北市,信義區,景勤里,765,1099,216,376,592,25,617
公投第１４案,臺北市,信義區,景勤里,766,1226,260,413,673,37,710
公投第１４案,臺北市,信義區,景勤里,767,1267,258,423,681,16,697
公投第１４案,臺北市,信義區,雙和里,768,1531,288,571,859,41,900
公投第１４案,臺北市,信義區,雙和里,769,1438,270,567,837,37,874
公投第１４案,臺北市,信義區,雙和里,770,1657,344,553,897,21,918
公投第１４案,臺北市,信義區,雙和里,771,1621,367,457,824,37,861
公投第１４案,臺北市,信義區,嘉興里,772,1508,327,554,881,24,905
公投第１４案,臺北市,信義區,嘉興里,773,1334,292,488,780,33,813
公投第１４案,臺北市,信義區,黎順里,774,1246,200,362,562,33,595
公投第１４案,臺北市,信義區,黎順里,775,1196,280,446,726,35,761
公投第１４案,臺北市,信義區,黎順里,776,1220,278,437,715,24,739
公投第１４案,臺北市,信義區,黎平里,777,1538,304,542,846,21,867
公投第１４案,臺北市,信義區,黎平里,778,1565,321,569,890,55,945
公投第１４案,臺北市,信義區,黎平里,779,1621,315,509,824,69,893
公投第１４案,臺北市,信義區,黎平里,780,1486,302,495,797,44,841
公投第１４案,臺北市,信義區,黎忠里,781,1507,301,483,784,32,816
公投第１４案,臺北市,信義區,黎忠里,782,1516,317,542,859,42,901
公投第１４案,臺北市,信義區,黎忠里,783,1287,254,500,754,50,804
公投第１４案,臺北市,信義區,黎安里,784,1050,187,334,521,40,561
公投第１４案,臺北市,信義區,黎安里,785,801,118,351,469,27,496
公投第１４案,臺北市,中山區,正守里,786,1522,331,517,848,28,876
公投第１４案,臺北市,中山區,正守里,787,1332,275,350,625,25,650
公投第１４案,臺北市,中山區,正義里,788,1656,321,478,799,39,838
公投第１４案,臺北市,中山區,正義里,789,1367,269,402,671,37,708
公投第１４案,臺北市,中山區,正義里,790,1732,339,523,862,33,895
公投第１４案,臺北市,中山區,正得里,791,1634,351,547,898,43,941
公投第１４案,臺北市,中山區,正得里,792,1650,332,521,853,42,895
公投第１４案,臺北市,中山區,民安里,793,1392,298,491,789,35,824
公投第１４案,臺北市,中山區,民安里,794,1177,300,295,595,30,625
公投第１４案,臺北市,中山區,民安里,795,1477,350,499,849,35,884
公投第１４案,臺北市,中山區,康樂里,796,1063,211,324,535,46,581
公投第１４案,臺北市,中山區,康樂里,797,1296,232,441,673,33,706
公投第１４案,臺北市,中山區,中山里,798,1330,277,401,678,35,713
公投第１４案,臺北市,中山區,中山里,799,1483,287,467,754,53,807
公投第１４案,臺北市,中山區,中山里,800,1542,314,480,794,34,828
公投第１４案,臺北市,中山區,中山里,801,1710,352,483,835,47,882
公投第１４案,臺北市,中山區,聚盛里,802,1315,250,407,657,20,677
公投第１４案,臺北市,中山區,聚盛里,803,1245,240,424,664,47,711
公投第１４案,臺北市,中山區,聚盛里,804,1262,226,432,658,30,688
公投第１４案,臺北市,中山區,集英里,805,1518,350,476,826,53,879
公投第１４案,臺北市,中山區,集英里,806,1522,321,504,825,49,874
公投第１４案,臺北市,中山區,集英里,807,1580,301,481,782,46,828
公投第１４案,臺北市,中山區,集英里,808,1529,351,481,832,28,860
公投第１４案,臺北市,中山區,聚葉里,809,1221,252,389,641,36,677
公投第１４案,臺北市,中山區,聚葉里,810,1221,261,442,703,26,729
公投第１４案,臺北市,中山區,聚葉里,811,1139,206,342,548,26,574
公投第１４案,臺北市,中山區,恆安里,812,1407,285,469,754,52,806
公投第１４案,臺北市,中山區,恆安里,813,1321,317,414,731,28,759
公投第１４案,臺北市,中山區,恆安里,814,1578,291,480,771,26,797
公投第１４案,臺北市,中山區,晴光里,815,1739,311,542,853,40,893
公投第１４案,臺北市,中山區,晴光里,816,1637,331,487,818,38,856
公投第１４案,臺北市,中山區,晴光里,817,1541,317,478,795,47,842
公投第１４案,臺北市,中山區,圓山里,818,1210,280,413,693,28,721
公投第１４案,臺北市,中山區,圓山里,819,1331,389,415,804,35,839
公投第１４案,臺北市,中山區,圓山里,820,1224,250,348,598,43,641
公投第１４案,臺北市,中山區,新庄里,821,1585,293,576,869,44,913
公投第１４案,臺北市,中山區,新庄里,822,1523,345,551,896,51,947
公投第１４案,臺北市,中山區,新庄里,823,1368,294,509,803,39,842
公投第１４案,臺北市,中山區,劍潭里,824,1805,291,702,993,38,1031
公投第１４案,臺北市,中山區,劍潭里,825,1404,235,567,802,25,827
公投第１４案,臺北市,中山區,大直里,826,1708,428,624,1052,36,1088
公投第１４案,臺北市,中山區,大直里,827,1451,365,511,876,43,919
公投第１４案,臺北市,中山區,大直里,828,1684,369,591,960,34,994
公投第１４案,臺北市,中山區,大直里,829,1585,312,573,885,20,905
公投第１４案,臺北市,中山區,大直里,830,1391,294,487,781,60,841
公投第１４案,臺北市,中山區,成功里,831,1375,309,544,853,54,907
公投第１４案,臺北市,中山區,成功里,832,1472,363,501,864,17,881
公投第１４案,臺北市,中山區,成功里,833,1327,276,432,708,31,739
公投第１４案,臺北市,中山區,成功里,834,1401,345,467,812,16,828
公投第１４案,臺北市,中山區,永安里,835,1423,284,530,814,33,847
公投第１４案,臺北市,中山區,永安里,836,1569,367,534,901,26,927
公投第１４案,臺北市,中山區,永安里,837,1651,380,559,939,23,962
公投第１４案,臺北市,中山區,永安里,838,1624,382,501,883,21,904
公投第１４案,臺北市,中山區,永安里,839,1713,468,551,1019,36,1055
公投第１４案,臺北市,中山區,金泰里,840,1647,364,583,947,43,990
公投第１４案,臺北市,中山區,金泰里,841,1762,326,591,917,32,949
公投第１４案,臺北市,中山區,金泰里,842,1399,274,551,825,36,861
公投第１４案,臺北市,中山區,金泰里,843,1489,334,553,887,36,923
公投第１４案,臺北市,中山區,北安里,844,1269,290,470,760,27,787
公投第１４案,臺北市,中山區,北安里,845,998,205,401,606,28,634
公投第１４案,臺北市,中山區,新喜里,846,1472,312,477,789,43,832
公投第１４案,臺北市,中山區,新喜里,847,1517,331,452,783,45,828
公投第１４案,臺北市,中山區,新喜里,848,1704,362,608,970,53,1023
公投第１４案,臺北市,中山區,新福里,849,1603,346,535,881,45,926
公投第１４案,臺北市,中山區,新福里,850,1432,285,455,740,56,796
公投第１４案,臺北市,中山區,新福里,851,1500,340,491,831,67,898
公投第１４案,臺北市,中山區,松江里,852,1332,296,489,785,34,819
公投第１４案,臺北市,中山區,松江里,853,1450,331,517,848,43,891
公投第１４案,臺北市,中山區,松江里,854,1434,357,485,842,38,880
公投第１４案,臺北市,中山區,松江里,855,1419,282,476,758,38,796
公投第１４案,臺北市,中山區,新生里,856,1292,263,440,703,33,736
公投第１４案,臺北市,中山區,新生里,857,1526,336,468,804,45,849
公投第１４案,臺北市,中山區,新生里,858,1582,302,455,757,42,799
公投第１４案,臺北市,中山區,中庄里,859,1588,316,471,787,42,829
公投第１４案,臺北市,中山區,中庄里,860,1463,294,528,822,52,874
公投第１４案,臺北市,中山區,中庄里,861,1533,337,418,755,39,794
公投第１４案,臺北市,中山區,大佳里,862,944,183,307,490,42,532
公投第１４案,臺北市,中山區,行政里,863,1745,374,657,1031,59,1090
公投第１４案,臺北市,中山區,行政里,864,1679,337,467,804,38,842
公投第１４案,臺北市,中山區,行政里,865,3419,311,471,782,41,823
公投第１４案,臺北市,中山區,行仁里,866,1387,321,468,789,46,835
公投第１４案,臺北市,中山區,行仁里,867,1672,369,571,940,52,992
公投第１４案,臺北市,中山區,行仁里,868,1319,287,440,727,49,776
公投第１４案,臺北市,中山區,行仁里,869,1364,284,446,730,42,772
公投第１４案,臺北市,中山區,行仁里,870,1461,320,452,772,45,817
公投第１４案,臺北市,中山區,行孝里,871,1173,262,395,657,41,698
公投第１４案,臺北市,中山區,行孝里,872,1171,245,371,616,41,657
公投第１４案,臺北市,中山區,行孝里,873,1310,312,404,716,28,744
公投第１４案,臺北市,中山區,下埤里,874,1373,300,438,738,43,781
公投第１４案,臺北市,中山區,下埤里,875,1290,303,468,771,28,799
公投第１４案,臺北市,中山區,下埤里,876,1346,289,474,763,40,803
公投第１４案,臺北市,中山區,下埤里,877,1468,358,479,837,53,890
公投第１４案,臺北市,中山區,下埤里,878,1178,264,422,686,24,710
公投第１４案,臺北市,中山區,江寧里,879,1654,368,585,953,38,991
公投第１４案,臺北市,中山區,江寧里,880,1464,333,485,818,42,860
公投第１４案,臺北市,中山區,江寧里,881,1450,304,476,780,39,819
公投第１４案,臺北市,中山區,江寧里,882,1534,340,494,834,37,871
公投第１４案,臺北市,中山區,江山里,883,1703,364,556,920,47,967
公投第１４案,臺北市,中山區,江山里,884,1610,338,572,910,47,957
公投第１４案,臺北市,中山區,江山里,885,1653,379,566,945,52,997
公投第１４案,臺北市,中山區,江山里,886,1694,426,556,982,51,1033
公投第１４案,臺北市,中山區,中吉里,887,1623,325,537,862,40,902
公投第１４案,臺北市,中山區,中吉里,888,1618,361,540,901,43,944
公投第１４案,臺北市,中山區,中吉里,889,1583,329,518,847,49,896
公投第１４案,臺北市,中山區,中原里,890,1605,390,526,916,48,964
公投第１４案,臺北市,中山區,中原里,891,1398,330,512,842,48,890
公投第１４案,臺北市,中山區,中原里,892,1526,393,547,940,51,991
公投第１４案,臺北市,中山區,興亞里,893,1555,354,521,875,41,916
公投第１４案,臺北市,中山區,興亞里,894,1597,327,532,859,35,894
公投第１４案,臺北市,中山區,興亞里,895,1587,369,507,876,61,937
公投第１４案,臺北市,中山區,中央里,896,1587,391,536,927,37,964
公投第１４案,臺北市,中山區,中央里,897,1546,367,540,907,47,954
公投第１４案,臺北市,中山區,朱馥里,898,1322,244,463,707,48,755
公投第１４案,臺北市,中山區,朱馥里,899,1267,262,447,709,32,741
公投第１４案,臺北市,中山區,朱馥里,900,1210,253,414,667,20,687
公投第１４案,臺北市,中山區,朱馥里,901,1295,257,448,705,43,748
公投第１４案,臺北市,中山區,龍洲里,902,1467,325,523,848,41,889
公投第１４案,臺北市,中山區,龍洲里,903,1491,281,622,903,39,942
公投第１４案,臺北市,中山區,龍洲里,904,1516,320,625,945,44,989
公投第１４案,臺北市,中山區,朱園里,905,1384,294,427,721,24,745
公投第１４案,臺北市,中山區,朱園里,906,1138,316,366,682,47,729
公投第１４案,臺北市,中山區,朱園里,907,1513,313,468,781,33,814
公投第１４案,臺北市,中山區,埤頭里,908,1559,353,527,880,47,927
公投第１４案,臺北市,中山區,埤頭里,909,1429,315,513,828,58,886
公投第１４案,臺北市,中山區,朱崙里,910,1245,295,449,744,27,771
公投第１４案,臺北市,中山區,朱崙里,911,1214,267,459,726,42,768
公投第１４案,臺北市,中山區,力行里,912,1394,314,503,817,26,843
公投第１４案,臺北市,中山區,力行里,913,1336,276,430,706,17,723
公投第１４案,臺北市,中山區,力行里,914,1227,281,389,670,35,705
公投第１４案,臺北市,中山區,力行里,915,1382,281,481,762,40,802
公投第１４案,臺北市,中山區,復華里,916,1436,263,510,773,48,821
公投第１４案,臺北市,中山區,復華里,917,1405,298,397,695,44,739
公投第１４案,臺北市,中山區,復華里,918,1259,262,442,704,24,728
公投第１４案,臺北市,大同區,玉泉里,919,1261,300,410,710,43,753
公投第１４案,臺北市,大同區,玉泉里,920,1352,317,477,794,42,836
公投第１４案,臺北市,大同區,建明里,921,1462,315,490,805,34,839
公投第１４案,臺北市,大同區,建明里,922,1510,324,503,827,44,871
公投第１４案,臺北市,大同區,建功里,923,1496,321,451,772,30,802
公投第１４案,臺北市,大同區,建功里,924,1329,274,433,707,48,755
公投第１４案,臺北市,大同區,建功里,925,1307,265,432,697,72,769
公投第１４案,臺北市,大同區,建泰里,926,1065,242,348,590,43,633
公投第１４案,臺北市,大同區,建泰里,927,1085,259,354,613,18,631
公投第１４案,臺北市,大同區,建泰里,928,1047,257,374,631,41,672
公投第１４案,臺北市,大同區,永樂里,929,1215,293,333,626,30,656
公投第１４案,臺北市,大同區,永樂里,930,1117,293,373,666,35,701
公投第１４案,臺北市,大同區,永樂里,931,1186,279,413,692,39,731
公投第１４案,臺北市,大同區,永樂里,932,1185,248,428,676,51,727
公投第１４案,臺北市,大同區,朝陽里,933,1359,277,478,755,37,792
公投第１４案,臺北市,大同區,朝陽里,934,1273,259,457,716,25,741
公投第１４案,臺北市,大同區,朝陽里,935,1291,339,374,713,40,753
公投第１４案,臺北市,大同區,星明里,936,1288,275,410,685,32,717
公投第１４案,臺北市,大同區,星明里,937,1245,299,455,754,31,785
公投第１４案,臺北市,大同區,星明里,938,1261,319,426,745,43,788
公投第１４案,臺北市,大同區,星明里,939,1348,293,432,725,28,753
公投第１４案,臺北市,大同區,光能里,940,1676,387,533,920,68,988
公投第１４案,臺北市,大同區,光能里,941,1311,276,497,773,33,806
公投第１４案,臺北市,大同區,光能里,942,1316,295,448,743,58,801
公投第１４案,臺北市,大同區,大有里,943,1409,332,438,770,57,827
公投第１４案,臺北市,大同區,大有里,944,1436,351,473,824,48,872
公投第１４案,臺北市,大同區,大有里,945,1408,307,477,784,45,829
公投第１４案,臺北市,大同區,延平里,946,1276,260,436,696,39,735
公投第１４案,臺北市,大同區,延平里,947,1110,219,398,617,20,637
公投第１４案,臺北市,大同區,延平里,948,1324,310,451,761,20,781
公投第１４案,臺北市,大同區,雙連里,949,1016,195,360,555,44,599
公投第１４案,臺北市,大同區,雙連里,950,1028,233,378,611,33,644
公投第１４案,臺北市,大同區,雙連里,951,1158,231,429,660,39,699
公投第１４案,臺北市,大同區,雙連里,952,1138,237,434,671,30,701
公投第１４案,臺北市,大同區,雙連里,953,1214,254,453,707,29,736
公投第１４案,臺北市,大同區,雙連里,954,1090,224,392,616,23,639
公投第１４案,臺北市,大同區,雙連里,955,1305,308,419,727,47,774
公投第１４案,臺北市,大同區,南芳里,956,1167,237,388,625,28,653
公投第１４案,臺北市,大同區,南芳里,957,1148,252,387,639,39,678
公投第１４案,臺北市,大同區,南芳里,958,1203,287,433,720,30,750
公投第１４案,臺北市,大同區,民權里,959,1441,320,452,772,37,809
公投第１４案,臺北市,大同區,民權里,960,1315,477,294,771,51,822
公投第１４案,臺北市,大同區,民權里,961,1393,315,450,765,40,805
公投第１４案,臺北市,大同區,民權里,962,1278,214,520,734,39,773
公投第１４案,臺北市,大同區,景星里,963,1246,355,299,654,38,692
公投第１４案,臺北市,大同區,景星里,964,1142,232,380,612,53,665
公投第１４案,臺北市,大同區,隆和里,965,1336,297,478,775,47,822
公投第１４案,臺北市,大同區,隆和里,966,1363,325,471,796,41,837
公投第１４案,臺北市,大同區,蓬萊里,967,1476,303,547,850,28,878
公投第１４案,臺北市,大同區,蓬萊里,968,1418,357,438,795,47,842
公投第１４案,臺北市,大同區,蓬萊里,969,1460,294,479,773,30,803
公投第１４案,臺北市,大同區,國順里,970,1222,252,347,599,38,637
公投第１４案,臺北市,大同區,國順里,971,1246,222,356,578,73,651
公投第１４案,臺北市,大同區,國慶里,972,1256,279,460,739,47,786
公投第１４案,臺北市,大同區,國慶里,973,1289,280,444,724,28,752
公投第１４案,臺北市,大同區,國慶里,974,1340,291,429,720,24,744
公投第１４案,臺北市,大同區,揚雅里,975,1555,322,473,795,42,837
公投第１４案,臺北市,大同區,揚雅里,976,2459,274,508,782,56,838
公投第１４案,臺北市,大同區,斯文里,977,1108,176,305,481,56,537
公投第１４案,臺北市,大同區,斯文里,978,867,160,288,448,37,485
公投第１４案,臺北市,大同區,斯文里,979,1329,326,440,766,56,822
公投第１４案,臺北市,大同區,斯文里,980,1162,281,358,639,37,676
公投第１４案,臺北市,大同區,鄰江里,981,1434,272,454,726,66,792
公投第１４案,臺北市,大同區,鄰江里,982,1351,315,428,743,51,794
公投第１４案,臺北市,大同區,鄰江里,983,1531,321,465,786,48,834
公投第１４案,臺北市,大同區,鄰江里,984,1507,328,420,748,24,772
公投第１４案,臺北市,大同區,至聖里,985,1488,338,454,792,49,841
公投第１４案,臺北市,大同區,至聖里,986,1384,325,472,797,58,855
公投第１４案,臺北市,大同區,至聖里,987,1460,278,523,801,53,854
公投第１４案,臺北市,大同區,至聖里,988,1371,310,478,788,45,833
公投第１４案,臺北市,大同區,至聖里,989,1439,310,463,773,27,800
公投第１４案,臺北市,大同區,老師里,990,1376,335,443,778,58,836
公投第１４案,臺北市,大同區,老師里,991,1366,271,445,716,67,783
公投第１４案,臺北市,大同區,老師里,992,1218,297,440,737,49,786
公投第１４案,臺北市,大同區,老師里,993,1235,247,439,686,44,730
公投第１４案,臺北市,大同區,重慶里,994,1364,234,486,720,19,739
公投第１４案,臺北市,大同區,重慶里,995,1408,345,514,859,52,911
公投第１４案,臺北市,大同區,重慶里,996,1450,326,473,799,52,851
公投第１４案,臺北市,大同區,重慶里,997,1429,318,514,832,56,888
公投第１４案,臺北市,大同區,保安里,998,1170,259,399,658,58,716
公投第１４案,臺北市,大同區,保安里,999,1245,271,462,733,5,738
公投第１４案,臺北市,大同區,保安里,1000,1215,302,428,730,60,790
公投第１４案,臺北市,中正區,水源里,1001,1308,292,466,758,33,791
公投第１４案,臺北市,中正區,水源里,1002,1317,269,432,701,43,744
公投第１４案,臺北市,中正區,富水里,1003,1069,223,418,641,23,664
公投第１４案,臺北市,中正區,富水里,1004,1128,228,373,601,31,632
公投第１４案,臺北市,中正區,文盛里,1005,1053,237,370,607,39,646
公投第１４案,臺北市,中正區,文盛里,1006,1048,225,386,611,11,622
公投第１４案,臺北市,中正區,林興里,1007,1297,244,455,699,42,741
公投第１４案,臺北市,中正區,林興里,1008,1193,255,448,703,20,723
公投第１４案,臺北市,中正區,林興里,1009,1500,341,599,940,35,975
公投第１４案,臺北市,中正區,河堤里,1010,1346,294,440,734,31,765
公投第１４案,臺北市,中正區,河堤里,1011,1283,283,435,718,16,734
公投第１４案,臺北市,中正區,河堤里,1012,1450,339,459,798,31,829
公投第１４案,臺北市,中正區,頂東里,1013,1433,326,496,822,34,856
公投第１４案,臺北市,中正區,頂東里,1014,1309,325,493,818,44,862
公投第１４案,臺北市,中正區,頂東里,1015,1386,304,518,822,12,834
公投第１４案,臺北市,中正區,頂東里,1016,1201,265,429,694,34,728
公投第１４案,臺北市,中正區,網溪里,1017,1336,300,493,793,30,823
公投第１４案,臺北市,中正區,網溪里,1018,1358,307,492,799,31,830
公投第１４案,臺北市,中正區,網溪里,1019,1177,260,424,684,36,720
公投第１４案,臺北市,中正區,網溪里,1020,1236,263,493,756,27,783
公投第１４案,臺北市,中正區,板溪里,1021,1478,290,526,816,44,860
公投第１４案,臺北市,中正區,板溪里,1022,1474,322,533,855,26,881
公投第１４案,臺北市,中正區,螢圃里,1023,1172,250,408,658,35,693
公投第１４案,臺北市,中正區,螢圃里,1024,1310,276,447,723,48,771
公投第１４案,臺北市,中正區,螢圃里,1025,1263,246,474,720,39,759
公投第１４案,臺北市,中正區,螢圃里,1026,1169,261,411,672,36,708
公投第１４案,臺北市,中正區,螢雪里,1027,1391,292,505,797,18,815
公投第１４案,臺北市,中正區,螢雪里,1028,1201,225,435,660,19,679
公投第１４案,臺北市,中正區,螢雪里,1029,1324,272,494,766,30,796
公投第１４案,臺北市,中正區,永功里,1030,1216,221,426,647,43,690
公投第１４案,臺北市,中正區,永功里,1031,1183,249,399,648,41,689
公投第１４案,臺北市,中正區,永功里,1032,1469,325,508,833,59,892
公投第１４案,臺北市,中正區,永功里,1033,1411,305,486,791,32,823
公投第１４案,臺北市,中正區,永昌里,1034,1398,284,486,770,75,845
公投第１４案,臺北市,中正區,永昌里,1035,1479,263,517,780,67,847
公投第１４案,臺北市,中正區,永昌里,1036,1620,319,544,863,51,914
公投第１４案,臺北市,中正區,龍興里,1037,1041,232,370,602,13,615
公投第１４案,臺北市,中正區,龍興里,1038,1056,244,355,599,16,615
公投第１４案,臺北市,中正區,龍興里,1039,1063,249,409,658,23,681
公投第１４案,臺北市,中正區,忠勤里,1040,1591,244,467,711,38,749
公投第１４案,臺北市,中正區,忠勤里,1041,1502,222,445,667,51,718
公投第１４案,臺北市,中正區,忠勤里,1042,1331,236,432,668,47,715
公投第１４案,臺北市,中正區,忠勤里,1043,1441,261,500,761,56,817
公投第１４案,臺北市,中正區,廈安里,1044,1273,300,468,768,31,799
公投第１４案,臺北市,中正區,廈安里,1045,1133,227,449,676,23,699
公投第１４案,臺北市,中正區,廈安里,1046,1156,199,468,667,26,693
公投第１４案,臺北市,中正區,愛國里,1047,1377,300,460,760,40,800
公投第１４案,臺北市,中正區,愛國里,1048,1266,254,480,734,50,784
公投第１４案,臺北市,中正區,南門里,1049,1111,235,454,689,25,714
公投第１４案,臺北市,中正區,南門里,1050,1124,263,390,653,26,679
公投第１４案,臺北市,中正區,龍光里,1051,1373,306,519,825,28,853
公投第１４案,臺北市,中正區,龍光里,1052,1351,292,519,811,27,838
公投第１４案,臺北市,中正區,南福里,1053,1495,324,542,866,25,891
公投第１４案,臺北市,中正區,南福里,1054,1436,341,545,886,33,919
公投第１４案,臺北市,中正區,南福里,1055,1516,319,532,851,21,872
公投第１４案,臺北市,中正區,南福里,1056,1374,284,491,775,32,807
公投第１４案,臺北市,中正區,南福里,1057,1522,289,525,814,25,839
公投第１４案,臺北市,中正區,南福里,1058,1336,291,582,873,27,900
公投第１４案,臺北市,中正區,龍福里,1059,1551,358,528,886,32,918
公投第１４案,臺北市,中正區,龍福里,1060,1594,339,571,910,46,956
公投第１４案,臺北市,中正區,龍福里,1061,1503,316,518,834,39,873
公投第１４案,臺北市,中正區,新營里,1062,1455,289,552,841,23,864
公投第１４案,臺北市,中正區,新營里,1063,1439,309,512,821,15,836
公投第１４案,臺北市,中正區,新營里,1064,1469,306,521,827,38,865
公投第１４案,臺北市,中正區,新營里,1065,1430,245,597,842,33,875
公投第１４案,臺北市,中正區,新營里,1066,1444,316,547,863,29,892
公投第１４案,臺北市,中正區,建國里,1067,1254,254,467,721,19,740
公投第１４案,臺北市,中正區,光復里,1068,932,206,328,534,38,572
公投第１４案,臺北市,中正區,光復里,1069,1055,235,378,613,32,645
公投第１４案,臺北市,中正區,光復里,1070,1226,251,445,696,26,722
公投第１４案,臺北市,中正區,黎明里,1071,1390,236,465,701,34,735
公投第１４案,臺北市,中正區,黎明里,1072,1336,289,462,751,28,779
公投第１４案,臺北市,中正區,梅花里,1073,1419,285,430,715,29,744
公投第１４案,臺北市,中正區,梅花里,1074,1361,307,493,800,46,846
公投第１４案,臺北市,中正區,幸福里,1075,2520,302,567,869,43,912
公投第１４案,臺北市,中正區,幸福里,1076,1224,254,458,712,11,723
公投第１４案,臺北市,中正區,幸福里,1077,1272,254,416,670,5,675
公投第１４案,臺北市,中正區,幸市里,1078,1400,331,462,793,26,819
公投第１４案,臺北市,中正區,幸市里,1079,1319,273,445,718,31,749
公投第１４案,臺北市,中正區,幸市里,1080,1232,263,462,725,41,766
公投第１４案,臺北市,中正區,東門里,1081,1265,308,477,785,24,809
公投第１４案,臺北市,中正區,東門里,1082,1055,250,403,653,20,673
公投第１４案,臺北市,中正區,東門里,1083,954,207,333,540,26,566
公投第１４案,臺北市,中正區,文北里,1084,1018,206,373,579,39,618
公投第１４案,臺北市,中正區,文北里,1085,1431,301,489,790,20,810
公投第１４案,臺北市,中正區,文北里,1086,1271,276,366,642,34,676
公投第１４案,臺北市,中正區,文北里,1087,983,227,364,591,25,616
公投第１４案,臺北市,中正區,文祥里,1088,1594,334,550,884,28,912
公投第１４案,臺北市,中正區,文祥里,1089,1565,345,564,909,39,948
公投第１４案,臺北市,中正區,文祥里,1090,1650,342,587,929,28,957
公投第１４案,臺北市,中正區,文祥里,1091,1600,314,533,847,36,883
公投第１４案,臺北市,中正區,三愛里,1092,1391,293,471,764,30,794
公投第１４案,臺北市,中正區,三愛里,1093,1769,373,598,971,28,999
公投第１４案,臺北市,中正區,三愛里,1094,1487,342,510,852,32,884
公投第１４案,臺北市,中正區,三愛里,1095,1291,275,474,749,34,783
公投第１４案,臺北市,中正區,三愛里,1096,1289,300,450,750,30,780
公投第１４案,臺北市,萬華區,福星里,1097,1305,291,446,737,47,784
公投第１４案,臺北市,萬華區,福星里,1098,1183,192,357,549,55,604
公投第１４案,臺北市,萬華區,福星里,1099,1176,228,406,634,22,656
公投第１４案,臺北市,萬華區,福星里,1100,1169,239,346,585,26,611
公投第１４案,臺北市,萬華區,萬壽里,1101,1457,231,473,704,37,741
公投第１４案,臺北市,萬華區,萬壽里,1102,1563,266,438,704,56,760
公投第１４案,臺北市,萬華區,西門里,1103,1771,341,505,846,23,869
公投第１４案,臺北市,萬華區,西門里,1104,1615,331,464,795,39,834
公投第１４案,臺北市,萬華區,新起里,1105,1478,314,451,765,67,832
公投第１４案,臺北市,萬華區,新起里,1106,1462,293,481,774,27,801
公投第１４案,臺北市,萬華區,新起里,1107,1507,226,467,693,43,736
公投第１４案,臺北市,萬華區,新起里,1108,1347,287,455,742,47,789
公投第１４案,臺北市,萬華區,菜園里,1109,1367,263,427,690,43,733
公投第１４案,臺北市,萬華區,菜園里,1110,1277,296,449,745,39,784
公投第１４案,臺北市,萬華區,菜園里,1111,1395,332,458,790,49,839
公投第１４案,臺北市,萬華區,菜園里,1112,1450,304,434,738,46,784
公投第１４案,臺北市,萬華區,青山里,1113,1340,261,401,662,35,697
公投第１４案,臺北市,萬華區,青山里,1114,1242,243,382,625,40,665
公投第１４案,臺北市,萬華區,青山里,1115,1286,235,423,658,56,714
公投第１４案,臺北市,萬華區,青山里,1116,1324,234,451,685,39,724
公投第１４案,臺北市,萬華區,富民里,1117,1619,327,469,796,59,855
公投第１４案,臺北市,萬華區,富民里,1118,1352,235,382,617,59,676
公投第１４案,臺北市,萬華區,富民里,1119,1440,269,471,740,39,779
公投第１４案,臺北市,萬華區,福音里,1120,1194,290,382,672,48,720
公投第１４案,臺北市,萬華區,福音里,1121,1083,228,419,647,43,690
公投第１４案,臺北市,萬華區,福音里,1122,1237,260,369,629,54,683
公投第１４案,臺北市,萬華區,仁德里,1123,1625,361,489,850,36,886
公投第１４案,臺北市,萬華區,仁德里,1124,1324,290,467,757,47,804
公投第１４案,臺北市,萬華區,仁德里,1125,1352,321,433,754,52,806
公投第１４案,臺北市,萬華區,富福里,1126,2630,279,426,705,35,740
公投第１４案,臺北市,萬華區,富福里,1127,1504,336,513,849,62,911
公投第１４案,臺北市,萬華區,富福里,1128,1425,296,449,745,48,793
公投第１４案,臺北市,萬華區,柳鄉里,1129,1591,287,470,757,61,818
公投第１４案,臺北市,萬華區,柳鄉里,1130,1474,282,473,755,60,815
公投第１４案,臺北市,萬華區,柳鄉里,1131,1612,325,465,790,59,849
公投第１４案,臺北市,萬華區,華江里,1132,1447,267,483,750,56,806
公投第１４案,臺北市,萬華區,華江里,1133,1491,285,525,810,56,866
公投第１４案,臺北市,萬華區,華江里,1134,1500,322,533,855,43,898
公投第１４案,臺北市,萬華區,華江里,1135,1582,323,561,884,48,932
公投第１４案,臺北市,萬華區,華江里,1136,1623,296,478,774,54,828
公投第１４案,臺北市,萬華區,糖廍里,1137,1228,260,390,650,25,675
公投第１４案,臺北市,萬華區,糖廍里,1138,1268,236,434,670,54,724
公投第１４案,臺北市,萬華區,糖廍里,1139,1207,253,429,682,53,735
公投第１４案,臺北市,萬華區,糖廍里,1140,1188,397,282,679,36,715
公投第１４案,臺北市,萬華區,綠堤里,1141,1474,281,472,753,42,795
公投第１４案,臺北市,萬華區,綠堤里,1142,1304,221,393,614,22,636
公投第１４案,臺北市,萬華區,綠堤里,1143,1082,156,275,431,47,478
公投第１４案,臺北市,萬華區,頂碩里,1144,1052,217,316,533,32,565
公投第１４案,臺北市,萬華區,頂碩里,1145,1135,243,364,607,36,643
公投第１４案,臺北市,萬華區,頂碩里,1146,1225,235,403,638,55,693
公投第１４案,臺北市,萬華區,頂碩里,1147,1583,293,502,795,43,838
公投第１４案,臺北市,萬華區,頂碩里,1148,1403,311,423,734,51,785
公投第１４案,臺北市,萬華區,雙園里,1149,1406,306,461,767,47,814
公投第１４案,臺北市,萬華區,雙園里,1150,1401,284,481,765,51,816
公投第１４案,臺北市,萬華區,雙園里,1151,1188,284,381,665,47,712
公投第１４案,臺北市,萬華區,和平里,1152,1597,306,498,804,61,865
公投第１４案,臺北市,萬華區,和平里,1153,1290,276,453,729,70,799
公投第１４案,臺北市,萬華區,和平里,1154,1746,319,517,836,34,870
公投第１４案,臺北市,萬華區,和平里,1155,1595,281,441,722,39,761
公投第１４案,臺北市,萬華區,和德里,1156,1701,332,522,854,81,935
公投第１４案,臺北市,萬華區,和德里,1157,1339,228,380,608,57,665
公投第１４案,臺北市,萬華區,和德里,1158,1484,245,439,684,69,753
公投第１４案,臺北市,萬華區,和德里,1159,1604,312,536,848,63,911
公投第１４案,臺北市,萬華區,全德里,1160,1197,253,417,670,31,701
公投第１４案,臺北市,萬華區,全德里,1161,1347,274,401,675,67,742
公投第１４案,臺北市,萬華區,全德里,1162,1223,305,438,743,43,786
公投第１４案,臺北市,萬華區,日善里,1163,1036,232,374,606,26,632
公投第１４案,臺北市,萬華區,日善里,1164,1035,249,380,629,38,667
公投第１４案,臺北市,萬華區,日善里,1165,1141,256,409,665,39,704
公投第１４案,臺北市,萬華區,忠德里,1166,1271,259,462,721,30,751
公投第１４案,臺北市,萬華區,忠德里,1167,1328,293,456,749,60,809
公投第１４案,臺北市,萬華區,忠德里,1168,1286,261,455,716,46,762
公投第１４案,臺北市,萬華區,錦德里,1169,1679,363,563,926,64,990
公投第１４案,臺北市,萬華區,錦德里,1170,1619,339,519,858,55,913
公投第１４案,臺北市,萬華區,錦德里,1171,1625,306,480,786,37,823
公投第１４案,臺北市,萬華區,孝德里,1172,1623,304,597,901,52,953
公投第１４案,臺北市,萬華區,孝德里,1173,1280,235,430,665,56,721
公投第１４案,臺北市,萬華區,壽德里,1174,1608,325,587,912,62,974
公投第１４案,臺北市,萬華區,壽德里,1175,1453,306,493,799,53,852
公投第１４案,臺北市,萬華區,壽德里,1176,1472,321,548,869,43,912
公投第１４案,臺北市,萬華區,銘德里,1177,1373,318,446,764,33,797
公投第１４案,臺北市,萬華區,銘德里,1178,1394,266,455,721,54,775
公投第１４案,臺北市,萬華區,銘德里,1179,1427,275,458,733,27,760
公投第１４案,臺北市,萬華區,保德里,1180,1342,296,494,790,41,831
公投第１４案,臺北市,萬華區,保德里,1181,1569,318,555,873,70,943
公投第１４案,臺北市,萬華區,榮德里,1182,1514,238,472,710,50,760
公投第１４案,臺北市,萬華區,榮德里,1183,1720,303,501,804,37,841
公投第１４案,臺北市,萬華區,華中里,1184,1461,317,545,862,60,922
公投第１４案,臺北市,萬華區,華中里,1185,1264,255,419,674,32,706
公投第１４案,臺北市,萬華區,華中里,1186,1334,274,500,774,58,832
公投第１４案,臺北市,萬華區,華中里,1187,1446,336,487,823,34,857
公投第１４案,臺北市,萬華區,興德里,1188,1307,226,426,652,34,686
公投第１４案,臺北市,萬華區,興德里,1189,1420,273,510,783,61,844
公投第１４案,臺北市,萬華區,興德里,1190,1427,278,428,706,44,750
公投第１４案,臺北市,萬華區,日祥里,1191,956,165,339,504,42,546
公投第１４案,臺北市,萬華區,日祥里,1192,1352,246,474,720,77,797
公投第１４案,臺北市,萬華區,日祥里,1193,1370,239,495,734,47,781
公投第１４案,臺北市,萬華區,日祥里,1194,1222,205,496,701,29,730
公投第１４案,臺北市,萬華區,忠貞里,1195,1375,205,553,758,37,795
公投第１４案,臺北市,萬華區,忠貞里,1196,1463,248,559,807,43,850
公投第１４案,臺北市,萬華區,忠貞里,1197,1527,257,523,780,42,822
公投第１４案,臺北市,萬華區,新忠里,1198,1485,238,542,780,36,816
公投第１４案,臺北市,萬華區,新忠里,1199,1591,237,705,942,37,979
公投第１４案,臺北市,萬華區,新和里,1200,1394,275,597,872,38,910
公投第１４案,臺北市,萬華區,新和里,1201,1522,283,612,895,28,923
公投第１４案,臺北市,萬華區,新和里,1202,1661,278,696,974,32,1006
公投第１４案,臺北市,萬華區,新和里,1203,1561,300,530,830,39,869
公投第１４案,臺北市,萬華區,新和里,1204,1406,297,569,866,41,907
公投第１４案,臺北市,萬華區,新安里,1205,1498,256,413,669,40,709
公投第１４案,臺北市,萬華區,新安里,1206,1478,218,443,661,48,709
公投第１４案,臺北市,萬華區,新安里,1207,1170,217,387,604,46,650
公投第１４案,臺北市,萬華區,新安里,1208,1376,244,529,773,43,816
公投第１４案,臺北市,萬華區,凌霄里,1209,1093,219,386,605,19,624
公投第１４案,臺北市,萬華區,凌霄里,1210,1084,227,403,630,54,684
公投第１４案,臺北市,萬華區,凌霄里,1211,1119,218,409,627,50,677
公投第１４案,臺北市,萬華區,騰雲里,1212,1381,281,552,833,23,856
公投第１４案,臺北市,萬華區,騰雲里,1213,1396,302,489,791,32,823
公投第１４案,臺北市,大安區,德安里,1214,1184,241,396,637,22,659
公投第１４案,臺北市,大安區,德安里,1215,1197,234,393,627,34,661
公投第１４案,臺北市,大安區,德安里,1216,1221,267,430,697,16,713
公投第１４案,臺北市,大安區,德安里,1217,1246,244,480,724,22,746
公投第１４案,臺北市,大安區,仁慈里,1218,1478,377,509,886,25,911
公投第１４案,臺北市,大安區,仁慈里,1219,1314,317,410,727,32,759
公投第１４案,臺北市,大安區,仁慈里,1220,1594,381,548,929,37,966
公投第１４案,臺北市,大安區,和安里,1221,1429,318,514,832,24,856
公投第１４案,臺北市,大安區,和安里,1222,1452,298,567,865,27,892
公投第１４案,臺北市,大安區,和安里,1223,1551,380,505,885,20,905
公投第１４案,臺北市,大安區,和安里,1224,1335,294,489,783,37,820
公投第１４案,臺北市,大安區,民炤里,1225,1196,239,395,634,27,661
公投第１４案,臺北市,大安區,民炤里,1226,1339,262,445,707,28,735
公投第１４案,臺北市,大安區,民炤里,1227,1448,346,462,808,28,836
公投第１４案,臺北市,大安區,民炤里,1228,1373,280,477,757,41,798
公投第１４案,臺北市,大安區,民炤里,1229,1439,287,507,794,47,841
公投第１４案,臺北市,大安區,仁愛里,1230,1174,246,380,626,7,633
公投第１４案,臺北市,大安區,仁愛里,1231,1144,223,378,601,15,616
公投第１４案,臺北市,大安區,仁愛里,1232,1119,166,411,577,25,602
公投第１４案,臺北市,大安區,仁愛里,1233,1024,187,293,480,21,501
公投第１４案,臺北市,大安區,義村里,1234,1032,189,418,607,20,627
公投第１４案,臺北市,大安區,義村里,1235,1319,222,543,765,26,791
公投第１４案,臺北市,大安區,義村里,1236,1369,281,536,817,25,842
公投第１４案,臺北市,大安區,義村里,1237,1347,320,445,765,38,803
公投第１４案,臺北市,大安區,民輝里,1238,1655,334,508,842,25,867
公投第１４案,臺北市,大安區,民輝里,1239,1595,284,505,789,26,815
公投第１４案,臺北市,大安區,民輝里,1240,1429,291,470,761,29,790
公投第１４案,臺北市,大安區,民輝里,1241,1309,252,431,683,24,707
公投第１４案,臺北市,大安區,昌隆里,1242,1508,283,519,802,22,824
公投第１４案,臺北市,大安區,昌隆里,1243,1310,286,405,691,39,730
公投第１４案,臺北市,大安區,誠安里,1244,1233,227,410,637,29,666
公投第１４案,臺北市,大安區,誠安里,1245,1287,254,406,660,38,698
公投第１４案,臺北市,大安區,誠安里,1246,1147,223,362,585,28,613
公投第１４案,臺北市,大安區,光武里,1247,1260,244,419,663,17,680
公投第１４案,臺北市,大安區,光武里,1248,1377,264,564,828,32,860
公投第１４案,臺北市,大安區,光武里,1249,1284,265,391,656,61,717
公投第１４案,臺北市,大安區,光武里,1250,1314,241,424,665,25,690
公投第１４案,臺北市,大安區,光武里,1251,1273,249,410,659,25,684
公投第１４案,臺北市,大安區,龍坡里,1252,1146,282,380,662,20,682
公投第１４案,臺北市,大安區,龍坡里,1253,1285,286,463,749,20,769
公投第１４案,臺北市,大安區,龍坡里,1254,1297,317,446,763,25,788
公投第１４案,臺北市,大安區,龍坡里,1255,1101,252,405,657,33,690
公投第１４案,臺北市,大安區,龍泉里,1256,1310,307,420,727,34,761
公投第１４案,臺北市,大安區,龍泉里,1257,1365,322,510,832,39,871
公投第１４案,臺北市,大安區,龍泉里,1258,1372,302,464,766,27,793
公投第１４案,臺北市,大安區,古風里,1259,1189,289,424,713,24,737
公投第１４案,臺北市,大安區,古風里,1260,1256,286,451,737,24,761
公投第１４案,臺北市,大安區,古風里,1261,1151,274,400,674,32,706
公投第１４案,臺北市,大安區,古莊里,1262,1501,337,552,889,31,920
公投第１４案,臺北市,大安區,古莊里,1263,1520,318,577,895,19,914
公投第１４案,臺北市,大安區,古莊里,1264,1529,340,579,919,37,956
公投第１４案,臺北市,大安區,古莊里,1265,1579,367,565,932,33,965
公投第１４案,臺北市,大安區,龍安里,1266,2619,273,398,671,18,689
公投第１４案,臺北市,大安區,龍安里,1267,1290,294,444,738,19,757
公投第１４案,臺北市,大安區,龍安里,1268,1307,320,486,806,20,826
公投第１４案,臺北市,大安區,龍安里,1269,1489,393,501,894,23,917
公投第１４案,臺北市,大安區,錦安里,1270,1097,243,413,656,30,686
公投第１４案,臺北市,大安區,錦安里,1271,1328,308,448,756,24,780
公投第１４案,臺北市,大安區,錦安里,1272,1189,282,380,662,22,684
公投第１４案,臺北市,大安區,錦安里,1273,1270,289,449,738,20,758
公投第１４案,臺北市,大安區,福住里,1274,1349,336,431,767,13,780
公投第１４案,臺北市,大安區,福住里,1275,1292,305,406,711,25,736
公投第１４案,臺北市,大安區,福住里,1276,1314,306,471,777,33,810
公投第１４案,臺北市,大安區,福住里,1277,1200,289,409,698,35,733
公投第１４案,臺北市,大安區,永康里,1278,1558,338,540,878,29,907
公投第１４案,臺北市,大安區,永康里,1279,1561,340,533,873,26,899
公投第１４案,臺北市,大安區,光明里,1280,1446,309,513,822,30,852
公投第１４案,臺北市,大安區,光明里,1281,1499,344,524,868,28,896
公投第１４案,臺北市,大安區,錦泰里,1282,1467,301,542,843,20,863
公投第１４案,臺北市,大安區,錦泰里,1283,1511,301,500,801,26,827
公投第１４案,臺北市,大安區,錦華里,1284,1600,335,572,907,48,955
公投第１４案,臺北市,大安區,錦華里,1285,1573,350,550,900,36,936
公投第１４案,臺北市,大安區,錦華里,1286,1467,324,559,883,38,921
公投第１４案,臺北市,大安區,龍圖里,1287,1358,259,505,764,36,800
公投第１４案,臺北市,大安區,龍圖里,1288,1568,329,545,874,33,907
公投第１４案,臺北市,大安區,龍圖里,1289,1411,319,497,816,33,849
公投第１４案,臺北市,大安區,龍圖里,1290,1554,322,536,858,20,878
公投第１４案,臺北市,大安區,新龍里,1291,1345,300,494,794,32,826
公投第１４案,臺北市,大安區,新龍里,1292,1435,311,520,831,13,844
公投第１４案,臺北市,大安區,新龍里,1293,1481,307,605,912,20,932
公投第１４案,臺北市,大安區,新龍里,1294,1451,322,584,906,26,932
公投第１４案,臺北市,大安區,龍陣里,1295,1566,323,665,988,47,1035
公投第１４案,臺北市,大安區,龍陣里,1296,1525,338,536,874,24,898
公投第１４案,臺北市,大安區,龍雲里,1297,1336,268,443,711,42,753
公投第１４案,臺北市,大安區,龍雲里,1298,1483,293,549,842,50,892
公投第１４案,臺北市,大安區,龍雲里,1299,1396,272,445,717,17,734
公投第１４案,臺北市,大安區,龍生里,1300,1406,325,497,822,46,868
公投第１４案,臺北市,大安區,龍生里,1301,1434,325,506,831,33,864
公投第１４案,臺北市,大安區,龍生里,1302,1288,364,362,726,33,759
公投第１４案,臺北市,大安區,龍生里,1303,1407,290,508,798,34,832
公投第１４案,臺北市,大安區,住安里,1304,1514,410,393,803,31,834
公投第１４案,臺北市,大安區,住安里,1305,1550,256,472,728,50,778
公投第１４案,臺北市,大安區,住安里,1306,1490,287,546,833,41,874
公投第１４案,臺北市,大安區,義安里,1307,1284,284,422,706,25,731
公投第１４案,臺北市,大安區,義安里,1308,1129,241,419,660,24,684
公投第１４案,臺北市,大安區,義安里,1309,1193,269,418,687,23,710
公投第１４案,臺北市,大安區,義安里,1310,1057,201,375,576,25,601
公投第１４案,臺北市,大安區,通化里,1311,1361,314,435,749,42,791
公投第１４案,臺北市,大安區,通化里,1312,1412,259,490,749,48,797
公投第１４案,臺北市,大安區,通化里,1313,1423,252,421,673,22,695
公投第１４案,臺北市,大安區,通化里,1314,1257,272,409,681,55,736
公投第１４案,臺北市,大安區,通安里,1315,1133,226,452,678,27,705
公投第１４案,臺北市,大安區,通安里,1316,1077,235,371,606,24,630
公投第１４案,臺北市,大安區,通安里,1317,1300,300,451,751,35,786
公投第１４案,臺北市,大安區,通安里,1318,1319,278,493,771,50,821
公投第１４案,臺北市,大安區,臨江里,1319,1265,255,451,706,50,756
公投第１４案,臺北市,大安區,臨江里,1320,1265,228,435,663,31,694
公投第１４案,臺北市,大安區,臨江里,1321,1103,244,394,638,29,667
公投第１４案,臺北市,大安區,法治里,1322,1341,275,495,770,32,802
公投第１４案,臺北市,大安區,法治里,1323,1357,285,499,784,39,823
公投第１４案,臺北市,大安區,法治里,1324,1260,284,436,720,32,752
公投第１４案,臺北市,大安區,全安里,1325,1295,292,438,730,39,769
公投第１４案,臺北市,大安區,全安里,1326,1399,282,444,726,29,755
公投第１４案,臺北市,大安區,全安里,1327,1150,243,394,637,26,663
公投第１４案,臺北市,大安區,群賢里,1328,1351,267,423,690,24,714
公投第１４案,臺北市,大安區,群賢里,1329,1341,317,440,757,37,794
公投第１４案,臺北市,大安區,群賢里,1330,1129,211,398,609,21,630
公投第１４案,臺北市,大安區,群賢里,1331,1328,255,482,737,23,760
公投第１４案,臺北市,大安區,群英里,1332,1557,296,663,959,23,982
公投第１４案,臺北市,大安區,群英里,1333,1461,295,599,894,33,927
公投第１４案,臺北市,大安區,群英里,1334,1589,290,512,802,23,825
公投第１４案,臺北市,大安區,群英里,1335,1473,275,528,803,29,832
公投第１４案,臺北市,大安區,虎嘯里,1336,1479,343,463,806,32,838
公投第１４案,臺北市,大安區,虎嘯里,1337,833,161,329,490,33,523
公投第１４案,臺北市,大安區,虎嘯里,1338,999,219,331,550,23,573
公投第１４案,臺北市,大安區,臥龍里,1339,1757,391,632,1023,22,1045
公投第１４案,臺北市,大安區,龍淵里,1340,1573,321,583,904,33,937
公投第１４案,臺北市,大安區,龍淵里,1341,1587,352,603,955,26,981
公投第１４案,臺北市,大安區,龍淵里,1342,1496,343,525,868,46,914
公投第１４案,臺北市,大安區,龍淵里,1343,1440,377,459,836,34,870
公投第１４案,臺北市,大安區,龍淵里,1344,1578,354,577,931,32,963
公投第１４案,臺北市,大安區,龍門里,1345,1223,292,419,711,22,733
公投第１４案,臺北市,大安區,龍門里,1346,1119,269,278,547,21,568
公投第１４案,臺北市,大安區,龍門里,1347,1252,295,456,751,21,772
公投第１４案,臺北市,大安區,大學里,1348,1576,374,535,909,40,949
公投第１４案,臺北市,大安區,大學里,1349,1425,300,498,798,28,826
公投第１４案,臺北市,大安區,大學里,1350,1450,312,462,774,23,797
公投第１４案,臺北市,大安區,大學里,1351,1444,277,515,792,26,818
公投第１４案,臺北市,大安區,大學里,1352,1337,341,475,816,32,848
公投第１４案,臺北市,大安區,芳和里,1353,1417,269,492,761,31,792
公投第１４案,臺北市,大安區,芳和里,1354,1250,266,431,697,33,730
公投第１４案,臺北市,大安區,芳和里,1355,1176,230,425,655,28,683
公投第１４案,臺北市,大安區,芳和里,1356,1257,279,454,733,37,770
公投第１４案,臺北市,大安區,黎元里,1357,1257,253,454,707,39,746
公投第１４案,臺北市,大安區,黎元里,1358,1148,257,398,655,29,684
公投第１４案,臺北市,大安區,黎元里,1359,1418,299,494,793,36,829
公投第１４案,臺北市,大安區,黎元里,1360,1028,217,360,577,19,596
公投第１４案,臺北市,大安區,黎孝里,1361,1445,347,496,843,29,872
公投第１４案,臺北市,大安區,黎孝里,1362,1361,293,483,776,38,814
公投第１４案,臺北市,大安區,黎孝里,1363,1343,157,629,786,42,828
公投第１４案,臺北市,大安區,黎孝里,1364,1267,283,443,726,32,758
公投第１４案,臺北市,大安區,黎孝里,1365,1380,295,431,726,24,750
公投第１４案,臺北市,大安區,黎和里,1366,1524,311,519,830,39,869
公投第１４案,臺北市,大安區,黎和里,1367,1470,311,537,848,30,878
公投第１４案,臺北市,大安區,黎和里,1368,1318,243,413,656,40,696
公投第１４案,臺北市,大安區,建安里,1369,1430,271,459,730,49,779
公投第１４案,臺北市,大安區,建安里,1370,1386,267,499,766,34,800
公投第１４案,臺北市,大安區,建安里,1371,1438,266,486,752,21,773
公投第１４案,臺北市,大安區,建倫里,1372,1270,228,419,647,22,669
公投第１４案,臺北市,大安區,建倫里,1373,1395,281,465,746,36,782
公投第１４案,臺北市,大安區,建倫里,1374,1292,261,458,719,24,743
公投第１４案,臺北市,大安區,建倫里,1375,1310,289,418,707,30,737
公投第１４案,臺北市,大安區,敦安里,1376,1319,277,449,726,32,758
公投第１４案,臺北市,大安區,敦安里,1377,1355,293,481,774,23,797
公投第１４案,臺北市,大安區,敦安里,1378,1312,269,419,688,20,708
公投第１４案,臺北市,大安區,敦安里,1379,1335,271,463,734,26,760
公投第１４案,臺北市,大安區,正聲里,1380,1489,295,473,768,26,794
公投第１４案,臺北市,大安區,正聲里,1381,1307,277,471,748,24,772
公投第１４案,臺北市,大安區,正聲里,1382,1328,265,415,680,22,702
公投第１４案,臺北市,大安區,敦煌里,1383,1277,276,423,699,9,708
公投第１４案,臺北市,大安區,敦煌里,1384,1314,271,457,728,34,762
公投第１４案,臺北市,大安區,敦煌里,1385,1270,283,453,736,27,763
公投第１４案,臺北市,大安區,敦煌里,1386,1308,302,394,696,62,758
公投第１４案,臺北市,大安區,華聲里,1387,1138,258,403,661,24,685
公投第１４案,臺北市,大安區,華聲里,1388,1333,283,432,715,29,744
公投第１４案,臺北市,大安區,華聲里,1389,1176,247,407,654,32,686
公投第１４案,臺北市,大安區,車層里,1390,1311,262,445,707,37,744
公投第１４案,臺北市,大安區,車層里,1391,1295,233,470,703,20,723
公投第１４案,臺北市,大安區,車層里,1392,1421,265,526,791,43,834
公投第１４案,臺北市,大安區,車層里,1393,1409,287,469,756,30,786
公投第１４案,臺北市,大安區,光信里,1394,1434,305,512,817,26,843
公投第１４案,臺北市,大安區,光信里,1395,1449,289,449,738,44,782
公投第１４案,臺北市,大安區,光信里,1396,1284,282,450,732,28,760
公投第１４案,臺北市,大安區,光信里,1397,1248,268,432,700,18,718
公投第１４案,臺北市,大安區,光信里,1398,1119,271,442,713,23,736
公投第１４案,臺北市,大安區,學府里,1399,883,183,326,509,32,541
公投第１４案,臺北市,大安區,學府里,1400,630,81,241,322,40,362
公投第１４案,臺北市,大安區,學府里,1401,814,183,268,451,32,483
公投第１４案,臺北市,文山區,景行里,1402,1539,310,519,829,39,868
公投第１４案,臺北市,文山區,景行里,1403,1548,274,543,817,26,843
公投第１４案,臺北市,文山區,景行里,1404,1493,309,542,851,56,907
公投第１４案,臺北市,文山區,景行里,1405,1648,362,600,962,39,1001
公投第１４案,臺北市,文山區,景東里,1406,1544,306,546,852,43,895
公投第１４案,臺北市,文山區,景東里,1407,1557,304,563,867,41,908
公投第１４案,臺北市,文山區,景東里,1408,1514,289,530,819,34,853
公投第１４案,臺北市,文山區,景東里,1409,1540,319,624,943,44,987
公投第１４案,臺北市,文山區,景美里,1410,1466,337,546,883,26,909
公投第１４案,臺北市,文山區,景美里,1411,1444,297,550,847,39,886
公投第１４案,臺北市,文山區,景美里,1412,1455,296,545,841,46,887
公投第１４案,臺北市,文山區,景慶里,1413,1440,260,513,773,32,805
公投第１４案,臺北市,文山區,景慶里,1414,1398,271,551,822,43,865
公投第１４案,臺北市,文山區,景慶里,1415,1412,323,466,789,13,802
公投第１４案,臺北市,文山區,景慶里,1416,1426,282,511,793,40,833
公投第１４案,臺北市,文山區,景仁里,1417,1437,302,519,821,35,856
公投第１４案,臺北市,文山區,景仁里,1418,1340,265,503,768,44,812
公投第１４案,臺北市,文山區,景仁里,1419,1568,335,552,887,27,914
公投第１４案,臺北市,文山區,景華里,1420,1372,256,514,770,23,793
公投第１４案,臺北市,文山區,景華里,1421,1046,225,367,592,25,617
公投第１４案,臺北市,文山區,景華里,1422,1274,276,444,720,45,765
公投第１４案,臺北市,文山區,景華里,1423,1324,272,486,758,24,782
公投第１４案,臺北市,文山區,萬有里,1424,1722,334,611,945,42,987
公投第１４案,臺北市,文山區,萬有里,1425,1737,347,635,982,52,1034
公投第１４案,臺北市,文山區,萬有里,1426,1370,328,509,837,23,860
公投第１４案,臺北市,文山區,萬祥里,1427,1495,331,513,844,35,879
公投第１４案,臺北市,文山區,萬祥里,1428,1328,296,463,759,42,801
公投第１４案,臺北市,文山區,萬祥里,1429,1138,248,428,676,27,703
公投第１４案,臺北市,文山區,萬隆里,1430,1471,302,563,865,25,890
公投第１４案,臺北市,文山區,萬隆里,1431,1144,243,446,689,28,717
公投第１４案,臺北市,文山區,萬隆里,1432,1176,261,462,723,39,762
公投第１４案,臺北市,文山區,萬隆里,1433,1212,249,484,733,38,771
公投第１４案,臺北市,文山區,萬隆里,1434,1214,270,472,742,36,778
公投第１４案,臺北市,文山區,萬年里,1435,1170,246,389,635,36,671
公投第１４案,臺北市,文山區,萬年里,1436,1308,269,482,751,38,789
公投第１４案,臺北市,文山區,萬年里,1437,1190,242,429,671,57,728
公投第１４案,臺北市,文山區,萬年里,1438,1110,232,401,633,35,668
公投第１４案,臺北市,文山區,萬和里,1439,1512,307,561,868,36,904
公投第１４案,臺北市,文山區,萬和里,1440,1387,258,562,820,33,853
公投第１４案,臺北市,文山區,萬盛里,1441,1355,297,478,775,38,813
公投第１４案,臺北市,文山區,萬盛里,1442,1370,302,475,777,56,833
公投第１４案,臺北市,文山區,萬盛里,1443,1484,316,539,855,43,898
公投第１４案,臺北市,文山區,興豐里,1444,1786,371,622,993,53,1046
公投第１４案,臺北市,文山區,興豐里,1445,1260,248,460,708,48,756
公投第１４案,臺北市,文山區,興豐里,1446,1194,286,474,760,25,785
公投第１４案,臺北市,文山區,興邦里,1447,1444,274,564,838,30,868
公投第１４案,臺北市,文山區,興邦里,1448,1495,320,546,866,39,905
公投第１４案,臺北市,文山區,興邦里,1449,1446,280,569,849,40,889
公投第１４案,臺北市,文山區,興光里,1450,1450,307,493,800,54,854
公投第１４案,臺北市,文山區,興光里,1451,1486,328,560,888,33,921
公投第１４案,臺北市,文山區,興家里,1452,1259,270,481,751,30,781
公投第１４案,臺北市,文山區,興家里,1453,1317,285,509,794,20,814
公投第１４案,臺北市,文山區,興家里,1454,1321,296,498,794,37,831
公投第１４案,臺北市,文山區,興家里,1455,1475,300,532,832,35,867
公投第１４案,臺北市,文山區,興家里,1456,1271,263,451,714,23,737
公投第１４案,臺北市,文山區,興得里,1457,1609,357,575,932,40,972
公投第１４案,臺北市,文山區,興得里,1458,1501,263,555,818,23,841
公投第１４案,臺北市,文山區,興得里,1459,997,189,338,527,28,555
公投第１４案,臺北市,文山區,興得里,1460,1052,247,396,643,40,683
公投第１４案,臺北市,文山區,興業里,1461,1247,268,452,720,46,766
公投第１４案,臺北市,文山區,興業里,1462,1167,265,426,691,38,729
公投第１４案,臺北市,文山區,興業里,1463,1280,276,487,763,30,793
公投第１４案,臺北市,文山區,興業里,1464,1153,238,435,673,42,715
公投第１４案,臺北市,文山區,興安里,1465,1557,336,559,895,34,929
公投第１４案,臺北市,文山區,興安里,1466,1444,253,559,812,47,859
公投第１４案,臺北市,文山區,興安里,1467,1459,348,568,916,29,945
公投第１４案,臺北市,文山區,興安里,1468,1357,277,557,834,34,868
公投第１４案,臺北市,文山區,興福里,1469,1194,269,494,763,29,792
公投第１４案,臺北市,文山區,興福里,1470,1184,280,440,720,45,765
公投第１４案,臺北市,文山區,興福里,1471,1119,264,429,693,26,719
公投第１４案,臺北市,文山區,興福里,1472,1350,309,507,816,46,862
公投第１４案,臺北市,文山區,興旺里,1473,1502,268,546,814,27,841
公投第１４案,臺北市,文山區,興旺里,1474,1511,300,589,889,33,922
公投第１４案,臺北市,文山區,興旺里,1475,1481,351,554,905,31,936
公投第１４案,臺北市,文山區,興旺里,1476,1477,214,697,911,30,941
公投第１４案,臺北市,文山區,興旺里,1477,1294,282,498,780,24,804
公投第１４案,臺北市,文山區,興泰里,1478,1040,244,440,684,25,709
公投第１４案,臺北市,文山區,興泰里,1479,1323,282,515,797,38,835
公投第１４案,臺北市,文山區,興泰里,1480,1153,278,396,674,40,714
公投第１４案,臺北市,文山區,興昌里,1481,1525,308,578,886,20,906
公投第１４案,臺北市,文山區,興昌里,1482,1412,250,503,753,39,792
公投第１４案,臺北市,文山區,興昌里,1483,1473,372,522,894,39,933
公投第１４案,臺北市,文山區,興昌里,1484,1486,271,597,868,31,899
公投第１４案,臺北市,文山區,試院里,1485,1616,338,636,974,41,1015
公投第１４案,臺北市,文山區,試院里,1486,1489,301,590,891,39,930
公投第１４案,臺北市,文山區,試院里,1487,1414,276,534,810,32,842
公投第１４案,臺北市,文山區,試院里,1488,1494,358,567,925,38,963
公投第１４案,臺北市,文山區,華興里,1489,1547,328,593,921,39,960
公投第１４案,臺北市,文山區,華興里,1490,1587,322,601,923,45,968
公投第１４案,臺北市,文山區,華興里,1491,1515,348,600,948,20,968
公投第１４案,臺北市,文山區,華興里,1492,1573,346,605,951,39,990
公投第１４案,臺北市,文山區,華興里,1493,1542,345,566,911,40,951
公投第１４案,臺北市,文山區,明義里,1494,1465,286,481,767,44,811
公投第１４案,臺北市,文山區,明義里,1495,699,130,178,308,38,346
公投第１４案,臺北市,文山區,明義里,1496,1372,256,416,672,42,714
公投第１４案,臺北市,文山區,明興里,1497,1448,254,452,706,42,748
公投第１４案,臺北市,文山區,明興里,1498,1548,297,572,869,48,917
公投第１４案,臺北市,文山區,明興里,1499,1501,343,529,872,33,905
公投第１４案,臺北市,文山區,明興里,1500,1560,356,574,930,33,963
公投第１４案,臺北市,文山區,木柵里,1501,1567,328,555,883,36,919
公投第１４案,臺北市,文山區,木柵里,1502,1554,352,539,891,28,919
公投第１４案,臺北市,文山區,木柵里,1503,1544,300,572,872,45,917
公投第１４案,臺北市,文山區,木柵里,1504,1528,316,574,890,34,924
公投第１４案,臺北市,文山區,木柵里,1505,1543,316,626,942,23,965
公投第１４案,臺北市,文山區,木新里,1506,2754,350,572,922,43,965
公投第１４案,臺北市,文山區,木新里,1507,1709,314,529,843,50,893
公投第１４案,臺北市,文山區,木新里,1508,1515,289,518,807,63,870
公投第１４案,臺北市,文山區,木新里,1509,1571,302,520,822,40,862
公投第１４案,臺北市,文山區,木新里,1510,1578,332,532,864,45,909
公投第１４案,臺北市,文山區,順興里,1511,1454,291,492,783,39,822
公投第１４案,臺北市,文山區,順興里,1512,1436,291,519,810,49,859
公投第１４案,臺北市,文山區,順興里,1513,1402,289,554,843,39,882
公投第１４案,臺北市,文山區,順興里,1514,1117,243,420,663,40,703
公投第１４案,臺北市,文山區,順興里,1515,1094,229,393,622,31,653
公投第１４案,臺北市,文山區,忠順里,1516,1070,201,448,649,39,688
公投第１４案,臺北市,文山區,忠順里,1517,1319,258,551,809,37,846
公投第１４案,臺北市,文山區,忠順里,1518,1226,253,501,754,36,790
公投第１４案,臺北市,文山區,樟林里,1519,1385,258,496,754,31,785
公投第１４案,臺北市,文山區,樟林里,1520,1416,328,491,819,43,862
公投第１４案,臺北市,文山區,樟林里,1521,1412,294,576,870,37,907
公投第１４案,臺北市,文山區,樟林里,1522,1535,284,546,830,56,886
公投第１４案,臺北市,文山區,樟林里,1523,1654,327,663,990,56,1046
公投第１４案,臺北市,文山區,樟新里,1524,1156,263,450,713,25,738
公投第１４案,臺北市,文山區,樟新里,1525,1231,288,464,752,26,778
公投第１４案,臺北市,文山區,樟新里,1526,1218,219,477,696,32,728
公投第１４案,臺北市,文山區,樟新里,1527,1176,295,443,738,24,762
公投第１４案,臺北市,文山區,樟文里,1528,1392,308,537,845,5,850
公投第１４案,臺北市,文山區,樟文里,1529,1323,280,444,724,61,785
公投第１４案,臺北市,文山區,樟文里,1530,1297,256,474,730,34,764
公投第１４案,臺北市,文山區,樟文里,1531,1296,289,484,773,41,814
公投第１４案,臺北市,文山區,樟腳里,1532,1613,330,576,906,39,945
公投第１４案,臺北市,文山區,樟腳里,1533,1697,315,657,972,59,1031
公投第１４案,臺北市,文山區,樟腳里,1534,1579,340,560,900,45,945
公投第１４案,臺北市,文山區,樟樹里,1535,1320,298,499,797,45,842
公投第１４案,臺北市,文山區,樟樹里,1536,1438,310,526,836,26,862
公投第１４案,臺北市,文山區,樟樹里,1537,1465,275,505,780,27,807
公投第１４案,臺北市,文山區,萬芳里,1538,1646,414,534,948,39,987
公投第１４案,臺北市,文山區,萬芳里,1539,1286,263,487,750,38,788
公投第１４案,臺北市,文山區,萬芳里,1540,1219,282,432,714,27,741
公投第１４案,臺北市,文山區,萬芳里,1541,1292,276,491,767,30,797
公投第１４案,臺北市,文山區,萬芳里,1542,1489,273,541,814,48,862
公投第１４案,臺北市,文山區,萬美里,1543,1611,428,525,953,36,989
公投第１４案,臺北市,文山區,萬美里,1544,1549,293,481,774,36,810
公投第１４案,臺北市,文山區,萬美里,1545,1678,314,582,896,55,951
公投第１４案,臺北市,文山區,萬美里,1546,1660,337,569,906,36,942
公投第１４案,臺北市,文山區,博嘉里,1547,1816,359,525,884,23,907
公投第１４案,臺北市,文山區,博嘉里,1548,985,217,323,540,26,566
公投第１４案,臺北市,文山區,博嘉里,1549,1314,293,487,780,24,804
公投第１４案,臺北市,文山區,博嘉里,1550,1018,416,217,633,34,667
公投第１４案,臺北市,文山區,萬興里,1551,1578,351,560,911,32,943
公投第１４案,臺北市,文山區,萬興里,1552,1457,316,510,826,30,856
公投第１４案,臺北市,文山區,萬興里,1553,1326,283,496,779,41,820
公投第１４案,臺北市,文山區,萬興里,1554,1393,305,523,828,34,862
公投第１４案,臺北市,文山區,萬興里,1555,1377,303,452,755,36,791
公投第１４案,臺北市,文山區,政大里,1556,1448,366,481,847,28,875
公投第１４案,臺北市,文山區,政大里,1557,1447,347,533,880,41,921
公投第１４案,臺北市,文山區,政大里,1558,1739,458,636,1094,41,1135
公投第１４案,臺北市,文山區,政大里,1559,1457,371,485,856,29,885
公投第１４案,臺北市,文山區,指南里,1560,1288,305,453,758,38,796
公投第１４案,臺北市,文山區,指南里,1561,1301,270,414,684,34,718
公投第１４案,臺北市,文山區,指南里,1562,865,148,281,429,48,477
公投第１４案,臺北市,文山區,老泉里,1563,789,150,257,407,34,441
公投第１４案,高雄市,桃源區,梅山里,1,264,40,72,112,2,114
公投第１４案,高雄市,桃源區,拉芙蘭里,2,233,31,128,159,13,172
公投第１４案,高雄市,桃源區,復興里,3,279,25,162,187,6,193
公投第１４案,高雄市,桃源區,勤和里,4,223,24,89,113,5,118
公投第１４案,高雄市,桃源區,桃源里,5,783,82,291,373,8,381
公投第１４案,高雄市,桃源區,高中里,6,632,66,123,189,7,196
公投第１４案,高雄市,桃源區,建山里,7,612,69,331,400,16,416
公投第１４案,高雄市,桃源區,寶山里,8,472,58,180,238,18,256
公投第１４案,高雄市,那瑪夏區,達卡努瓦里,9,741,106,277,383,23,406
公投第１４案,高雄市,那瑪夏區,達卡努瓦里,10,585,75,295,370,51,421
公投第１４案,高雄市,那瑪夏區,瑪雅里,11,609,67,376,443,29,472
公投第１４案,高雄市,那瑪夏區,南沙魯里,12,489,37,253,290,14,304
公投第１４案,高雄市,甲仙區,東安里,13,472,42,123,165,7,172
公投第１４案,高雄市,甲仙區,西安里,14,882,138,362,500,54,554
公投第１４案,高雄市,甲仙區,和安里,15,668,90,239,329,27,356
公投第１４案,高雄市,甲仙區,大田里,16,1581,200,496,696,98,794
公投第１４案,高雄市,甲仙區,寶隆里,17,673,64,168,232,10,242
公投第１４案,高雄市,甲仙區,關山里,18,607,57,201,258,35,293
公投第１４案,高雄市,甲仙區,小林里,19,534,90,170,260,14,274
公投第１４案,高雄市,六龜區,新威里,20,760,111,238,349,30,379
公投第１４案,高雄市,六龜區,新興里,21,666,74,202,276,31,307
公投第１４案,高雄市,六龜區,新寮里,22,704,108,243,351,53,404
公投第１４案,高雄市,六龜區,新發里,23,1003,127,341,468,42,510
公投第１４案,高雄市,六龜區,荖濃里,24,1382,132,436,568,99,667
公投第１４案,高雄市,六龜區,六龜里,25,986,106,247,353,63,416
公投第１４案,高雄市,六龜區,義寶里,26,1046,134,359,493,36,529
公投第１４案,高雄市,六龜區,興龍里,27,812,99,228,327,52,379
公投第１４案,高雄市,六龜區,中興里,28,1431,161,445,606,53,659
公投第１４案,高雄市,六龜區,寶來里,29,912,78,344,422,60,482
公投第１４案,高雄市,六龜區,文武里,30,1472,254,300,554,52,606
公投第１４案,高雄市,六龜區,大津里,31,327,30,93,123,20,143
公投第１４案,高雄市,杉林區,杉林里,32,640,75,193,268,50,318
公投第１４案,高雄市,杉林區,木梓里,33,696,60,228,288,27,315
公投第１４案,高雄市,杉林區,集來里,34,1284,115,331,446,43,489
公投第１４案,高雄市,杉林區,新庄里,35,1027,110,303,413,34,447
公投第１４案,高雄市,杉林區,新庄里,36,482,45,168,213,22,235
公投第１４案,高雄市,杉林區,上平里,37,1627,223,581,804,105,909
公投第１４案,高雄市,杉林區,月眉里,38,1630,178,538,716,24,740
公投第１４案,高雄市,杉林區,大愛里,39,973,106,336,442,24,466
公投第１４案,高雄市,杉林區,大愛里,40,987,116,276,392,21,413
公投第１４案,高雄市,杉林區,月美里,41,1261,152,432,584,82,666
公投第１４案,高雄市,內門區,溝坪里,42,969,89,318,407,52,459
公投第１４案,高雄市,內門區,金竹里,43,652,83,159,242,22,264
公投第１４案,高雄市,內門區,永富里,44,961,123,310,433,79,512
公投第１４案,高雄市,內門區,永吉里,45,426,33,141,174,6,180
公投第１４案,高雄市,內門區,永興里,46,398,30,133,163,21,184
公投第１４案,高雄市,內門區,石坑里,47,508,62,152,214,16,230
公投第１４案,高雄市,內門區,內門里,48,980,130,393,523,50,573
公投第１４案,高雄市,內門區,內豊里,49,1225,132,367,499,37,536
公投第１４案,高雄市,內門區,觀亭里,50,1722,267,565,832,122,954
公投第１４案,高雄市,內門區,中埔里,51,560,78,171,249,26,275
公投第１４案,高雄市,內門區,內東里,52,801,92,233,325,20,345
公投第１４案,高雄市,內門區,內南里,53,423,55,145,200,16,216
公投第１４案,高雄市,內門區,東埔里,54,497,54,157,211,25,236
公投第１４案,高雄市,內門區,三平里,55,677,85,220,305,24,329
公投第１４案,高雄市,內門區,木柵里,56,593,46,169,215,13,228
公投第１４案,高雄市,內門區,內興里,57,597,73,154,227,44,271
公投第１４案,高雄市,內門區,瑞山里,58,343,30,112,142,7,149
公投第１４案,高雄市,內門區,光興里,59,670,99,143,242,34,276
公投第１４案,高雄市,旗山區,太平里,60,1060,176,427,603,36,639
公投第１４案,高雄市,旗山區,太平里,61,1125,152,399,551,44,595
公投第１４案,高雄市,旗山區,大德里,62,1100,181,455,636,35,671
公投第１４案,高雄市,旗山區,大德里,63,1238,225,405,630,22,652
公投第１４案,高雄市,旗山區,湄洲里,64,933,146,394,540,17,557
公投第１４案,高雄市,旗山區,湄洲里,65,727,111,248,359,16,375
公投第１４案,高雄市,旗山區,圓富里,66,1071,181,377,558,48,606
公投第１４案,高雄市,旗山區,圓富里,67,744,118,244,362,29,391
公投第１４案,高雄市,旗山區,中正里,68,1100,142,368,510,27,537
公投第１４案,高雄市,旗山區,中正里,69,369,53,126,179,16,195
公投第１４案,高雄市,旗山區,大林里,70,888,99,287,386,15,401
公投第１４案,高雄市,旗山區,大林里,71,510,66,145,211,11,222
公投第１４案,高雄市,旗山區,上洲里,72,1042,147,427,574,77,651
公投第１４案,高雄市,旗山區,新光里,73,791,90,298,388,44,432
公投第１４案,高雄市,旗山區,南勝里,74,939,150,348,498,67,565
公投第１４案,高雄市,旗山區,南勝里,75,1218,172,400,572,43,615
公投第１４案,高雄市,旗山區,中寮里,76,178,19,60,79,19,98
公投第１４案,高雄市,旗山區,東平里,77,946,174,375,549,42,591
公投第１４案,高雄市,旗山區,東平里,78,1025,353,174,527,39,566
公投第１４案,高雄市,旗山區,東昌里,79,1040,173,401,574,57,631
公投第１４案,高雄市,旗山區,竹峰里,80,900,176,354,530,45,575
公投第１４案,高雄市,旗山區,竹峰里,81,663,117,214,331,19,350
公投第１４案,高雄市,旗山區,瑞吉里,82,954,160,342,502,38,540
公投第１４案,高雄市,旗山區,瑞吉里,83,1060,181,362,543,31,574
公投第１４案,高雄市,旗山區,永和里,84,1110,196,425,621,46,667
公投第１４案,高雄市,旗山區,永和里,85,1062,190,394,584,48,632
公投第１４案,高雄市,旗山區,永和里,86,1151,183,436,619,43,662
公投第１４案,高雄市,旗山區,三協里,87,266,46,98,144,22,166
公投第１４案,高雄市,旗山區,三協里,88,633,106,264,370,23,393
公投第１４案,高雄市,旗山區,三協里,89,1307,182,424,606,41,647
公投第１４案,高雄市,旗山區,鯤洲里,90,754,120,249,369,63,432
公投第１４案,高雄市,旗山區,大山里,91,1296,185,459,644,99,743
公投第１４案,高雄市,旗山區,中洲里,92,839,107,260,367,18,385
公投第１４案,高雄市,旗山區,南洲里,93,1329,193,510,703,56,759
公投第１４案,高雄市,旗山區,廣福里,94,628,91,251,342,30,372
公投第１４案,高雄市,美濃區,福安里,95,1175,187,423,610,73,683
公投第１４案,高雄市,美濃區,福安里,96,1438,171,509,680,36,716
公投第１４案,高雄市,美濃區,合和里,97,989,111,360,471,40,511
公投第１４案,高雄市,美濃區,合和里,98,1427,212,548,760,63,823
公投第１４案,高雄市,美濃區,祿興里,99,1309,243,483,726,61,787
公投第１４案,高雄市,美濃區,祿興里,100,1263,177,541,718,57,775
公投第１４案,高雄市,美濃區,中壇里,101,997,138,424,562,44,606
公投第１４案,高雄市,美濃區,中壇里,102,1064,132,427,559,56,615
公投第１４案,高雄市,美濃區,德興里,103,1498,215,551,766,64,830
公投第１４案,高雄市,美濃區,龍山里,104,1119,143,451,594,64,658
公投第１４案,高雄市,美濃區,龍山里,105,1031,113,435,548,58,606
公投第１４案,高雄市,美濃區,獅山里,106,1437,166,561,727,69,796
公投第１４案,高雄市,美濃區,獅山里,107,1071,155,405,560,47,607
公投第１４案,高雄市,美濃區,龍肚里,108,687,81,271,352,34,386
公投第１４案,高雄市,美濃區,龍肚里,109,775,74,248,322,20,342
公投第１４案,高雄市,美濃區,廣德里,110,1353,149,478,627,72,699
公投第１４案,高雄市,美濃區,興隆里,111,1191,163,402,565,40,605
公投第１４案,高雄市,美濃區,中圳里,112,906,113,298,411,34,445
公投第１４案,高雄市,美濃區,中圳里,113,1178,162,492,654,42,696
公投第１４案,高雄市,美濃區,東門里,114,1252,159,433,592,24,616
公投第１４案,高雄市,美濃區,泰安里,115,1549,206,626,832,48,880
公投第１４案,高雄市,美濃區,瀰濃里,116,1088,110,413,523,45,568
公投第１４案,高雄市,美濃區,瀰濃里,117,1116,156,435,591,44,635
公投第１４案,高雄市,美濃區,清水里,118,977,153,335,488,37,525
公投第１４案,高雄市,美濃區,清水里,119,816,142,318,460,53,513
公投第１４案,高雄市,美濃區,吉洋里,120,955,107,319,426,28,454
公投第１４案,高雄市,美濃區,吉洋里,121,943,126,368,494,57,551
公投第１４案,高雄市,美濃區,吉和里,122,1371,175,484,659,44,703
公投第１４案,高雄市,美濃區,吉東里,123,919,225,234,459,54,513
公投第１４案,高雄市,美濃區,吉東里,124,915,139,385,524,40,564
公投第１４案,高雄市,美濃區,廣林里,125,828,93,293,386,71,457
公投第１４案,高雄市,美濃區,廣林里,126,674,67,204,271,49,320
公投第１４案,高雄市,茂林區,多納里,127,507,79,264,343,13,356
公投第１４案,高雄市,茂林區,萬山里,128,382,66,189,255,15,270
公投第１４案,高雄市,茂林區,茂林里,129,726,88,384,472,15,487
公投第１４案,高雄市,茄萣區,福德里,130,976,149,305,454,18,472
公投第１４案,高雄市,茄萣區,萬福里,131,887,147,288,435,51,486
公投第１４案,高雄市,茄萣區,白雲里,132,1710,253,602,855,35,890
公投第１４案,高雄市,茄萣區,嘉賜里,133,1280,181,374,555,37,592
公投第１４案,高雄市,茄萣區,嘉賜里,134,1314,217,513,730,31,761
公投第１４案,高雄市,茄萣區,嘉賜里,135,1157,217,489,706,23,729
公投第１４案,高雄市,茄萣區,嘉安里,136,1785,275,630,905,83,988
公投第１４案,高雄市,茄萣區,嘉樂里,137,838,159,293,452,36,488
公投第１４案,高雄市,茄萣區,嘉樂里,138,1249,236,514,750,65,815
公投第１４案,高雄市,茄萣區,嘉泰里,139,1116,194,354,548,67,615
公投第１４案,高雄市,茄萣區,嘉福里,140,978,151,315,466,49,515
公投第１４案,高雄市,茄萣區,和協里,141,1125,155,339,494,33,527
公投第１４案,高雄市,茄萣區,嘉定里,142,1139,183,384,567,56,623
公投第１４案,高雄市,茄萣區,保定里,143,1363,222,470,692,72,764
公投第１４案,高雄市,茄萣區,保定里,144,1598,253,617,870,76,946
公投第１４案,高雄市,茄萣區,大定里,145,1111,159,383,542,54,596
公投第１４案,高雄市,茄萣區,光定里,146,925,116,285,401,36,437
公投第１４案,高雄市,茄萣區,吉定里,147,1148,177,403,580,45,625
公投第１４案,高雄市,茄萣區,崎漏里,148,1353,187,469,656,35,691
公投第１４案,高雄市,茄萣區,崎漏里,149,1331,190,487,677,54,731
公投第１４案,高雄市,茄萣區,崎漏里,150,1829,271,567,838,60,898
公投第１４案,高雄市,湖內區,海山里,151,1112,143,398,541,30,571
公投第１４案,高雄市,湖內區,劉家里,152,1017,158,365,523,66,589
公投第１４案,高雄市,湖內區,太爺里,153,796,142,259,401,26,427
公投第１４案,高雄市,湖內區,公舘里,154,1079,216,432,648,23,671
公投第１４案,高雄市,湖內區,公舘里,155,1115,196,412,608,26,634
公投第１４案,高雄市,湖內區,葉厝里,156,1311,203,495,698,29,727
公投第１４案,高雄市,湖內區,葉厝里,157,1319,225,433,658,32,690
公投第１４案,高雄市,湖內區,大湖里,158,1244,223,512,735,56,791
公投第１４案,高雄市,湖內區,大湖里,159,1227,207,536,743,37,780
公投第１４案,高雄市,湖內區,大湖里,160,1163,201,465,666,47,713
公投第１４案,高雄市,湖內區,田尾里,161,981,179,391,570,29,599
公投第１４案,高雄市,湖內區,湖內里,162,780,117,288,405,19,424
公投第１４案,高雄市,湖內區,湖內里,163,832,132,299,431,43,474
公投第１４案,高雄市,湖內區,湖內里,164,1017,199,406,605,37,642
公投第１４案,高雄市,湖內區,湖內里,165,1051,213,385,598,19,617
公投第１４案,高雄市,湖內區,海埔里,166,941,141,351,492,27,519
公投第１４案,高雄市,湖內區,海埔里,167,863,123,326,449,38,487
公投第１４案,高雄市,湖內區,文賢里,168,1160,213,380,593,37,630
公投第１４案,高雄市,湖內區,中賢里,169,1090,163,295,458,28,486
公投第１４案,高雄市,湖內區,中賢里,170,1122,210,391,601,47,648
公投第１４案,高雄市,湖內區,逸賢里,171,1123,185,338,523,28,551
公投第１４案,高雄市,湖內區,忠興里,172,684,101,261,362,24,386
公投第１４案,高雄市,湖內區,湖東里,173,1249,178,425,603,23,626
公投第１４案,高雄市,湖內區,湖東里,174,1453,222,472,694,37,731
公投第１４案,高雄市,路竹區,竹滬里,175,1026,151,376,527,19,546
公投第１４案,高雄市,路竹區,竹滬里,176,1069,186,392,578,53,631
公投第１４案,高雄市,路竹區,竹滬里,177,1127,209,427,636,55,691
公投第１４案,高雄市,路竹區,頂寮里,178,1179,159,472,631,45,676
公投第１４案,高雄市,路竹區,新達里,179,1237,194,450,644,58,702
公投第１４案,高雄市,路竹區,後鄉里,180,1096,212,397,609,51,660
公投第１４案,高雄市,路竹區,北嶺里,181,1272,212,528,740,65,805
公投第１４案,高雄市,路竹區,社西里,182,1182,193,462,655,47,702
公投第１４案,高雄市,路竹區,社西里,183,1127,157,451,608,47,655
公投第１４案,高雄市,路竹區,甲北里,184,956,187,351,538,37,575
公投第１４案,高雄市,路竹區,甲北里,185,1132,192,413,605,60,665
公投第１４案,高雄市,路竹區,甲南里,186,1025,190,401,591,65,656
公投第１４案,高雄市,路竹區,甲南里,187,1007,152,394,546,21,567
公投第１４案,高雄市,路竹區,甲南里,188,1301,209,445,654,50,704
公投第１４案,高雄市,路竹區,下坑里,189,885,146,335,481,32,513
公投第１４案,高雄市,路竹區,下坑里,190,837,132,268,400,14,414
公投第１４案,高雄市,路竹區,下坑里,191,930,170,349,519,45,564
公投第１４案,高雄市,路竹區,竹園里,192,781,130,238,368,39,407
公投第１４案,高雄市,路竹區,竹園里,193,1023,176,379,555,58,613
公投第１４案,高雄市,路竹區,竹東里,194,1763,306,686,992,68,1060
公投第１４案,高雄市,路竹區,竹東里,195,1637,261,618,879,52,931
公投第１４案,高雄市,路竹區,竹西里,196,1070,383,178,561,48,609
公投第１４案,高雄市,路竹區,竹西里,197,1177,201,476,677,49,726
公投第１４案,高雄市,路竹區,文北里,198,1007,172,382,554,39,593
公投第１４案,高雄市,路竹區,文北里,199,1026,196,365,561,37,598
公投第１４案,高雄市,路竹區,文北里,200,1017,175,391,566,33,599
公投第１４案,高雄市,路竹區,文南里,201,1264,227,478,705,36,741
公投第１４案,高雄市,路竹區,文南里,202,1089,186,441,627,42,669
公投第１４案,高雄市,路竹區,三爺里,203,851,128,333,461,34,495
公投第１４案,高雄市,路竹區,鴨寮里,204,1011,192,385,577,52,629
公投第１４案,高雄市,路竹區,鴨寮里,205,937,170,407,577,30,607
公投第１４案,高雄市,路竹區,社東里,206,820,126,286,412,15,427
公投第１４案,高雄市,路竹區,社東里,207,910,182,359,541,31,572
公投第１４案,高雄市,路竹區,社中里,208,867,153,300,453,41,494
公投第１４案,高雄市,路竹區,竹南里,209,937,160,371,531,21,552
公投第１４案,高雄市,路竹區,竹南里,210,900,197,296,493,30,523
公投第１４案,高雄市,路竹區,竹南里,211,900,149,367,516,42,558
公投第１４案,高雄市,路竹區,社南里,212,918,136,394,530,32,562
公投第１４案,高雄市,路竹區,社南里,213,870,162,366,528,36,564
公投第１４案,高雄市,路竹區,社南里,214,1150,216,469,685,37,722
公投第１４案,高雄市,路竹區,社南里,215,1537,272,664,936,49,985
公投第１４案,高雄市,阿蓮區,石安里,216,1299,204,389,593,35,628
公投第１４案,高雄市,阿蓮區,中路里,217,1107,180,398,578,28,606
公投第１４案,高雄市,阿蓮區,中路里,218,898,124,320,444,18,462
公投第１４案,高雄市,阿蓮區,峯山里,219,1259,202,428,630,58,688
公投第１４案,高雄市,阿蓮區,港後里,220,1579,258,539,797,50,847
公投第１４案,高雄市,阿蓮區,港後里,221,564,88,232,320,9,329
公投第１４案,高雄市,阿蓮區,崗山里,222,768,142,309,451,47,498
公投第１４案,高雄市,阿蓮區,阿蓮里,223,1092,184,412,596,41,637
公投第１４案,高雄市,阿蓮區,阿蓮里,224,1099,171,404,575,52,627
公投第１４案,高雄市,阿蓮區,阿蓮里,225,1134,190,425,615,25,640
公投第１４案,高雄市,阿蓮區,阿蓮里,226,1561,251,544,795,15,810
公投第１４案,高雄市,阿蓮區,清蓮里,227,1533,273,551,824,80,904
公投第１４案,高雄市,阿蓮區,清蓮里,228,1116,186,358,544,25,569
公投第１４案,高雄市,阿蓮區,和蓮里,229,1054,177,377,554,30,584
公投第１４案,高雄市,阿蓮區,和蓮里,230,1260,211,432,643,44,687
公投第１４案,高雄市,阿蓮區,青旗里,231,1504,233,503,736,61,797
公投第１４案,高雄市,阿蓮區,復安里,232,848,118,268,386,20,406
公投第１４案,高雄市,阿蓮區,復安里,233,823,118,301,419,19,438
公投第１４案,高雄市,阿蓮區,玉庫里,234,1021,143,412,555,31,586
公投第１４案,高雄市,阿蓮區,南蓮里,235,1715,290,562,852,26,878
公投第１４案,高雄市,阿蓮區,南蓮里,236,1300,203,442,645,42,687
公投第１４案,高雄市,田寮區,鹿埔里,237,369,43,117,160,6,166
公投第１４案,高雄市,田寮區,南安里,238,656,83,178,261,20,281
公投第１４案,高雄市,田寮區,南安里,239,406,28,85,113,12,125
公投第１４案,高雄市,田寮區,大同里,240,380,114,54,168,24,192
公投第１４案,高雄市,田寮區,田寮里,241,379,39,148,187,16,203
公投第１４案,高雄市,田寮區,七星里,242,625,70,236,306,50,356
公投第１４案,高雄市,田寮區,崇德里,243,946,144,300,444,23,467
公投第１４案,高雄市,田寮區,西德里,244,794,86,253,339,41,380
公投第１４案,高雄市,田寮區,三和里,245,382,44,105,149,20,169
公投第１４案,高雄市,田寮區,古亭里,246,513,59,106,165,35,200
公投第１４案,高雄市,田寮區,新興里,247,601,85,207,292,17,309
公投第１４案,高雄市,田寮區,新興里,248,620,108,218,326,38,364
公投第１４案,高雄市,永安區,永安里,249,756,131,338,469,35,504
公投第１４案,高雄市,永安區,永安里,250,818,144,334,478,45,523
公投第１４案,高雄市,永安區,永華里,251,866,170,401,571,31,602
公投第１４案,高雄市,永安區,永華里,252,951,158,402,560,53,613
公投第１４案,高雄市,永安區,新港里,253,992,160,421,581,52,633
公投第１４案,高雄市,永安區,新港里,254,682,112,205,317,17,334
公投第１４案,高雄市,永安區,新港里,255,665,106,278,384,18,402
公投第１４案,高雄市,永安區,鹽田里,256,371,65,127,192,11,203
公投第１４案,高雄市,永安區,保寧里,257,1114,190,485,675,57,732
公投第１４案,高雄市,永安區,保寧里,258,1418,266,577,843,42,885
公投第１４案,高雄市,永安區,維新里,259,1477,254,623,877,76,953
公投第１４案,高雄市,永安區,維新里,260,1891,359,769,1128,64,1192
公投第１４案,高雄市,岡山區,岡山里,261,1345,259,588,847,34,881
公投第１４案,高雄市,岡山區,岡山里,262,1045,145,331,476,24,500
公投第１４案,高雄市,岡山區,岡山里,263,1051,184,440,624,20,644
公投第１４案,高雄市,岡山區,岡山里,264,917,189,356,545,20,565
公投第１４案,高雄市,岡山區,壽天里,265,934,210,370,580,29,609
公投第１４案,高雄市,岡山區,壽天里,266,1097,176,486,662,34,696
公投第１４案,高雄市,岡山區,壽天里,267,1208,208,559,767,37,804
公投第１４案,高雄市,岡山區,平安里,268,1159,212,520,732,40,772
公投第１４案,高雄市,岡山區,維仁里,269,1018,182,412,594,36,630
公投第１４案,高雄市,岡山區,大遼里,270,1316,227,461,688,37,725
公投第１４案,高雄市,岡山區,程香里,271,1345,235,528,763,28,791
公投第１４案,高雄市,岡山區,程香里,272,1295,237,528,765,42,807
公投第１４案,高雄市,岡山區,程香里,273,1425,243,566,809,38,847
公投第１４案,高雄市,岡山區,後紅里,274,1328,231,514,745,27,772
公投第１４案,高雄市,岡山區,後紅里,275,1382,251,560,811,17,828
公投第１４案,高雄市,岡山區,後紅里,276,1381,256,575,831,18,849
公投第１４案,高雄市,岡山區,碧紅里,277,1282,236,475,711,64,775
公投第１４案,高雄市,岡山區,碧紅里,278,1240,225,477,702,15,717
公投第１４案,高雄市,岡山區,碧紅里,279,1327,237,515,752,49,801
公投第１４案,高雄市,岡山區,竹圍里,280,1736,308,613,921,42,963
公投第１４案,高雄市,岡山區,竹圍里,281,1566,273,634,907,43,950
公投第１４案,高雄市,岡山區,竹圍里,282,1779,294,596,890,35,925
公投第１４案,高雄市,岡山區,竹圍里,283,1593,273,628,901,58,959
公投第１４案,高雄市,岡山區,台上里,284,1480,268,600,868,56,924
公投第１４案,高雄市,岡山區,台上里,285,1364,228,564,792,34,826
公投第１４案,高雄市,岡山區,台上里,286,1410,587,242,829,39,868
公投第１４案,高雄市,岡山區,台上里,287,1148,187,556,743,50,793
公投第１４案,高雄市,岡山區,為隨里,288,625,114,249,363,45,408
公投第１４案,高雄市,岡山區,灣裡里,289,969,171,403,574,27,601
公投第１４案,高雄市,岡山區,灣裡里,290,861,177,352,529,19,548
公投第１４案,高雄市,岡山區,本洲里,291,823,132,296,428,28,456
公投第１４案,高雄市,岡山區,本洲里,292,889,177,380,557,43,600
公投第１４案,高雄市,岡山區,前峰里,293,1283,223,520,743,33,776
公投第１４案,高雄市,岡山區,前峰里,294,1512,256,568,824,33,857
公投第１４案,高雄市,岡山區,壽峰里,295,983,200,425,625,47,672
公投第１４案,高雄市,岡山區,壽峰里,296,1262,222,497,719,37,756
公投第１４案,高雄市,岡山區,仁壽里,297,1096,193,457,650,40,690
公投第１４案,高雄市,岡山區,仁壽里,298,1066,195,419,614,35,649
公投第１４案,高雄市,岡山區,仁壽里,299,1188,195,444,639,30,669
公投第１４案,高雄市,岡山區,後協里,300,1360,274,541,815,36,851
公投第１４案,高雄市,岡山區,後協里,301,1363,253,570,823,32,855
公投第１４案,高雄市,岡山區,後協里,302,1352,178,657,835,42,877
公投第１４案,高雄市,岡山區,後協里,303,1460,266,560,826,44,870
公投第１４案,高雄市,岡山區,協和里,304,1272,237,514,751,34,785
公投第１４案,高雄市,岡山區,協和里,305,1080,195,456,651,45,696
公投第１４案,高雄市,岡山區,協和里,306,1255,228,498,726,53,779
公投第１４案,高雄市,岡山區,協榮里,307,938,159,423,582,47,629
公投第１４案,高雄市,岡山區,協榮里,308,1237,208,544,752,41,793
公投第１４案,高雄市,岡山區,劉厝里,309,1413,250,511,761,26,787
公投第１４案,高雄市,岡山區,白米里,310,765,158,293,451,16,467
公投第１４案,高雄市,岡山區,白米里,311,1043,211,450,661,25,686
公投第１４案,高雄市,岡山區,石潭里,312,844,119,306,425,32,457
公投第１４案,高雄市,岡山區,石潭里,313,993,204,495,699,30,729
公投第１４案,高雄市,岡山區,福興里,314,1038,203,414,617,57,674
公投第１４案,高雄市,岡山區,嘉興里,315,1070,184,422,606,60,666
公投第１４案,高雄市,岡山區,嘉興里,316,1023,202,435,637,58,695
公投第１４案,高雄市,岡山區,嘉興里,317,1349,232,543,775,27,802
公投第１４案,高雄市,岡山區,嘉峰里,318,1452,239,534,773,36,809
公投第１４案,高雄市,岡山區,嘉峰里,319,301,61,125,186,19,205
公投第１４案,高雄市,岡山區,潭底里,320,756,130,307,437,79,516
公投第１４案,高雄市,岡山區,華崗里,321,733,109,281,390,13,403
公投第１４案,高雄市,岡山區,華崗里,322,854,158,376,534,63,597
公投第１４案,高雄市,岡山區,三和里,323,866,102,313,415,17,432
公投第１４案,高雄市,岡山區,大莊里,324,978,131,398,529,45,574
公投第１４案,高雄市,岡山區,忠孝里,325,1336,200,565,765,52,817
公投第１４案,高雄市,岡山區,忠孝里,326,1218,154,604,758,13,771
公投第１４案,高雄市,岡山區,忠孝里,327,341,81,170,251,7,258
公投第１４案,高雄市,岡山區,仁義里,328,955,132,556,688,27,715
公投第１４案,高雄市,岡山區,仁義里,329,940,124,514,638,15,653
公投第１４案,高雄市,岡山區,信義里,330,851,158,381,539,35,574
公投第１４案,高雄市,岡山區,信義里,331,762,142,380,522,15,537
公投第１４案,高雄市,岡山區,和平里,332,318,74,158,232,8,240
公投第１４案,高雄市,燕巢區,尖山里,333,1152,155,427,582,75,657
公投第１４案,高雄市,燕巢區,瓊林里,334,1120,191,435,626,30,656
公投第１４案,高雄市,燕巢區,瓊林里,335,974,159,438,597,50,647
公投第１４案,高雄市,燕巢區,安招里,336,1019,174,388,562,12,574
公投第１４案,高雄市,燕巢區,安招里,337,1058,172,380,552,52,604
公投第１４案,高雄市,燕巢區,安招里,338,1017,154,317,471,28,499
公投第１４案,高雄市,燕巢區,安招里,339,259,6,34,40,1,41
公投第１４案,高雄市,燕巢區,角宿里,340,926,166,405,571,39,610
公投第１４案,高雄市,燕巢區,角宿里,341,624,85,232,317,16,333
公投第１４案,高雄市,燕巢區,角宿里,342,1102,196,476,672,49,721
公投第１４案,高雄市,燕巢區,鳳雄里,343,1072,166,372,538,37,575
公投第１４案,高雄市,燕巢區,鳳雄里,344,1361,266,464,730,63,793
公投第１４案,高雄市,燕巢區,金山里,345,472,61,200,261,27,288
公投第１４案,高雄市,燕巢區,東燕里,346,1197,177,421,598,44,642
公投第１４案,高雄市,燕巢區,東燕里,347,1134,192,478,670,66,736
公投第１４案,高雄市,燕巢區,南燕里,348,1148,201,414,615,25,640
公投第１４案,高雄市,燕巢區,南燕里,349,1207,176,415,591,66,657
公投第１４案,高雄市,燕巢區,南燕里,350,1402,267,607,874,32,906
公投第１４案,高雄市,燕巢區,西燕里,351,1000,207,345,552,56,608
公投第１４案,高雄市,燕巢區,西燕里,352,1110,215,408,623,58,681
公投第１４案,高雄市,燕巢區,西燕里,353,1291,229,472,701,45,746
公投第１４案,高雄市,燕巢區,橫山里,354,797,135,288,423,68,491
公投第１４案,高雄市,燕巢區,橫山里,355,1098,150,390,540,38,578
公投第１４案,高雄市,燕巢區,深水里,356,1393,211,485,696,57,753
公投第１４案,高雄市,燕巢區,深水里,357,1079,127,343,470,24,494
公投第１４案,高雄市,彌陀區,光和里,358,1246,180,512,692,56,748
公投第１４案,高雄市,彌陀區,彌靖里,359,885,153,353,506,45,551
公投第１４案,高雄市,彌陀區,彌靖里,360,955,196,391,587,65,652
公投第１４案,高雄市,彌陀區,彌仁里,361,534,96,190,286,32,318
公投第１４案,高雄市,彌陀區,彌壽里,362,738,117,305,422,27,449
公投第１４案,高雄市,彌陀區,彌陀里,363,855,146,395,541,36,577
公投第１４案,高雄市,彌陀區,彌陀里,364,877,173,354,527,42,569
公投第１４案,高雄市,彌陀區,舊港里,365,781,132,329,461,47,508
公投第１４案,高雄市,彌陀區,舊港里,366,808,135,305,440,40,480
公投第１４案,高雄市,彌陀區,文安里,367,904,112,330,442,28,470
公投第１４案,高雄市,彌陀區,文安里,368,825,304,146,450,54,504
公投第１４案,高雄市,彌陀區,過港里,369,941,341,130,471,60,531
公投第１４案,高雄市,彌陀區,鹽埕里,370,1013,182,363,545,36,581
公投第１４案,高雄市,彌陀區,鹽埕里,371,1024,158,451,609,54,663
公投第１４案,高雄市,彌陀區,海尾里,372,861,130,314,444,15,459
公投第１４案,高雄市,彌陀區,漯底里,373,1163,305,351,656,74,730
公投第１４案,高雄市,彌陀區,南寮里,374,1216,204,534,738,59,797
公投第１４案,高雄市,彌陀區,南寮里,375,861,167,394,561,67,628
公投第１４案,高雄市,梓官區,梓信里,376,1061,156,465,621,60,681
公投第１４案,高雄市,梓官區,梓信里,377,1063,184,395,579,58,637
公投第１４案,高雄市,梓官區,梓義里,378,969,177,380,557,22,579
公投第１４案,高雄市,梓官區,梓義里,379,1078,175,362,537,25,562
公投第１４案,高雄市,梓官區,梓和里,380,838,203,276,479,42,521
公投第１４案,高雄市,梓官區,梓和里,381,611,105,247,352,41,393
公投第１４案,高雄市,梓官區,梓和里,382,782,147,295,442,24,466
公投第１４案,高雄市,梓官區,梓平里,383,1451,244,635,879,67,946
公投第１４案,高雄市,梓官區,中崙里,384,1144,213,403,616,22,638
公投第１４案,高雄市,梓官區,同安里,385,975,139,367,506,21,527
公投第１４案,高雄市,梓官區,大舍里,386,1317,221,502,723,39,762
公投第１４案,高雄市,梓官區,大舍里,387,1218,212,478,690,66,756
公投第１４案,高雄市,梓官區,大舍里,388,1073,422,183,605,33,638
公投第１４案,高雄市,梓官區,赤崁里,389,1112,152,389,541,40,581
公投第１４案,高雄市,梓官區,赤崁里,390,715,133,239,372,36,408
公投第１４案,高雄市,梓官區,赤東里,391,1311,202,470,672,49,721
公投第１４案,高雄市,梓官區,赤東里,392,939,169,365,534,25,559
公投第１４案,高雄市,梓官區,赤西里,393,824,149,349,498,17,515
公投第１４案,高雄市,梓官區,禮蚵里,394,1052,184,451,635,67,702
公投第１４案,高雄市,梓官區,禮蚵里,395,1020,155,416,571,80,651
公投第１４案,高雄市,梓官區,智蚵里,396,1260,205,455,660,31,691
公投第１４案,高雄市,梓官區,智蚵里,397,1595,250,586,836,36,872
公投第１４案,高雄市,梓官區,信蚵里,398,829,125,335,460,40,500
公投第１４案,高雄市,梓官區,信蚵里,399,1532,223,587,810,24,834
公投第１４案,高雄市,梓官區,茄苳里,400,1195,197,542,739,46,785
公投第１４案,高雄市,梓官區,茄苳里,401,1143,165,481,646,63,709
公投第１４案,高雄市,梓官區,典寶里,402,1186,200,497,697,45,742
公投第１４案,高雄市,梓官區,典寶里,403,1732,226,580,806,36,842
公投第１４案,高雄市,橋頭區,橋頭里,404,1005,210,408,618,58,676
公投第１４案,高雄市,橋頭區,橋頭里,405,1073,212,429,641,47,688
公投第１４案,高雄市,橋頭區,橋南里,406,1129,200,475,675,27,702
公投第１４案,高雄市,橋頭區,仕隆里,407,1244,234,485,719,68,787
公投第１４案,高雄市,橋頭區,仕隆里,408,1091,193,417,610,31,641
公投第１４案,高雄市,橋頭區,仕豐里,409,1329,277,552,829,49,878
公投第１４案,高雄市,橋頭區,仕豐里,410,1140,217,450,667,45,712
公投第１４案,高雄市,橋頭區,芋寮里,411,1220,229,472,701,56,757
公投第１４案,高雄市,橋頭區,東林里,412,1047,204,458,662,52,714
公投第１４案,高雄市,橋頭區,東林里,413,1315,220,490,710,82,792
公投第１４案,高雄市,橋頭區,西林里,414,691,133,250,383,29,412
公投第１４案,高雄市,橋頭區,西林里,415,720,123,304,427,51,478
公投第１４案,高雄市,橋頭區,白樹里,416,1192,247,427,674,67,741
公投第１４案,高雄市,橋頭區,白樹里,417,1318,250,544,794,54,848
公投第１４案,高雄市,橋頭區,白樹里,418,761,127,334,461,32,493
公投第１４案,高雄市,橋頭區,筆秀里,419,973,195,352,547,27,574
公投第１４案,高雄市,橋頭區,筆秀里,420,587,127,220,347,19,366
公投第１４案,高雄市,橋頭區,新莊里,421,812,167,328,495,36,531
公投第１４案,高雄市,橋頭區,新莊里,422,343,75,135,210,11,221
公投第１４案,高雄市,橋頭區,新莊里,423,1266,294,509,803,22,825
公投第１４案,高雄市,橋頭區,甲北里,424,1128,188,485,673,73,746
公投第１４案,高雄市,橋頭區,甲北里,425,884,137,389,526,39,565
公投第１４案,高雄市,橋頭區,甲南里,426,1187,189,443,632,63,695
公投第１４案,高雄市,橋頭區,甲南里,427,1259,202,530,732,52,784
公投第１４案,高雄市,橋頭區,頂鹽里,428,1361,213,477,690,66,756
公投第１４案,高雄市,橋頭區,中崎里,429,671,118,222,340,21,361
公投第１４案,高雄市,橋頭區,仕和里,430,1215,239,483,722,51,773
公投第１４案,高雄市,橋頭區,仕和里,431,1255,224,502,726,78,804
公投第１４案,高雄市,橋頭區,仕和里,432,1219,247,493,740,49,789
公投第１４案,高雄市,橋頭區,德松里,433,1372,249,510,759,35,794
公投第１４案,高雄市,橋頭區,三德里,434,758,128,207,335,10,345
公投第１４案,高雄市,楠梓區,清豐里,435,1309,274,522,796,38,834
公投第１４案,高雄市,楠梓區,清豐里,436,1408,294,535,829,29,858
公投第１４案,高雄市,楠梓區,清豐里,437,1851,356,703,1059,45,1104
公投第１４案,高雄市,楠梓區,清豐里,438,1578,290,632,922,55,977
公投第１４案,高雄市,楠梓區,清豐里,439,1715,433,609,1042,28,1070
公投第１４案,高雄市,楠梓區,清豐里,440,1611,298,587,885,18,903
公投第１４案,高雄市,楠梓區,清豐里,441,2024,314,738,1052,59,1111
公投第１４案,高雄市,楠梓區,清豐里,442,1890,353,641,994,29,1023
公投第１４案,高雄市,楠梓區,清豐里,443,1762,289,605,894,21,915
公投第１４案,高雄市,楠梓區,清豐里,444,1888,327,665,992,48,1040
公投第１４案,高雄市,楠梓區,清豐里,445,1822,347,610,957,75,1032
公投第１４案,高雄市,楠梓區,清豐里,446,1846,376,630,1006,37,1043
公投第１４案,高雄市,楠梓區,東寧里,447,1268,250,500,750,59,809
公投第１４案,高雄市,楠梓區,東寧里,448,1240,247,522,769,43,812
公投第１４案,高雄市,楠梓區,東寧里,449,1432,305,556,861,26,887
公投第１４案,高雄市,楠梓區,五常里,450,1490,296,567,863,43,906
公投第１４案,高雄市,楠梓區,五常里,451,1464,254,622,876,47,923
公投第１４案,高雄市,楠梓區,五常里,452,1435,246,515,761,59,820
公投第１４案,高雄市,楠梓區,五常里,453,1602,252,578,830,67,897
公投第１４案,高雄市,楠梓區,享平里,454,1500,289,518,807,44,851
公投第１４案,高雄市,楠梓區,享平里,455,1591,314,551,865,61,926
公投第１４案,高雄市,楠梓區,惠楠里,456,1669,225,399,624,39,663
公投第１４案,高雄市,楠梓區,惠楠里,457,1469,288,572,860,47,907
公投第１４案,高雄市,楠梓區,中陽里,458,1559,285,547,832,63,895
公投第１４案,高雄市,楠梓區,中陽里,459,1638,296,577,873,64,937
公投第１４案,高雄市,楠梓區,惠民里,460,1960,361,726,1087,84,1171
公投第１４案,高雄市,楠梓區,惠民里,461,1912,365,703,1068,82,1150
公投第１４案,高雄市,楠梓區,惠豐里,462,1559,255,589,844,50,894
公投第１４案,高雄市,楠梓區,惠豐里,463,1423,262,509,771,38,809
公投第１４案,高雄市,楠梓區,惠豐里,464,1696,327,665,992,25,1017
公投第１４案,高雄市,楠梓區,錦屏里,465,1493,266,506,772,114,886
公投第１４案,高雄市,楠梓區,錦屏里,466,1527,266,571,837,84,921
公投第１４案,高雄市,楠梓區,玉屏里,467,1020,171,428,599,55,654
公投第１４案,高雄市,楠梓區,玉屏里,468,1197,255,395,650,75,725
公投第１４案,高雄市,楠梓區,金田里,469,1528,288,486,774,71,845
公投第１４案,高雄市,楠梓區,金田里,470,1918,320,603,923,70,993
公投第１４案,高雄市,楠梓區,稔田里,471,1458,261,511,772,82,854
公投第１４案,高雄市,楠梓區,瑞屏里,472,1790,330,670,1000,76,1076
公投第１４案,高雄市,楠梓區,瑞屏里,473,1845,341,721,1062,81,1143
公投第１４案,高雄市,楠梓區,翠屏里,474,2037,401,790,1191,52,1243
公投第１４案,高雄市,楠梓區,翠屏里,475,1964,363,694,1057,52,1109
公投第１４案,高雄市,楠梓區,翠屏里,476,2006,361,773,1134,24,1158
公投第１４案,高雄市,楠梓區,翠屏里,477,1951,355,718,1073,41,1114
公投第１４案,高雄市,楠梓區,翠屏里,478,1951,343,506,849,255,1104
公投第１４案,高雄市,楠梓區,翠屏里,479,2008,347,805,1152,54,1206
公投第１４案,高雄市,楠梓區,翠屏里,480,1923,330,768,1098,72,1170
公投第１４案,高雄市,楠梓區,翠屏里,481,1921,375,737,1112,39,1151
公投第１４案,高雄市,楠梓區,宏南里,482,832,160,390,550,32,582
公投第１４案,高雄市,楠梓區,宏毅里,483,1156,291,429,720,50,770
公投第１４案,高雄市,楠梓區,宏毅里,484,1125,215,439,654,60,714
公投第１４案,高雄市,楠梓區,宏榮里,485,1060,225,445,670,49,719
公投第１４案,高雄市,楠梓區,宏榮里,486,1502,256,629,885,39,924
公投第１４案,高雄市,楠梓區,廣昌里,487,1404,260,513,773,85,858
公投第１４案,高雄市,楠梓區,廣昌里,488,1552,235,529,764,60,824
公投第１４案,高雄市,楠梓區,久昌里,489,1460,253,535,788,54,842
公投第１４案,高雄市,楠梓區,久昌里,490,1315,181,503,684,51,735
公投第１４案,高雄市,楠梓區,大昌里,491,1062,211,404,615,55,670
公投第１４案,高雄市,楠梓區,大昌里,492,1078,183,423,606,49,655
公投第１４案,高雄市,楠梓區,福昌里,493,914,167,372,539,73,612
公投第１４案,高雄市,楠梓區,福昌里,494,1064,209,422,631,70,701
公投第１４案,高雄市,楠梓區,盛昌里,495,1705,292,705,997,55,1052
公投第１４案,高雄市,楠梓區,盛昌里,496,1728,289,705,994,50,1044
公投第１４案,高雄市,楠梓區,盛昌里,497,1917,352,764,1116,39,1155
公投第１４案,高雄市,楠梓區,泰昌里,498,1439,198,563,761,60,821
公投第１４案,高雄市,楠梓區,興昌里,499,1287,228,531,759,58,817
公投第１４案,高雄市,楠梓區,興昌里,500,1504,258,650,908,58,966
公投第１４案,高雄市,楠梓區,興昌里,501,1405,268,597,865,64,929
公投第１４案,高雄市,楠梓區,建昌里,502,1287,246,469,715,76,791
公投第１４案,高雄市,楠梓區,建昌里,503,1295,252,522,774,36,810
公投第１４案,高雄市,楠梓區,宏昌里,504,1483,286,588,874,56,930
公投第１４案,高雄市,楠梓區,宏昌里,505,1649,308,741,1049,43,1092
公投第１４案,高雄市,楠梓區,和昌里,506,998,209,401,610,40,650
公投第１４案,高雄市,楠梓區,和昌里,507,1025,206,411,617,49,666
公投第１４案,高雄市,楠梓區,慶昌里,508,1671,306,740,1046,60,1106
公投第１４案,高雄市,楠梓區,慶昌里,509,1453,266,619,885,71,956
公投第１４案,高雄市,楠梓區,隆昌里,510,1673,322,625,947,72,1019
公投第１４案,高雄市,楠梓區,隆昌里,511,1653,280,653,933,41,974
公投第１４案,高雄市,楠梓區,秀昌里,512,1034,184,407,591,52,643
公投第１４案,高雄市,楠梓區,秀昌里,513,1127,235,499,734,43,777
公投第１４案,高雄市,楠梓區,裕昌里,514,1575,288,570,858,64,922
公投第１４案,高雄市,楠梓區,裕昌里,515,1559,254,653,907,48,955
公投第１４案,高雄市,楠梓區,裕昌里,516,1378,248,516,764,40,804
公投第１４案,高雄市,楠梓區,國昌里,517,1714,286,690,976,54,1030
公投第１４案,高雄市,楠梓區,國昌里,518,1721,281,702,983,73,1056
公投第１４案,高雄市,楠梓區,加昌里,519,1628,273,646,919,64,983
公投第１４案,高雄市,楠梓區,加昌里,520,1590,308,685,993,69,1062
公投第１４案,高雄市,楠梓區,加昌里,521,1628,290,650,940,55,995
公投第１４案,高雄市,楠梓區,加昌里,522,1739,363,745,1108,26,1134
公投第１４案,高雄市,楠梓區,加昌里,523,1642,310,713,1023,37,1060
公投第１４案,高雄市,楠梓區,仁昌里,524,1766,300,624,924,66,990
公投第１４案,高雄市,楠梓區,仁昌里,525,1482,262,550,812,47,859
公投第１４案,高雄市,楠梓區,仁昌里,526,1749,268,629,897,26,923
公投第１４案,高雄市,楠梓區,藍田里,527,1591,331,605,936,31,967
公投第１４案,高雄市,楠梓區,藍田里,528,1545,329,642,971,23,994
公投第１４案,高雄市,楠梓區,藍田里,529,1651,331,711,1042,34,1076
公投第１４案,高雄市,楠梓區,藍田里,530,1646,329,664,993,48,1041
公投第１４案,高雄市,楠梓區,中興里,531,1496,303,599,902,68,970
公投第１４案,高雄市,楠梓區,中和里,532,1403,222,522,744,72,816
公投第１４案,高雄市,楠梓區,中和里,533,1624,355,543,898,39,937
公投第１４案,高雄市,左營區,進學里,534,2604,287,577,864,51,915
公投第１４案,高雄市,左營區,尾西里,535,1037,196,382,578,67,645
公投第１４案,高雄市,左營區,頂北里,536,542,116,200,316,41,357
公投第１４案,高雄市,左營區,中北里,537,635,115,231,346,46,392
公投第１４案,高雄市,左營區,中南里,538,518,81,170,251,12,263
公投第１４案,高雄市,左營區,廟東里,539,813,148,270,418,49,467
公投第１４案,高雄市,左營區,廟北里,540,889,170,303,473,68,541
公投第１４案,高雄市,左營區,尾南里,541,731,145,266,411,60,471
公投第１４案,高雄市,左營區,尾北里,542,1592,268,517,785,38,823
公投第１４案,高雄市,左營區,尾北里,543,1709,342,640,982,35,1017
公投第１４案,高雄市,左營區,屏山里,544,1588,194,659,853,65,918
公投第１４案,高雄市,左營區,祥和里,545,358,45,155,200,4,204
公投第１４案,高雄市,左營區,永清里,546,666,81,360,441,16,457
公投第１４案,高雄市,左營區,莒光里,547,1748,271,686,957,57,1014
公投第１４案,高雄市,左營區,光輝里,548,1196,184,529,713,54,767
公投第１４案,高雄市,左營區,光輝里,549,1240,227,523,750,45,795
公投第１４案,高雄市,左營區,合群里,550,1402,166,665,831,45,876
公投第１４案,高雄市,左營區,合群里,551,1173,128,592,720,29,749
公投第１４案,高雄市,左營區,明建里,552,641,114,329,443,18,461
公投第１４案,高雄市,左營區,頂西里,553,951,184,326,510,38,548
公投第１４案,高雄市,左營區,聖后里,554,732,141,256,397,33,430
公投第１４案,高雄市,左營區,聖西里,555,339,60,117,177,9,186
公投第１４案,高雄市,左營區,聖南里,556,519,102,191,293,14,307
公投第１４案,高雄市,左營區,城南里,557,514,111,181,292,50,342
公投第１４案,高雄市,左營區,路東里,558,720,115,298,413,51,464
公投第１４案,高雄市,左營區,廍北里,559,411,80,152,232,37,269
公投第１４案,高雄市,左營區,廍南里,560,603,138,217,355,48,403
公投第１４案,高雄市,左營區,埤西里,561,904,168,321,489,64,553
公投第１４案,高雄市,左營區,埤北里,562,1318,158,514,672,33,705
公投第１４案,高雄市,左營區,埤東里,563,966,184,324,508,22,530
公投第１４案,高雄市,左營區,海勝里,564,1440,246,599,845,32,877
公投第１４案,高雄市,左營區,海勝里,565,1990,251,826,1077,37,1114
公投第１４案,高雄市,左營區,海勝里,566,1090,52,595,647,35,682
公投第１４案,高雄市,左營區,海勝里,567,1272,160,587,747,52,799
公投第１４案,高雄市,左營區,崇實里,568,1558,334,648,982,29,1011
公投第１４案,高雄市,左營區,崇實里,569,1501,324,616,940,29,969
公投第１４案,高雄市,左營區,自助里,570,360,80,163,243,7,250
公投第１４案,高雄市,左營區,果貿里,571,1335,155,607,762,30,792
公投第１４案,高雄市,左營區,果貿里,572,1359,196,589,785,21,806
公投第１４案,高雄市,左營區,果惠里,573,1487,245,641,886,51,937
公投第１４案,高雄市,左營區,果峰里,574,1637,208,692,900,94,994
公投第１４案,高雄市,左營區,新下里,575,1553,317,621,938,34,972
公投第１４案,高雄市,左營區,新下里,576,1564,323,637,960,55,1015
公投第１４案,高雄市,左營區,新下里,577,1788,385,733,1118,46,1164
公投第１４案,高雄市,左營區,新下里,578,2028,390,772,1162,83,1245
公投第１４案,高雄市,左營區,新下里,579,2037,425,714,1139,67,1206
公投第１４案,高雄市,左營區,新下里,580,2101,428,833,1261,44,1305
公投第１４案,高雄市,左營區,新下里,581,2018,317,898,1215,48,1263
公投第１４案,高雄市,左營區,新上里,582,1925,407,789,1196,62,1258
公投第１４案,高雄市,左營區,新上里,583,1989,393,721,1114,46,1160
公投第１４案,高雄市,左營區,新上里,584,1780,325,621,946,28,974
公投第１４案,高雄市,左營區,新上里,585,1778,354,715,1069,31,1100
公投第１４案,高雄市,左營區,新上里,586,1496,290,599,889,31,920
公投第１４案,高雄市,左營區,新上里,587,1538,339,603,942,30,972
公投第１４案,高雄市,左營區,新上里,588,2058,404,822,1226,37,1263
公投第１４案,高雄市,左營區,新上里,589,1992,433,752,1185,35,1220
公投第１４案,高雄市,左營區,新上里,590,2058,436,791,1227,57,1284
公投第１４案,高雄市,左營區,新上里,591,2090,426,813,1239,38,1277
公投第１４案,高雄市,左營區,新上里,592,2157,448,820,1268,34,1302
公投第１４案,高雄市,左營區,新上里,593,2096,421,857,1278,38,1316
公投第１４案,高雄市,左營區,新上里,594,2101,467,807,1274,56,1330
公投第１４案,高雄市,左營區,新中里,595,1649,295,632,927,64,991
公投第１４案,高雄市,左營區,新中里,596,1516,256,570,826,74,900
公投第１４案,高雄市,左營區,新中里,597,1678,304,704,1008,68,1076
公投第１４案,高雄市,左營區,新光里,598,1898,342,735,1077,73,1150
公投第１４案,高雄市,左營區,新光里,599,1837,362,739,1101,47,1148
公投第１４案,高雄市,左營區,新光里,600,1922,333,727,1060,37,1097
公投第１４案,高雄市,左營區,新光里,601,1785,360,719,1079,50,1129
公投第１４案,高雄市,左營區,新光里,602,1886,342,758,1100,25,1125
公投第１４案,高雄市,左營區,新光里,603,1895,367,771,1138,37,1175
公投第１４案,高雄市,左營區,新光里,604,1831,393,739,1132,24,1156
公投第１４案,高雄市,左營區,菜公里,605,2050,374,789,1163,45,1208
公投第１４案,高雄市,左營區,菜公里,606,2251,480,964,1444,38,1482
公投第１４案,高雄市,左營區,菜公里,607,2126,451,888,1339,31,1370
公投第１４案,高雄市,左營區,菜公里,608,1928,335,729,1064,26,1090
公投第１４案,高雄市,左營區,菜公里,609,2166,405,831,1236,34,1270
公投第１４案,高雄市,左營區,菜公里,610,2031,385,802,1187,41,1228
公投第１４案,高雄市,左營區,菜公里,611,1987,367,834,1201,34,1235
公投第１４案,高雄市,左營區,菜公里,612,2166,446,889,1335,31,1366
公投第１４案,高雄市,左營區,菜公里,613,1856,380,712,1092,56,1148
公投第１４案,高雄市,左營區,菜公里,614,2289,467,932,1399,26,1425
公投第１４案,高雄市,左營區,菜公里,615,1973,348,825,1173,36,1209
公投第１４案,高雄市,左營區,菜公里,616,1818,359,712,1071,57,1128
公投第１４案,高雄市,左營區,菜公里,617,1565,301,592,893,25,918
公投第１４案,高雄市,左營區,菜公里,618,1608,341,686,1027,22,1049
公投第１４案,高雄市,左營區,福山里,619,1812,375,759,1134,43,1177
公投第１４案,高雄市,左營區,福山里,620,1821,341,685,1026,19,1045
公投第１４案,高雄市,左營區,福山里,621,1907,386,768,1154,39,1193
公投第１４案,高雄市,左營區,福山里,622,1812,287,703,990,36,1026
公投第１４案,高雄市,左營區,福山里,623,1833,367,764,1131,39,1170
公投第１４案,高雄市,左營區,福山里,624,1850,400,727,1127,35,1162
公投第１４案,高雄市,左營區,福山里,625,1738,305,682,987,47,1034
公投第１４案,高雄市,左營區,福山里,626,1864,374,805,1179,43,1222
公投第１４案,高雄市,左營區,福山里,627,1887,389,776,1165,30,1195
公投第１４案,高雄市,左營區,福山里,628,1870,349,697,1046,27,1073
公投第１４案,高雄市,左營區,福山里,629,1866,359,744,1103,22,1125
公投第１４案,高雄市,左營區,福山里,630,1862,354,727,1081,21,1102
公投第１４案,高雄市,左營區,福山里,631,1816,355,745,1100,24,1124
公投第１４案,高雄市,左營區,福山里,632,1833,317,794,1111,36,1147
公投第１４案,高雄市,左營區,福山里,633,1676,330,685,1015,44,1059
公投第１４案,高雄市,左營區,福山里,634,1843,336,769,1105,37,1142
公投第１４案,高雄市,左營區,福山里,635,1872,374,769,1143,24,1167
公投第１４案,高雄市,左營區,福山里,636,2259,381,919,1300,48,1348
公投第１４案,高雄市,大社區,嘉誠里,637,950,143,332,475,60,535
公投第１４案,高雄市,大社區,保社里,638,1306,210,448,658,23,681
公投第１４案,高雄市,大社區,保社里,639,1856,257,553,810,31,841
公投第１４案,高雄市,大社區,大社里,640,986,208,378,586,49,635
公投第１４案,高雄市,大社區,大社里,641,1116,179,349,528,45,573
公投第１４案,高雄市,大社區,大社里,642,1253,272,477,749,58,807
公投第１４案,高雄市,大社區,大社里,643,1613,271,640,911,45,956
公投第１４案,高雄市,大社區,保安里,644,1455,223,513,736,39,775
公投第１４案,高雄市,大社區,保安里,645,1674,318,634,952,50,1002
公投第１４案,高雄市,大社區,三奶里,646,1004,160,394,554,55,609
公投第１４案,高雄市,大社區,三奶里,647,879,164,321,485,36,521
公投第１４案,高雄市,大社區,三奶里,648,778,162,256,418,18,436
公投第１４案,高雄市,大社區,觀音里,649,1110,219,411,630,45,675
公投第１４案,高雄市,大社區,觀音里,650,1432,263,509,772,46,818
公投第１４案,高雄市,大社區,觀音里,651,1466,273,562,835,38,873
公投第１４案,高雄市,大社區,觀音里,652,1383,290,549,839,73,912
公投第１４案,高雄市,大社區,神農里,653,1645,302,572,874,61,935
公投第１４案,高雄市,大社區,神農里,654,1555,280,477,757,46,803
公投第１４案,高雄市,大社區,神農里,655,1750,426,531,957,51,1008
公投第１４案,高雄市,大社區,中里里,656,1111,198,414,612,54,666
公投第１４案,高雄市,大社區,中里里,657,1133,209,420,629,65,694
公投第１４案,高雄市,大社區,中里里,658,912,166,353,519,34,553
公投第１４案,高雄市,大社區,翠屏里,659,745,108,226,334,15,349
公投第１４案,高雄市,大社區,翠屏里,660,934,194,343,537,25,562
公投第１４案,高雄市,仁武區,大灣里,661,1777,319,816,1135,34,1169
公投第１４案,高雄市,仁武區,大灣里,662,2273,403,917,1320,59,1379
公投第１４案,高雄市,仁武區,灣內里,663,1384,271,592,863,55,918
公投第１４案,高雄市,仁武區,灣內里,664,1170,199,445,644,46,690
公投第１４案,高雄市,仁武區,灣內里,665,1216,255,516,771,47,818
公投第１４案,高雄市,仁武區,灣內里,666,1598,274,602,876,23,899
公投第１４案,高雄市,仁武區,灣內里,667,2143,372,935,1307,26,1333
公投第１４案,高雄市,仁武區,考潭里,668,1300,243,461,704,51,755
公投第１４案,高雄市,仁武區,考潭里,669,1338,260,510,770,54,824
公投第１４案,高雄市,仁武區,烏林里,670,1217,223,427,650,16,666
公投第１４案,高雄市,仁武區,烏林里,671,1202,168,394,562,55,617
公投第１４案,高雄市,仁武區,烏林里,672,1404,245,485,730,36,766
公投第１４案,高雄市,仁武區,仁福里,673,830,117,331,448,34,482
公投第１４案,高雄市,仁武區,仁武里,674,1802,224,540,764,40,804
公投第１４案,高雄市,仁武區,仁武里,675,1877,302,656,958,53,1011
公投第１４案,高雄市,仁武區,仁武里,676,1738,258,559,817,32,849
公投第１４案,高雄市,仁武區,文武里,677,1549,296,533,829,48,877
公投第１４案,高雄市,仁武區,文武里,678,1579,280,611,891,49,940
公投第１４案,高雄市,仁武區,文武里,679,1406,200,549,749,32,781
公投第１４案,高雄市,仁武區,文武里,680,1461,239,595,834,28,862
公投第１４案,高雄市,仁武區,文武里,681,1311,516,264,780,41,821
公投第１４案,高雄市,仁武區,文武里,682,1373,236,531,767,23,790
公投第１４案,高雄市,仁武區,竹後里,683,1035,205,321,526,18,544
公投第１４案,高雄市,仁武區,竹後里,684,1181,197,435,632,32,664
公投第１４案,高雄市,仁武區,八卦里,685,1670,341,563,904,32,936
公投第１４案,高雄市,仁武區,八卦里,686,1576,293,575,868,29,897
公投第１４案,高雄市,仁武區,八卦里,687,1576,294,641,935,43,978
公投第１４案,高雄市,仁武區,八卦里,688,1915,331,829,1160,28,1188
公投第１４案,高雄市,仁武區,八卦里,689,1758,289,679,968,32,1000
公投第１４案,高雄市,仁武區,八卦里,690,1892,366,783,1149,44,1193
公投第１４案,高雄市,仁武區,八卦里,691,2025,358,815,1173,62,1235
公投第１４案,高雄市,仁武區,八卦里,692,2014,370,842,1212,39,1251
公投第１４案,高雄市,仁武區,八卦里,693,1473,306,627,933,34,967
公投第１４案,高雄市,仁武區,高楠里,694,979,171,349,520,26,546
公投第１４案,高雄市,仁武區,高楠里,695,944,175,365,540,17,557
公投第１４案,高雄市,仁武區,後安里,696,1153,187,450,637,65,702
公投第１４案,高雄市,仁武區,後安里,697,1328,198,510,708,39,747
公投第１４案,高雄市,仁武區,中華里,698,1657,275,652,927,71,998
公投第１４案,高雄市,仁武區,五和里,699,1545,239,545,784,45,829
公投第１４案,高雄市,仁武區,五和里,700,1417,259,595,854,35,889
公投第１４案,高雄市,仁武區,五和里,701,1602,398,592,990,41,1031
公投第１４案,高雄市,仁武區,仁和里,702,1823,337,788,1125,49,1174
公投第１４案,高雄市,仁武區,仁和里,703,1914,355,711,1066,26,1092
公投第１４案,高雄市,仁武區,赤山里,704,1992,370,762,1132,47,1179
公投第１４案,高雄市,仁武區,赤山里,705,2045,202,837,1039,34,1073
公投第１４案,高雄市,仁武區,赤山里,706,1982,385,800,1185,42,1227
公投第１４案,高雄市,仁武區,仁慈里,707,2167,344,785,1129,39,1168
公投第１４案,高雄市,鳥松區,鳥松里,708,1678,307,635,942,48,990
公投第１４案,高雄市,鳥松區,鳥松里,709,1682,288,573,861,55,916
公投第１４案,高雄市,鳥松區,鳥松里,710,1225,253,479,732,37,769
公投第１４案,高雄市,鳥松區,鳥松里,711,1322,233,449,682,50,732
公投第１４案,高雄市,鳥松區,鳥松里,712,1215,219,482,701,37,738
公投第１４案,高雄市,鳥松區,鳥松里,713,1779,322,620,942,46,988
公投第１４案,高雄市,鳥松區,鳥松里,714,1129,364,365,729,14,743
公投第１４案,高雄市,鳥松區,夢裡里,715,1374,239,574,813,44,857
公投第１４案,高雄市,鳥松區,夢裡里,716,1089,218,405,623,31,654
公投第１４案,高雄市,鳥松區,夢裡里,717,2219,468,853,1321,44,1365
公投第１４案,高雄市,鳥松區,大華里,718,1634,331,620,951,28,979
公投第１４案,高雄市,鳥松區,大華里,719,1553,296,640,936,51,987
公投第１４案,高雄市,鳥松區,大華里,720,1572,316,644,960,43,1003
公投第１４案,高雄市,鳥松區,大華里,721,1688,361,666,1027,37,1064
公投第１４案,高雄市,鳥松區,大華里,722,1626,363,637,1000,82,1082
公投第１４案,高雄市,鳥松區,大華里,723,1744,369,711,1080,48,1128
公投第１４案,高雄市,鳥松區,坔埔里,724,1230,175,489,664,38,702
公投第１４案,高雄市,鳥松區,坔埔里,725,1201,205,509,714,63,777
公投第１４案,高雄市,鳥松區,坔埔里,726,1117,195,499,694,34,728
公投第１４案,高雄市,鳥松區,仁美里,727,1255,195,486,681,58,739
公投第１４案,高雄市,鳥松區,仁美里,728,1432,224,520,744,29,773
公投第１４案,高雄市,鳥松區,仁美里,729,1370,691,7,698,31,729
公投第１４案,高雄市,鳥松區,仁美里,730,1364,243,541,784,68,852
公投第１４案,高雄市,鳥松區,仁美里,731,1041,176,450,626,44,670
公投第１４案,高雄市,鳥松區,大竹里,732,702,139,336,475,34,509
公投第１４案,高雄市,鳥松區,華美里,733,1212,200,489,689,49,738
公投第１４案,高雄市,鳥松區,華美里,734,1289,195,512,707,44,751
公投第１４案,高雄市,鳥松區,華美里,735,1449,287,624,911,28,939
公投第１４案,高雄市,大樹區,竹寮里,736,1386,240,504,744,27,771
公投第１４案,高雄市,大樹區,竹寮里,737,1315,232,581,813,32,845
公投第１４案,高雄市,大樹區,九曲里,738,2461,338,950,1288,58,1346
公投第１４案,高雄市,大樹區,九曲里,739,1274,205,488,693,26,719
公投第１４案,高雄市,大樹區,九曲里,740,1265,209,449,658,59,717
公投第１４案,高雄市,大樹區,久堂里,741,1504,233,545,778,61,839
公投第１４案,高雄市,大樹區,久堂里,742,1049,179,350,529,15,544
公投第１４案,高雄市,大樹區,久堂里,743,1573,283,529,812,46,858
公投第１４案,高雄市,大樹區,水安里,744,1121,155,367,522,33,555
公投第１４案,高雄市,大樹區,水安里,745,1207,183,493,676,40,716
公投第１４案,高雄市,大樹區,水寮里,746,1134,178,443,621,22,643
公投第１４案,高雄市,大樹區,水寮里,747,1124,187,477,664,23,687
公投第１４案,高雄市,大樹區,檨腳里,748,1259,205,441,646,76,722
公投第１４案,高雄市,大樹區,檨腳里,749,1105,219,421,640,56,696
公投第１４案,高雄市,大樹區,檨腳里,750,1128,198,390,588,61,649
公投第１４案,高雄市,大樹區,興山里,751,1079,162,357,519,77,596
公投第１４案,高雄市,大樹區,和山里,752,1025,169,335,504,44,548
公投第１４案,高雄市,大樹區,姑山里,753,950,149,334,483,49,532
公投第１４案,高雄市,大樹區,大坑里,754,1433,251,480,731,81,812
公投第１４案,高雄市,大樹區,井腳里,755,794,117,268,385,23,408
公投第１４案,高雄市,大樹區,井腳里,756,781,116,218,334,15,349
公投第１４案,高雄市,大樹區,小坪里,757,1318,218,414,632,21,653
公投第１４案,高雄市,大樹區,龍目里,758,736,119,258,377,34,411
公投第１４案,高雄市,大樹區,龍目里,759,1047,158,312,470,23,493
公投第１４案,高雄市,大樹區,大樹里,760,1271,218,442,660,57,717
公投第１４案,高雄市,大樹區,大樹里,761,1186,152,430,582,31,613
公投第１４案,高雄市,大樹區,三和里,762,1007,172,371,543,48,591
公投第１４案,高雄市,大樹區,溪埔里,763,859,157,321,478,41,519
公投第１４案,高雄市,大樹區,溪埔里,764,735,109,225,334,18,352
公投第１４案,高雄市,大樹區,興田里,765,1046,186,396,582,65,647
公投第１４案,高雄市,大樹區,興田里,766,880,102,521,623,28,651
公投第１４案,高雄市,大樹區,統嶺里,767,720,68,288,356,20,376
公投第１４案,高雄市,鼓山區,鼓峰里,768,959,152,339,491,24,515
公投第１４案,高雄市,鼓山區,鼓峰里,769,1000,209,410,619,46,665
公投第１４案,高雄市,鼓山區,雄峰里,770,910,140,381,521,14,535
公投第１４案,高雄市,鼓山區,雄峰里,771,1085,202,460,662,47,709
公投第１４案,高雄市,鼓山區,前峰里,772,1484,211,484,695,45,740
公投第１４案,高雄市,鼓山區,前峰里,773,1393,231,586,817,26,843
公投第１４案,高雄市,鼓山區,前峰里,774,1270,261,542,803,46,849
公投第１４案,高雄市,鼓山區,光榮里,775,1055,192,394,586,35,621
公投第１４案,高雄市,鼓山區,光榮里,776,1172,221,444,665,27,692
公投第１４案,高雄市,鼓山區,光榮里,777,1175,207,497,704,51,755
公投第１４案,高雄市,鼓山區,民族里,778,1274,246,493,739,32,771
公投第１４案,高雄市,鼓山區,內惟里,779,1085,189,347,536,42,578
公投第１４案,高雄市,鼓山區,建國里,780,1470,272,535,807,45,852
公投第１４案,高雄市,鼓山區,建國里,781,974,199,408,607,39,646
公投第１４案,高雄市,鼓山區,忠正里,782,1275,260,471,731,61,792
公投第１４案,高雄市,鼓山區,忠正里,783,1206,215,446,661,55,716
公投第１４案,高雄市,鼓山區,忠正里,784,1238,229,490,719,28,747
公投第１４案,高雄市,鼓山區,自強里,785,721,101,391,492,7,499
公投第１４案,高雄市,鼓山區,龍井里,786,1220,227,452,679,28,707
公投第１４案,高雄市,鼓山區,正德里,787,1966,328,613,941,39,980
公投第１４案,高雄市,鼓山區,平和里,788,1722,283,600,883,76,959
公投第１４案,高雄市,鼓山區,平和里,789,1720,286,611,897,36,933
公投第１４案,高雄市,鼓山區,民強里,790,1287,255,495,750,76,826
公投第１４案,高雄市,鼓山區,民強里,791,1369,230,373,603,30,633
公投第１４案,高雄市,鼓山區,厚生里,792,1222,228,517,745,25,770
公投第１４案,高雄市,鼓山區,厚生里,793,1770,309,638,947,51,998
公投第１４案,高雄市,鼓山區,龍子里,794,1860,469,678,1147,29,1176
公投第１４案,高雄市,鼓山區,龍子里,795,1857,367,664,1031,39,1070
公投第１４案,高雄市,鼓山區,龍子里,796,1841,382,680,1062,31,1093
公投第１４案,高雄市,鼓山區,龍子里,797,1830,378,705,1083,47,1130
公投第１４案,高雄市,鼓山區,龍子里,798,1809,346,687,1033,51,1084
公投第１４案,高雄市,鼓山區,龍子里,799,1894,393,735,1128,37,1165
公投第１４案,高雄市,鼓山區,龍子里,800,1882,377,759,1136,22,1158
公投第１４案,高雄市,鼓山區,龍子里,801,1894,437,738,1175,35,1210
公投第１４案,高雄市,鼓山區,龍水里,802,1745,302,671,973,38,1011
公投第１４案,高雄市,鼓山區,龍水里,803,1887,403,645,1048,16,1064
公投第１４案,高雄市,鼓山區,龍水里,804,1891,442,746,1188,47,1235
公投第１４案,高雄市,鼓山區,龍水里,805,1903,397,738,1135,38,1173
公投第１４案,高雄市,鼓山區,龍水里,806,1998,470,717,1187,34,1221
公投第１４案,高雄市,鼓山區,龍水里,807,1912,388,755,1143,31,1174
公投第１４案,高雄市,鼓山區,龍水里,808,1923,342,764,1106,52,1158
公投第１４案,高雄市,鼓山區,龍水里,809,1888,431,733,1164,22,1186
公投第１４案,高雄市,鼓山區,龍水里,810,1873,403,742,1145,26,1171
公投第１４案,高雄市,鼓山區,龍水里,811,1959,491,792,1283,28,1311
公投第１４案,高雄市,鼓山區,龍水里,812,1897,402,800,1202,37,1239
公投第１４案,高雄市,鼓山區,明誠里,813,2362,577,825,1402,40,1442
公投第１４案,高雄市,鼓山區,明誠里,814,1850,358,740,1098,53,1151
公投第１４案,高雄市,鼓山區,明誠里,815,1928,417,749,1166,25,1191
公投第１４案,高雄市,鼓山區,明誠里,816,1937,348,721,1069,32,1101
公投第１４案,高雄市,鼓山區,明誠里,817,2123,426,798,1224,51,1275
公投第１４案,高雄市,鼓山區,明誠里,818,1861,355,775,1130,32,1162
公投第１４案,高雄市,鼓山區,明誠里,819,1892,352,748,1100,22,1122
公投第１４案,高雄市,鼓山區,明誠里,820,2147,485,805,1290,42,1332
公投第１４案,高雄市,鼓山區,華豐里,821,1897,349,796,1145,33,1178
公投第１４案,高雄市,鼓山區,華豐里,822,2041,410,771,1181,31,1212
公投第１４案,高雄市,鼓山區,裕興里,823,1309,250,497,747,41,788
公投第１４案,高雄市,鼓山區,裕興里,824,1867,344,737,1081,48,1129
公投第１４案,高雄市,鼓山區,裕豐里,825,1152,234,529,763,25,788
公投第１４案,高雄市,鼓山區,裕豐里,826,1404,253,610,863,49,912
公投第１４案,高雄市,鼓山區,鼓岩里,827,1210,143,356,499,23,522
公投第１４案,高雄市,鼓山區,樹德里,828,1135,218,415,633,31,664
公投第１４案,高雄市,鼓山區,寶樹里,829,1831,199,396,595,77,672
公投第１４案,高雄市,鼓山區,興宗里,830,1288,220,491,711,52,763
公投第１４案,高雄市,鼓山區,光化里,831,1241,203,462,665,35,700
公投第１４案,高雄市,鼓山區,山下里,832,1342,252,517,769,56,825
公投第１４案,高雄市,鼓山區,河邊里,833,1422,259,519,778,96,874
公投第１４案,高雄市,鼓山區,綠川里,834,1453,288,531,819,82,901
公投第１４案,高雄市,鼓山區,登山里,835,616,117,251,368,37,405
公投第１４案,高雄市,鼓山區,峰南里,836,834,136,303,439,56,495
公投第１４案,高雄市,鼓山區,麗興里,837,969,168,300,468,57,525
公投第１４案,高雄市,鼓山區,新民里,838,978,170,343,513,72,585
公投第１４案,高雄市,鼓山區,延平里,839,760,160,288,448,52,500
公投第１４案,高雄市,鼓山區,維生里,840,1248,231,453,684,13,697
公投第１４案,高雄市,鼓山區,惠安里,841,1143,211,386,597,23,620
公投第１４案,高雄市,鼓山區,壽山里,842,1358,216,408,624,72,696
公投第１４案,高雄市,鼓山區,哨船頭里,843,1036,153,378,531,14,545
公投第１４案,高雄市,鼓山區,桃源里,844,580,91,222,313,9,322
公投第１４案,高雄市,鹽埕區,藍橋里,845,1304,292,503,795,41,836
公投第１４案,高雄市,鹽埕區,慈愛里,846,357,74,125,199,23,222
公投第１４案,高雄市,鹽埕區,博愛里,847,651,138,227,365,23,388
公投第１４案,高雄市,鹽埕區,壽星里,848,1322,220,434,654,20,674
公投第１４案,高雄市,鹽埕區,中山里,849,1056,216,417,633,22,655
公投第１４案,高雄市,鹽埕區,教仁里,850,904,224,327,551,16,567
公投第１４案,高雄市,鹽埕區,教仁里,851,1130,230,395,625,24,649
公投第１４案,高雄市,鹽埕區,新樂里,852,840,153,344,497,19,516
公投第１４案,高雄市,鹽埕區,中原里,853,616,151,272,423,17,440
公投第１４案,高雄市,鹽埕區,光明里,854,1397,294,420,714,27,741
公投第１４案,高雄市,鹽埕區,育仁里,855,766,164,276,440,12,452
公投第１４案,高雄市,鹽埕區,河濱里,856,839,182,303,485,33,518
公投第１４案,高雄市,鹽埕區,河濱里,857,805,169,319,488,16,504
公投第１４案,高雄市,鹽埕區,沙地里,858,750,140,257,397,18,415
公投第１４案,高雄市,鹽埕區,南端里,859,986,291,244,535,28,563
公投第１４案,高雄市,鹽埕區,港都里,860,1068,193,368,561,9,570
公投第１４案,高雄市,鹽埕區,江西里,861,1060,227,379,606,34,640
公投第１４案,高雄市,鹽埕區,新豐里,862,805,166,271,437,23,460
公投第１４案,高雄市,鹽埕區,府北里,863,1073,203,336,539,15,554
公投第１４案,高雄市,鹽埕區,府北里,864,921,175,285,460,23,483
公投第１４案,高雄市,鹽埕區,陸橋里,865,1171,327,315,642,21,663
公投第１４案,高雄市,鹽埕區,瀨南里,866,594,129,216,345,9,354
公投第１４案,高雄市,鹽埕區,新化里,867,592,123,230,353,15,368
公投第１４案,高雄市,鹽埕區,江南里,868,610,120,191,311,13,324
公投第１４案,高雄市,旗津區,旗下里,869,1177,246,414,660,85,745
公投第１４案,高雄市,旗津區,永安里,870,1109,153,384,537,47,584
公投第１４案,高雄市,旗津區,振興里,871,1642,279,487,766,23,789
公投第１４案,高雄市,旗津區,慈愛里,872,1209,190,408,598,73,671
公投第１４案,高雄市,旗津區,慈愛里,873,1112,198,317,515,45,560
公投第１４案,高雄市,旗津區,復興里,874,1483,267,524,791,75,866
公投第１４案,高雄市,旗津區,復興里,875,1460,191,451,642,31,673
公投第１４案,高雄市,旗津區,中華里,876,1572,300,530,830,115,945
公投第１４案,高雄市,旗津區,實踐里,877,1384,209,441,650,30,680
公投第１４案,高雄市,旗津區,北汕里,878,1390,194,466,660,33,693
公投第１４案,高雄市,旗津區,北汕里,879,1239,192,388,580,44,624
公投第１４案,高雄市,旗津區,南汕里,880,2045,241,750,991,99,1090
公投第１４案,高雄市,旗津區,上竹里,881,893,127,308,435,22,457
公投第１４案,高雄市,旗津區,上竹里,882,1866,292,605,897,82,979
公投第１４案,高雄市,旗津區,中洲里,883,1874,270,509,779,43,822
公投第１４案,高雄市,旗津區,安順里,884,893,128,274,402,58,460
公投第１４案,高雄市,旗津區,中興里,885,1215,240,416,656,32,688
公投第１４案,高雄市,旗津區,中興里,886,1297,217,406,623,32,655
公投第１４案,高雄市,三民區,鼎金里,887,1893,336,691,1027,69,1096
公投第１４案,高雄市,三民區,鼎金里,888,1982,298,693,991,84,1075
公投第１４案,高雄市,三民區,鼎盛里,889,1661,279,629,908,66,974
公投第１４案,高雄市,三民區,鼎盛里,890,1894,351,697,1048,24,1072
公投第１４案,高雄市,三民區,鼎盛里,891,1839,311,684,995,44,1039
公投第１４案,高雄市,三民區,鼎盛里,892,2014,373,699,1072,80,1152
公投第１４案,高雄市,三民區,鼎強里,893,1897,312,707,1019,105,1124
公投第１４案,高雄市,三民區,鼎強里,894,2016,387,649,1036,39,1075
公投第１４案,高雄市,三民區,鼎力里,895,1924,315,705,1020,44,1064
公投第１４案,高雄市,三民區,鼎力里,896,1749,300,691,991,44,1035
公投第１４案,高雄市,三民區,鼎西里,897,1845,370,710,1080,78,1158
公投第１４案,高雄市,三民區,鼎西里,898,1724,335,592,927,39,966
公投第１４案,高雄市,三民區,鼎西里,899,1889,368,696,1064,35,1099
公投第１４案,高雄市,三民區,鼎西里,900,1622,322,587,909,50,959
公投第１４案,高雄市,三民區,鼎中里,901,1870,354,738,1092,29,1121
公投第１４案,高雄市,三民區,鼎中里,902,1523,497,413,910,54,964
公投第１４案,高雄市,三民區,鼎泰里,903,2006,317,695,1012,57,1069
公投第１４案,高雄市,三民區,鼎泰里,904,2076,474,785,1259,56,1315
公投第１４案,高雄市,三民區,鼎泰里,905,2073,458,713,1171,19,1190
公投第１４案,高雄市,三民區,鼎泰里,906,2045,395,785,1180,34,1214
公投第１４案,高雄市,三民區,鼎泰里,907,2070,361,646,1007,53,1060
公投第１４案,高雄市,三民區,鼎泰里,908,2035,364,733,1097,44,1141
公投第１４案,高雄市,三民區,鼎泰里,909,2075,462,795,1257,33,1290
公投第１４案,高雄市,三民區,鼎泰里,910,2053,388,800,1188,35,1223
公投第１４案,高雄市,三民區,鼎泰里,911,2063,473,833,1306,36,1342
公投第１４案,高雄市,三民區,鼎泰里,912,2143,423,873,1296,41,1337
公投第１４案,高雄市,三民區,本館里,913,1746,324,756,1080,54,1134
公投第１４案,高雄市,三民區,本館里,914,1735,306,583,889,23,912
公投第１４案,高雄市,三民區,本館里,915,1655,306,563,869,56,925
公投第１４案,高雄市,三民區,本館里,916,1583,330,564,894,54,948
公投第１４案,高雄市,三民區,本館里,917,1800,357,633,990,39,1029
公投第１４案,高雄市,三民區,本和里,918,1730,318,698,1016,30,1046
公投第１４案,高雄市,三民區,本和里,919,1715,321,645,966,30,996
公投第１４案,高雄市,三民區,本和里,920,1691,313,665,978,37,1015
公投第１４案,高雄市,三民區,本和里,921,1865,388,688,1076,38,1114
公投第１４案,高雄市,三民區,本文里,922,1073,222,451,673,24,697
公投第１４案,高雄市,三民區,本文里,923,917,182,395,577,62,639
公投第１４案,高雄市,三民區,本武里,924,1647,301,640,941,42,983
公投第１４案,高雄市,三民區,本元里,925,1654,331,632,963,51,1014
公投第１４案,高雄市,三民區,本元里,926,1639,313,668,981,46,1027
公投第１４案,高雄市,三民區,本元里,927,1833,351,719,1070,42,1112
公投第１４案,高雄市,三民區,本安里,928,1362,307,550,857,33,890
公投第１４案,高雄市,三民區,本安里,929,1557,333,612,945,54,999
公投第１４案,高雄市,三民區,本安里,930,1482,272,634,906,24,930
公投第１４案,高雄市,三民區,本上里,931,1563,319,638,957,37,994
公投第１４案,高雄市,三民區,本上里,932,1497,220,684,904,32,936
公投第１４案,高雄市,三民區,本上里,933,1523,317,633,950,25,975
公投第１４案,高雄市,三民區,本揚里,934,1293,262,565,827,42,869
公投第１４案,高雄市,三民區,本揚里,935,1662,386,627,1013,37,1050
公投第１４案,高雄市,三民區,本揚里,936,1441,264,565,829,36,865
公投第１４案,高雄市,三民區,本揚里,937,1326,288,574,862,41,903
公投第１４案,高雄市,三民區,本揚里,938,1476,333,610,943,27,970
公投第１４案,高雄市,三民區,寶獅里,939,1968,367,670,1037,39,1076
公投第１４案,高雄市,三民區,寶獅里,940,1618,288,557,845,23,868
公投第１４案,高雄市,三民區,寶德里,941,1873,400,644,1044,46,1090
公投第１４案,高雄市,三民區,寶德里,942,1487,287,563,850,52,902
公投第１４案,高雄市,三民區,寶德里,943,1640,616,311,927,32,959
公投第１４案,高雄市,三民區,寶泰里,944,1889,345,716,1061,19,1080
公投第１４案,高雄市,三民區,寶泰里,945,1969,380,678,1058,44,1102
公投第１４案,高雄市,三民區,寶興里,946,1466,287,520,807,79,886
公投第１４案,高雄市,三民區,寶興里,947,1697,341,625,966,48,1014
公投第１４案,高雄市,三民區,寶興里,948,1663,308,667,975,45,1020
公投第１４案,高雄市,三民區,寶興里,949,1649,342,591,933,37,970
公投第１４案,高雄市,三民區,寶中里,950,1486,276,561,837,0,837
公投第１４案,高雄市,三民區,寶中里,951,1495,268,553,821,25,846
公投第１４案,高雄市,三民區,寶華里,952,1548,348,619,967,25,992
公投第１４案,高雄市,三民區,寶華里,953,1493,312,541,853,31,884
公投第１４案,高雄市,三民區,寶國里,954,1445,291,594,885,27,912
公投第１４案,高雄市,三民區,寶國里,955,1529,279,574,853,36,889
公投第１４案,高雄市,三民區,寶國里,956,1506,277,583,860,30,890
公投第１４案,高雄市,三民區,寶國里,957,1549,329,619,948,31,979
公投第１４案,高雄市,三民區,寶國里,958,1620,361,633,994,41,1035
公投第１４案,高雄市,三民區,寶民里,959,1550,306,631,937,56,993
公投第１４案,高雄市,三民區,寶民里,960,1488,275,632,907,35,942
公投第１４案,高雄市,三民區,寶慶里,961,1335,282,502,784,40,824
公投第１４案,高雄市,三民區,寶慶里,962,1332,220,560,780,38,818
公投第１４案,高雄市,三民區,寶業里,963,1764,358,656,1014,68,1082
公投第１４案,高雄市,三民區,寶業里,964,1811,338,697,1035,36,1071
公投第１４案,高雄市,三民區,寶業里,965,1693,355,682,1037,48,1085
公投第１４案,高雄市,三民區,寶盛里,966,1684,355,696,1051,56,1107
公投第１４案,高雄市,三民區,寶盛里,967,1464,287,534,821,42,863
公投第１４案,高雄市,三民區,寶盛里,968,1719,387,710,1097,27,1124
公投第１４案,高雄市,三民區,寶安里,969,1749,353,662,1015,17,1032
公投第１４案,高雄市,三民區,寶安里,970,1908,366,678,1044,34,1078
公投第１４案,高雄市,三民區,寶安里,971,1573,308,603,911,61,972
公投第１４案,高雄市,三民區,寶安里,972,1628,313,599,912,27,939
公投第１４案,高雄市,三民區,寶龍里,973,1377,237,457,694,55,749
公投第１４案,高雄市,三民區,寶龍里,974,1530,310,637,947,30,977
公投第１４案,高雄市,三民區,寶龍里,975,1188,207,465,672,44,716
公投第１４案,高雄市,三民區,寶珠里,976,2791,263,552,815,35,850
公投第１４案,高雄市,三民區,寶珠里,977,1840,362,686,1048,46,1094
公投第１４案,高雄市,三民區,寶珠里,978,1671,226,751,977,59,1036
公投第１４案,高雄市,三民區,寶玉里,979,1624,334,597,931,56,987
公投第１４案,高雄市,三民區,寶玉里,980,1555,358,664,1022,38,1060
公投第１４案,高雄市,三民區,寶玉里,981,1489,327,619,946,38,984
公投第１４案,高雄市,三民區,寶玉里,982,1662,342,658,1000,37,1037
公投第１４案,高雄市,三民區,寶玉里,983,1639,298,619,917,28,945
公投第１４案,高雄市,三民區,灣子里,984,1872,348,701,1049,53,1102
公投第１４案,高雄市,三民區,灣子里,985,1968,355,738,1093,39,1132
公投第１４案,高雄市,三民區,灣愛里,986,1471,226,487,713,73,786
公投第１４案,高雄市,三民區,灣愛里,987,1534,276,552,828,53,881
公投第１４案,高雄市,三民區,灣中里,988,1659,272,563,835,71,906
公投第１４案,高雄市,三民區,灣中里,989,1815,283,627,910,34,944
公投第１４案,高雄市,三民區,灣中里,990,1808,350,614,964,41,1005
公投第１４案,高雄市,三民區,灣華里,991,1224,204,431,635,32,667
公投第１４案,高雄市,三民區,灣華里,992,1406,260,525,785,20,805
公投第１４案,高雄市,三民區,灣勝里,993,945,162,338,500,37,537
公投第１４案,高雄市,三民區,灣勝里,994,944,179,404,583,27,610
公投第１４案,高雄市,三民區,灣利里,995,1669,303,636,939,68,1007
公投第１４案,高雄市,三民區,灣利里,996,1473,244,612,856,71,927
公投第１４案,高雄市,三民區,灣復里,997,1876,324,586,910,47,957
公投第１４案,高雄市,三民區,灣復里,998,1682,217,410,627,43,670
公投第１４案,高雄市,三民區,正興里,999,1791,357,579,936,35,971
公投第１４案,高雄市,三民區,正興里,1000,1808,363,694,1057,37,1094
公投第１４案,高雄市,三民區,正興里,1001,1798,308,651,959,43,1002
公投第１４案,高雄市,三民區,正興里,1002,2030,454,705,1159,37,1196
公投第１４案,高雄市,三民區,正興里,1003,2034,402,772,1174,21,1195
公投第１４案,高雄市,三民區,正興里,1004,1998,393,748,1141,22,1163
公投第１４案,高雄市,三民區,正順里,1005,1914,346,682,1028,26,1054
公投第１４案,高雄市,三民區,正順里,1006,1965,441,669,1110,40,1150
公投第１４案,高雄市,三民區,灣興里,1007,1885,391,650,1041,60,1101
公投第１４案,高雄市,三民區,灣成里,1008,1220,238,513,751,19,770
公投第１４案,高雄市,三民區,灣成里,1009,1057,184,404,588,58,646
公投第１４案,高雄市,三民區,安康里,1010,1434,173,421,594,29,623
公投第１４案,高雄市,三民區,安康里,1011,1350,208,455,663,30,693
公投第１４案,高雄市,三民區,安寧里,1012,872,147,278,425,23,448
公投第１４案,高雄市,三民區,安寧里,1013,954,195,296,491,18,509
公投第１４案,高雄市,三民區,安吉里,1014,1689,636,337,973,16,989
公投第１４案,高雄市,三民區,安吉里,1015,1390,299,493,792,16,808
公投第１４案,高雄市,三民區,安吉里,1016,1336,278,499,777,62,839
公投第１４案,高雄市,三民區,安發里,1017,1437,333,584,917,42,959
公投第１４案,高雄市,三民區,安發里,1018,1452,306,548,854,28,882
公投第１４案,高雄市,三民區,安發里,1019,1513,323,551,874,59,933
公投第１４案,高雄市,三民區,安東里,1020,1467,317,577,894,69,963
公投第１４案,高雄市,三民區,安東里,1021,1381,294,574,868,78,946
公投第１４案,高雄市,三民區,安和里,1022,1117,228,398,626,48,674
公投第１４案,高雄市,三民區,安和里,1023,1327,290,513,803,35,838
公投第１４案,高雄市,三民區,達德里,1024,1304,256,533,789,27,816
公投第１４案,高雄市,三民區,達明里,1025,1483,283,532,815,27,842
公投第１４案,高雄市,三民區,達仁里,1026,1473,291,616,907,31,938
公投第１４案,高雄市,三民區,達勇里,1027,980,203,359,562,41,603
公投第１４案,高雄市,三民區,同德里,1028,1409,348,475,823,55,878
公投第１４案,高雄市,三民區,同德里,1029,1230,246,478,724,39,763
公投第１４案,高雄市,三民區,德智里,1030,1024,218,424,642,42,684
公投第１４案,高雄市,三民區,德智里,1031,1130,229,429,658,59,717
公投第１４案,高雄市,三民區,德仁里,1032,1889,320,653,973,33,1006
公投第１４案,高雄市,三民區,安生里,1033,1427,270,545,815,27,842
公投第１４案,高雄市,三民區,德東里,1034,791,119,356,475,21,496
公投第１４案,高雄市,三民區,德行里,1035,1079,205,487,692,74,766
公投第１４案,高雄市,三民區,精華里,1036,1492,287,551,838,64,902
公投第１４案,高雄市,三民區,民享里,1037,1020,213,416,629,37,666
公投第１４案,高雄市,三民區,民享里,1038,1001,209,412,621,11,632
公投第１４案,高雄市,三民區,安宜里,1039,1581,287,623,910,42,952
公投第１４案,高雄市,三民區,安宜里,1040,1471,278,565,843,36,879
公投第１４案,高雄市,三民區,安泰里,1041,1151,258,453,711,16,727
公投第１４案,高雄市,三民區,安泰里,1042,1334,267,563,830,46,876
公投第１４案,高雄市,三民區,安泰里,1043,1275,227,505,732,41,773
公投第１４案,高雄市,三民區,安邦里,1044,1688,259,478,737,34,771
公投第１４案,高雄市,三民區,安邦里,1045,1214,245,466,711,29,740
公投第１４案,高雄市,三民區,安邦里,1046,1149,248,478,726,16,742
公投第１４案,高雄市,三民區,十全里,1047,1667,316,626,942,71,1013
公投第１４案,高雄市,三民區,十美里,1048,1786,352,584,936,28,964
公投第１４案,高雄市,三民區,德北里,1049,896,158,377,535,20,555
公投第１４案,高雄市,三民區,德北里,1050,925,165,372,537,44,581
公投第１４案,高雄市,三民區,立誠里,1051,684,138,285,423,44,467
公投第１４案,高雄市,三民區,立業里,1052,981,411,187,598,60,658
公投第１４案,高雄市,三民區,港東里,1053,1383,221,476,697,66,763
公投第１４案,高雄市,三民區,港新里,1054,1382,261,537,798,39,837
公投第１４案,高雄市,三民區,港西里,1055,808,157,299,456,19,475
公投第１４案,高雄市,三民區,博愛里,1056,1197,252,456,708,22,730
公投第１４案,高雄市,三民區,博惠里,1057,1344,219,526,745,39,784
公投第１４案,高雄市,三民區,博惠里,1058,1344,269,515,784,54,838
公投第１４案,高雄市,三民區,博惠里,1059,1359,267,540,807,14,821
公投第１４案,高雄市,三民區,長明里,1060,1073,221,414,635,48,683
公投第１４案,高雄市,三民區,建東里,1061,1186,220,421,641,37,678
公投第１４案,高雄市,三民區,興德里,1062,1749,335,635,970,66,1036
公投第１４案,高雄市,三民區,鳳南里,1063,877,154,313,467,16,483
公投第１４案,高雄市,三民區,鳳北里,1064,1402,268,578,846,81,927
公投第１４案,高雄市,三民區,德西里,1065,769,142,338,480,23,503
公投第１４案,高雄市,三民區,豐裕里,1066,1207,228,495,723,43,766
公投第１４案,高雄市,三民區,豐裕里,1067,1270,224,417,641,40,681
公投第１４案,高雄市,三民區,川東里,1068,1248,253,450,703,40,743
公投第１４案,高雄市,三民區,裕民里,1069,1263,247,493,740,54,794
公投第１４案,高雄市,三民區,力行里,1070,1101,196,448,644,33,677
公投第１４案,高雄市,三民區,千歲里,1071,1116,236,436,672,23,695
公投第１４案,高雄市,三民區,立德里,1072,1152,225,451,676,37,713
公投第１４案,高雄市,三民區,千北里,1073,1057,214,407,621,46,667
公投第１４案,高雄市,三民區,千秋里,1074,971,157,361,518,46,564
公投第１４案,高雄市,三民區,千秋里,1075,1062,193,410,603,16,619
公投第１４案,高雄市,前金區,三川里,1076,673,127,246,373,18,391
公投第１４案,高雄市,前金區,草江里,1077,1022,194,415,609,27,636
公投第１４案,高雄市,前金區,長城里,1078,1324,226,501,727,34,761
公投第１４案,高雄市,前金區,北金里,1079,839,165,313,478,35,513
公投第１４案,高雄市,前金區,東金里,1080,975,203,356,559,51,610
公投第１４案,高雄市,前金區,新生里,1081,1806,358,666,1024,48,1072
公投第１４案,高雄市,前金區,新生里,1082,1781,345,682,1027,35,1062
公投第１４案,高雄市,前金區,後金里,1083,717,146,290,436,20,456
公投第１４案,高雄市,前金區,長興里,1084,1097,215,414,629,14,643
公投第１４案,高雄市,前金區,青山里,1085,1633,317,623,940,21,961
公投第１４案,高雄市,前金區,民生里,1086,759,169,321,490,27,517
公投第１４案,高雄市,前金區,復元里,1087,948,210,375,585,37,622
公投第１４案,高雄市,前金區,林投里,1088,1009,177,322,499,62,561
公投第１４案,高雄市,前金區,國民里,1089,945,185,379,564,23,587
公投第１４案,高雄市,前金區,社東里,1090,772,165,293,458,15,473
公投第１４案,高雄市,前金區,社東里,1091,757,157,311,468,25,493
公投第１４案,高雄市,前金區,社西里,1092,1047,211,431,642,28,670
公投第１４案,高雄市,前金區,博孝里,1093,985,178,410,588,39,627
公投第１４案,高雄市,前金區,長生里,1094,1674,295,627,922,27,949
公投第１４案,高雄市,前金區,榮復里,1095,1088,192,420,612,29,641
公投第１４案,高雄市,前金區,文西里,1096,893,187,372,559,45,604
公投第１４案,高雄市,前金區,文東里,1097,1184,227,449,676,25,701
公投第１４案,高雄市,新興區,浩然里,1098,828,162,307,469,26,495
公投第１４案,高雄市,新興區,浩然里,1099,963,202,389,591,47,638
公投第１４案,高雄市,新興區,振成里,1100,1075,190,390,580,23,603
公投第１４案,高雄市,新興區,德生里,1101,1488,323,546,869,18,887
公投第１４案,高雄市,新興區,德生里,1102,1438,307,538,845,29,874
公投第１４案,高雄市,新興區,振華里,1103,1049,216,390,606,36,642
公投第１４案,高雄市,新興區,正氣里,1104,1378,276,572,848,73,921
公投第１４案,高雄市,新興區,德政里,1105,666,129,288,417,25,442
公投第１４案,高雄市,新興區,仁聲里,1106,981,202,381,583,15,598
公投第１４案,高雄市,新興區,德望里,1107,933,194,395,589,30,619
公投第１４案,高雄市,新興區,德望里,1108,987,174,389,563,22,585
公投第１４案,高雄市,新興區,華聲里,1109,988,185,415,600,29,629
公投第１４案,高雄市,新興區,蕉園里,1110,735,150,312,462,32,494
公投第１４案,高雄市,新興區,永寧里,1111,1317,282,485,767,28,795
公投第１４案,高雄市,新興區,玉衡里,1112,800,142,293,435,16,451
公投第１４案,高雄市,新興區,順昌里,1113,968,176,410,586,32,618
公投第１４案,高雄市,新興區,順昌里,1114,913,174,380,554,16,570
公投第１４案,高雄市,新興區,文昌里,1115,1389,336,536,872,20,892
公投第１４案,高雄市,新興區,文昌里,1116,1228,287,507,794,40,834
公投第１４案,高雄市,新興區,光耀里,1117,1211,245,465,710,56,766
公投第１４案,高雄市,新興區,光耀里,1118,1101,223,443,666,24,690
公投第１４案,高雄市,新興區,興昌里,1119,752,221,250,471,14,485
公投第１４案,高雄市,新興區,興昌里,1120,873,223,368,591,30,621
公投第１４案,高雄市,新興區,開平里,1121,1609,323,607,930,38,968
公投第１４案,高雄市,新興區,開平里,1122,1736,374,678,1052,51,1103
公投第１４案,高雄市,新興區,成功里,1123,1258,231,488,719,26,745
公投第１４案,高雄市,新興區,新江里,1124,1105,259,391,650,42,692
公投第１４案,高雄市,新興區,黎明里,1125,851,152,343,495,43,538
公投第１４案,高雄市,新興區,愛平里,1126,1011,207,402,609,35,644
公投第１４案,高雄市,新興區,南港里,1127,888,191,376,567,53,620
公投第１４案,高雄市,新興區,南港里,1128,1005,209,381,590,31,621
公投第１４案,高雄市,新興區,中東里,1129,1375,201,419,620,13,633
公投第１４案,高雄市,新興區,中東里,1130,1388,313,506,819,38,857
公投第１４案,高雄市,新興區,明莊里,1131,719,125,266,391,44,435
公投第１４案,高雄市,新興區,大明里,1132,1077,210,399,609,51,660
公投第１４案,高雄市,新興區,秋山里,1133,875,160,278,438,16,454
公投第１４案,高雄市,新興區,長驛里,1134,936,186,330,516,18,534
公投第１４案,高雄市,新興區,建興里,1135,944,191,324,515,49,564
公投第１４案,高雄市,新興區,建華里,1136,833,156,278,434,30,464
公投第１４案,高雄市,新興區,漢民里,1137,708,138,282,420,16,436
公投第１４案,高雄市,新興區,榮治里,1138,741,158,264,422,17,439
公投第１４案,高雄市,新興區,東坡里,1139,1235,217,421,638,27,665
公投第１４案,高雄市,苓雅區,博仁里,1140,718,140,294,434,17,451
公投第１４案,高雄市,苓雅區,苓洲里,1141,1492,257,573,830,36,866
公投第１４案,高雄市,苓雅區,苓昇里,1142,1210,220,482,702,42,744
公投第１４案,高雄市,苓雅區,苓中里,1143,1617,279,565,844,25,869
公投第１４案,高雄市,苓雅區,苓雅里,1144,1428,270,576,846,49,895
公投第１４案,高雄市,苓雅區,苓東里,1145,1444,250,498,748,36,784
公投第１４案,高雄市,苓雅區,城北里,1146,1452,264,542,806,57,863
公投第１４案,高雄市,苓雅區,城西里,1147,554,105,221,326,28,354
公投第１４案,高雄市,苓雅區,城東里,1148,950,164,374,538,15,553
公投第１４案,高雄市,苓雅區,城東里,1149,978,171,358,529,17,546
公投第１４案,高雄市,苓雅區,意誠里,1150,1673,269,602,871,37,908
公投第１４案,高雄市,苓雅區,意誠里,1151,2045,382,686,1068,50,1118
公投第１４案,高雄市,苓雅區,鼓中里,1152,939,165,382,547,48,595
公投第１４案,高雄市,苓雅區,田西里,1153,1284,244,426,670,38,708
公投第１４案,高雄市,苓雅區,人和里,1154,908,174,366,540,25,565
公投第１４案,高雄市,苓雅區,人和里,1155,838,182,276,458,19,477
公投第１４案,高雄市,苓雅區,仁政里,1156,1267,252,499,751,36,787
公投第１４案,高雄市,苓雅區,廣澤里,1157,994,200,408,608,51,659
公投第１４案,高雄市,苓雅區,廣澤里,1158,774,125,294,419,15,434
公投第１４案,高雄市,苓雅區,美田里,1159,1121,242,411,653,26,679
公投第１４案,高雄市,苓雅區,華堂里,1160,1474,288,569,857,40,897
公投第１４案,高雄市,苓雅區,華堂里,1161,1525,277,589,866,64,930
公投第１４案,高雄市,苓雅區,日中里,1162,1147,227,449,676,27,703
公投第１４案,高雄市,苓雅區,日中里,1163,1014,222,398,620,38,658
公投第１４案,高雄市,苓雅區,普照里,1164,1496,322,550,872,46,918
公投第１４案,高雄市,苓雅區,普照里,1165,1499,289,615,904,51,955
公投第１４案,高雄市,苓雅區,和煦里,1166,1138,228,457,685,28,713
公投第１４案,高雄市,苓雅區,和煦里,1167,839,163,382,545,37,582
公投第１４案,高雄市,苓雅區,晴朗里,1168,2088,235,475,710,33,743
公投第１４案,高雄市,苓雅區,普天里,1169,1648,342,650,992,23,1015
公投第１４案,高雄市,苓雅區,普天里,1170,1623,290,624,914,43,957
公投第１４案,高雄市,苓雅區,林富里,1171,1932,402,817,1219,45,1264
公投第１４案,高雄市,苓雅區,林圍里,1172,1127,250,520,770,16,786
公投第１４案,高雄市,苓雅區,林圍里,1173,1156,267,526,793,17,810
公投第１４案,高雄市,苓雅區,林安里,1174,1465,303,606,909,29,938
公投第１４案,高雄市,苓雅區,光華里,1175,690,116,243,359,21,380
公投第１４案,高雄市,苓雅區,林興里,1176,1283,227,461,688,73,761
公投第１４案,高雄市,苓雅區,林華里,1177,1432,270,548,818,63,881
公投第１４案,高雄市,苓雅區,林華里,1178,1313,246,541,787,28,815
公投第１４案,高雄市,苓雅區,林西里,1179,1579,289,569,858,33,891
公投第１４案,高雄市,苓雅區,林中里,1180,1385,260,553,813,53,866
公投第１４案,高雄市,苓雅區,林中里,1181,1449,268,606,874,43,917
公投第１４案,高雄市,苓雅區,林泉里,1182,1834,390,743,1133,36,1169
公投第１４案,高雄市,苓雅區,林南里,1183,1436,301,553,854,53,907
公投第１４案,高雄市,苓雅區,林南里,1184,1431,303,601,904,25,929
公投第１４案,高雄市,苓雅區,中正里,1185,1248,360,439,799,22,821
公投第１４案,高雄市,苓雅區,中正里,1186,1470,329,572,901,43,944
公投第１４案,高雄市,苓雅區,尚義里,1187,1540,294,676,970,52,1022
公投第１４案,高雄市,苓雅區,同慶里,1188,1374,293,569,862,21,883
公投第１４案,高雄市,苓雅區,同慶里,1189,839,185,358,543,18,561
公投第１４案,高雄市,苓雅區,凱旋里,1190,1022,242,444,686,23,709
公投第１４案,高雄市,苓雅區,凱旋里,1191,1062,201,476,677,17,694
公投第１４案,高雄市,苓雅區,安祥里,1192,1078,252,423,675,11,686
公投第１４案,高雄市,苓雅區,安祥里,1193,1117,226,485,711,18,729
公投第１４案,高雄市,苓雅區,奏捷里,1194,1516,270,635,905,45,950
公投第１４案,高雄市,苓雅區,福壽里,1195,1440,297,487,784,107,891
公投第１４案,高雄市,苓雅區,福南里,1196,839,167,308,475,43,518
公投第１４案,高雄市,苓雅區,福南里,1197,888,153,343,496,22,518
公投第１４案,高雄市,苓雅區,五權里,1198,1101,257,437,694,29,723
公投第１４案,高雄市,苓雅區,五權里,1199,1004,229,444,673,38,711
公投第１４案,高雄市,苓雅區,民主里,1200,1427,256,591,847,43,890
公投第１４案,高雄市,苓雅區,民主里,1201,1168,221,475,696,24,720
公投第１４案,高雄市,苓雅區,民主里,1202,1184,276,489,765,35,800
公投第１４案,高雄市,苓雅區,林德里,1203,974,203,400,603,26,629
公投第１４案,高雄市,苓雅區,林德里,1204,849,153,306,459,9,468
公投第１４案,高雄市,苓雅區,林貴里,1205,1821,545,535,1080,40,1120
公投第１４案,高雄市,苓雅區,林榮里,1206,1306,267,472,739,45,784
公投第１４案,高雄市,苓雅區,林榮里,1207,1185,260,490,750,18,768
公投第１４案,高雄市,苓雅區,林榮里,1208,1415,288,534,822,39,861
公投第１４案,高雄市,苓雅區,英明里,1209,962,225,379,604,38,642
公投第１４案,高雄市,苓雅區,英明里,1210,964,171,377,548,45,593
公投第１４案,高雄市,苓雅區,林靖里,1211,1524,315,595,910,29,939
公投第１４案,高雄市,苓雅區,朝陽里,1212,1455,236,644,880,23,903
公投第１４案,高雄市,苓雅區,福隆里,1213,1272,223,436,659,38,697
公投第１４案,高雄市,苓雅區,福隆里,1214,1256,267,437,704,21,725
公投第１４案,高雄市,苓雅區,福祥里,1215,1203,191,482,673,26,699
公投第１４案,高雄市,苓雅區,福海里,1216,1062,184,464,648,28,676
公投第１４案,高雄市,苓雅區,福康里,1217,850,180,338,518,60,578
公投第１４案,高雄市,苓雅區,福康里,1218,1010,218,408,626,69,695
公投第１４案,高雄市,苓雅區,福人里,1219,1118,194,439,633,23,656
公投第１４案,高雄市,苓雅區,福人里,1220,937,192,282,474,37,511
公投第１４案,高雄市,苓雅區,福地里,1221,1493,232,541,773,23,796
公投第１４案,高雄市,苓雅區,福地里,1222,1183,254,476,730,21,751
公投第１４案,高雄市,苓雅區,福居里,1223,1318,227,465,692,23,715
公投第１４案,高雄市,苓雅區,福居里,1224,1362,249,524,773,50,823
公投第１４案,高雄市,苓雅區,福東里,1225,1102,202,431,633,50,683
公投第１４案,高雄市,苓雅區,福東里,1226,1481,265,580,845,40,885
公投第１４案,高雄市,苓雅區,福西里,1227,878,179,367,546,38,584
公投第１４案,高雄市,苓雅區,福西里,1228,908,153,324,477,18,495
公投第１４案,高雄市,苓雅區,永康里,1229,1056,227,419,646,54,700
公投第１４案,高雄市,苓雅區,永康里,1230,1091,185,417,602,29,631
公投第１４案,高雄市,苓雅區,正文里,1231,976,206,388,594,23,617
公投第１４案,高雄市,苓雅區,正文里,1232,1063,235,455,690,27,717
公投第１４案,高雄市,苓雅區,正言里,1233,1484,332,562,894,45,939
公投第１４案,高雄市,苓雅區,正言里,1234,1290,270,494,764,35,799
公投第１４案,高雄市,苓雅區,正大里,1235,1740,329,695,1024,53,1077
公投第１４案,高雄市,苓雅區,正大里,1236,1594,273,658,931,43,974
公投第１４案,高雄市,苓雅區,正大里,1237,1648,340,606,946,21,967
公投第１４案,高雄市,苓雅區,五福里,1238,1236,228,542,770,42,812
公投第１４案,高雄市,苓雅區,五福里,1239,1211,220,491,711,40,751
公投第１４案,高雄市,苓雅區,五福里,1240,1283,226,531,757,20,777
公投第１４案,高雄市,苓雅區,正心里,1241,1804,332,748,1080,68,1148
公投第１４案,高雄市,苓雅區,正心里,1242,1718,316,713,1029,49,1078
公投第１４案,高雄市,苓雅區,正道里,1243,1297,269,519,788,33,821
公投第１４案,高雄市,苓雅區,正道里,1244,1449,200,637,837,55,892
公投第１４案,高雄市,苓雅區,正道里,1245,1307,226,542,768,26,794
公投第１４案,高雄市,苓雅區,正義里,1246,1184,250,456,706,47,753
公投第１４案,高雄市,苓雅區,正義里,1247,1250,280,478,758,61,819
公投第１４案,高雄市,苓雅區,正仁里,1248,1248,234,478,712,27,739
公投第１４案,高雄市,苓雅區,正仁里,1249,1283,220,539,759,20,779
公投第１４案,高雄市,苓雅區,文昌里,1250,1121,190,488,678,25,703
公投第１４案,高雄市,苓雅區,文昌里,1251,1258,228,518,746,21,767
公投第１４案,高雄市,苓雅區,文昌里,1252,1339,266,521,787,27,814
公投第１４案,高雄市,苓雅區,建軍里,1253,1986,344,763,1107,49,1156
公投第１４案,高雄市,苓雅區,衛武里,1254,1028,183,317,500,27,527
公投第１４案,高雄市,苓雅區,衛武里,1255,948,202,378,580,13,593
公投第１４案,高雄市,鳳山區,鳳崗里,1256,1080,219,455,674,45,719
公投第１４案,高雄市,鳳山區,縣衙里,1257,819,159,326,485,33,518
公投第１４案,高雄市,鳳山區,曹公里,1258,851,139,349,488,45,533
公投第１４案,高雄市,鳳山區,曹公里,1259,1075,246,398,644,35,679
公投第１４案,高雄市,鳳山區,鎮西里,1260,1223,202,533,735,41,776
公投第１４案,高雄市,鳳山區,鎮西里,1261,1207,216,511,727,31,758
公投第１４案,高雄市,鳳山區,鎮西里,1262,1339,231,475,706,34,740
公投第１４案,高雄市,鳳山區,鎮西里,1263,1188,210,400,610,27,637
公投第１４案,高雄市,鳳山區,北門里,1264,1055,175,423,598,47,645
公投第１４案,高雄市,鳳山區,北門里,1265,1109,188,400,588,57,645
公投第１４案,高雄市,鳳山區,北門里,1266,756,162,315,477,34,511
公投第１４案,高雄市,鳳山區,北門里,1267,1182,196,446,642,33,675
公投第１４案,高雄市,鳳山區,鎮北里,1268,1496,269,563,832,67,899
公投第１４案,高雄市,鳳山區,鎮北里,1269,2094,357,644,1001,47,1048
公投第１４案,高雄市,鳳山區,鎮北里,1270,1672,299,615,914,22,936
公投第１４案,高雄市,鳳山區,鎮北里,1271,1761,330,620,950,21,971
公投第１４案,高雄市,鳳山區,鎮北里,1272,1450,253,550,803,62,865
公投第１４案,高雄市,鳳山區,武松里,1273,1455,259,471,730,32,762
公投第１４案,高雄市,鳳山區,武松里,1274,1234,193,497,690,49,739
公投第１４案,高雄市,鳳山區,忠誠里,1275,1713,350,668,1018,50,1068
公投第１４案,高雄市,鳳山區,忠誠里,1276,1698,276,596,872,34,906
公投第１４案,高雄市,鳳山區,文英里,1277,1247,250,469,719,55,774
公投第１４案,高雄市,鳳山區,文英里,1278,1087,233,402,635,35,670
公投第１４案,高雄市,鳳山區,文英里,1279,1199,236,475,711,23,734
公投第１４案,高雄市,鳳山區,文華里,1280,1559,226,629,855,45,900
公投第１４案,高雄市,鳳山區,文華里,1281,1233,228,508,736,28,764
公投第１４案,高雄市,鳳山區,文華里,1282,1277,256,489,745,47,792
公投第１４案,高雄市,鳳山區,文華里,1283,1481,264,583,847,21,868
公投第１４案,高雄市,鳳山區,文華里,1284,1154,240,490,730,24,754
公投第１４案,高雄市,鳳山區,文華里,1285,1475,314,599,913,17,930
公投第１４案,高雄市,鳳山區,文山里,1286,1247,205,448,653,29,682
公投第１４案,高雄市,鳳山區,文山里,1287,1538,346,457,803,52,855
公投第１４案,高雄市,鳳山區,文山里,1288,1097,195,429,624,32,656
公投第１４案,高雄市,鳳山區,文山里,1289,1221,242,398,640,21,661
公投第１４案,高雄市,鳳山區,文山里,1290,1075,265,425,690,41,731
公投第１４案,高雄市,鳳山區,文德里,1291,1751,351,682,1033,40,1073
公投第１４案,高雄市,鳳山區,文德里,1292,1758,346,696,1042,32,1074
公投第１４案,高雄市,鳳山區,文德里,1293,1749,281,683,964,76,1040
公投第１４案,高雄市,鳳山區,文德里,1294,1746,309,648,957,19,976
公投第１４案,高雄市,鳳山區,文德里,1295,1712,297,648,945,31,976
公投第１４案,高雄市,鳳山區,文衡里,1296,1247,232,497,729,23,752
公投第１４案,高雄市,鳳山區,文衡里,1297,1409,276,544,820,46,866
公投第１４案,高雄市,鳳山區,文衡里,1298,1347,277,502,779,35,814
公投第１４案,高雄市,鳳山區,文福里,1299,1771,326,668,994,22,1016
公投第１４案,高雄市,鳳山區,文福里,1300,1537,328,562,890,17,907
公投第１４案,高雄市,鳳山區,文福里,1301,1605,300,641,941,25,966
公投第１４案,高雄市,鳳山區,文福里,1302,1375,332,466,798,38,836
公投第１４案,高雄市,鳳山區,文福里,1303,1393,274,565,839,42,881
公投第１４案,高雄市,鳳山區,文福里,1304,1584,303,546,849,34,883
公投第１４案,高雄市,鳳山區,成功里,1305,618,114,235,349,21,370
公投第１４案,高雄市,鳳山區,縣口里,1306,423,83,176,259,9,268
公投第１４案,高雄市,鳳山區,光明里,1307,1312,218,518,736,48,784
公投第１４案,高雄市,鳳山區,和德里,1308,769,143,294,437,31,468
公投第１４案,高雄市,鳳山區,和德里,1309,1213,252,519,771,18,789
公投第１４案,高雄市,鳳山區,和興里,1310,1107,214,487,701,34,735
公投第１４案,高雄市,鳳山區,和興里,1311,1188,223,466,689,36,725
公投第１４案,高雄市,鳳山區,和興里,1312,1183,275,447,722,27,749
公投第１４案,高雄市,鳳山區,和興里,1313,1264,233,510,743,43,786
公投第１４案,高雄市,鳳山區,南興里,1314,882,151,346,497,36,533
公投第１４案,高雄市,鳳山區,三民里,1315,1007,219,449,668,39,707
公投第１４案,高雄市,鳳山區,新興里,1316,853,152,334,486,60,546
公投第１４案,高雄市,鳳山區,新興里,1317,1660,137,305,442,37,479
公投第１４案,高雄市,鳳山區,興仁里,1318,1124,222,434,656,37,693
公投第１４案,高雄市,鳳山區,興仁里,1319,1112,235,406,641,54,695
公投第１４案,高雄市,鳳山區,興仁里,1320,1182,201,453,654,37,691
公投第１４案,高雄市,鳳山區,興中里,1321,875,214,364,578,44,622
公投第１４案,高雄市,鳳山區,協和里,1322,1040,228,373,601,47,648
公投第１４案,高雄市,鳳山區,協和里,1323,1094,246,440,686,19,705
公投第１４案,高雄市,鳳山區,協和里,1324,1217,244,465,709,50,759
公投第１４案,高雄市,鳳山區,忠義里,1325,974,216,421,637,28,665
公投第１４案,高雄市,鳳山區,忠義里,1326,987,177,397,574,31,605
公投第１４案,高雄市,鳳山區,忠義里,1327,1210,238,531,769,20,789
公投第１４案,高雄市,鳳山區,忠義里,1328,1391,279,511,790,45,835
公投第１４案,高雄市,鳳山區,忠孝里,1329,1241,228,392,620,24,644
公投第１４案,高雄市,鳳山區,忠孝里,1330,1000,208,414,622,32,654
公投第１４案,高雄市,鳳山區,忠孝里,1331,1092,207,448,655,26,681
公投第１４案,高雄市,鳳山區,忠孝里,1332,1308,227,551,778,41,819
公投第１４案,高雄市,鳳山區,忠孝里,1333,1031,187,410,597,52,649
公投第１４案,高雄市,鳳山區,中和里,1334,1159,250,467,717,49,766
公投第１４案,高雄市,鳳山區,中和里,1335,1127,453,174,627,47,674
公投第１４案,高雄市,鳳山區,中和里,1336,1109,243,519,762,34,796
公投第１４案,高雄市,鳳山區,誠義里,1337,1879,342,806,1148,46,1194
公投第１４案,高雄市,鳳山區,誠義里,1338,1803,345,809,1154,47,1201
公投第１４案,高雄市,鳳山區,生明里,1339,2045,288,761,1049,65,1114
公投第１４案,高雄市,鳳山區,鎮東里,1340,1432,234,537,771,47,818
公投第１４案,高雄市,鳳山區,鎮東里,1341,1033,155,407,562,12,574
公投第１４案,高雄市,鳳山區,瑞竹里,1342,1253,205,522,727,72,799
公投第１４案,高雄市,鳳山區,瑞竹里,1343,1217,225,484,709,22,731
公投第１４案,高雄市,鳳山區,瑞竹里,1344,1267,223,558,781,41,822
公投第１４案,高雄市,鳳山區,瑞竹里,1345,1251,219,458,677,37,714
公投第１４案,高雄市,鳳山區,瑞興里,1346,1563,269,625,894,61,955
公投第１４案,高雄市,鳳山區,瑞興里,1347,1888,343,799,1142,44,1186
公投第１４案,高雄市,鳳山區,瑞興里,1348,1368,266,521,787,49,836
公投第１４案,高雄市,鳳山區,東門里,1349,1588,264,574,838,38,876
公投第１４案,高雄市,鳳山區,東門里,1350,1255,168,589,757,44,801
公投第１４案,高雄市,鳳山區,東門里,1351,1264,210,489,699,59,758
公投第１４案,高雄市,鳳山區,東門里,1352,1291,194,530,724,65,789
公投第１４案,高雄市,鳳山區,誠德里,1353,1224,185,520,705,33,738
公投第１４案,高雄市,鳳山區,誠德里,1354,1296,221,517,738,24,762
公投第１４案,高雄市,鳳山區,誠信里,1355,826,175,352,527,31,558
公投第１４案,高雄市,鳳山區,誠信里,1356,1229,184,541,725,26,751
公投第１４案,高雄市,鳳山區,誠智里,1357,1467,273,588,861,36,897
公投第１４案,高雄市,鳳山區,誠智里,1358,1218,204,494,698,47,745
公投第１４案,高雄市,鳳山區,鳳東里,1359,2173,299,850,1149,58,1207
公投第１４案,高雄市,鳳山區,鳳東里,1360,2255,371,899,1270,54,1324
公投第１４案,高雄市,鳳山區,鳳東里,1361,1556,257,656,913,35,948
公投第１４案,高雄市,鳳山區,埤頂里,1362,1521,275,534,809,40,849
公投第１４案,高雄市,鳳山區,埤頂里,1363,1407,187,519,706,38,744
公投第１４案,高雄市,鳳山區,埤頂里,1364,1542,251,628,879,59,938
公投第１４案,高雄市,鳳山區,埤頂里,1365,1502,230,564,794,16,810
公投第１４案,高雄市,鳳山區,中正里,1366,1320,232,537,769,52,821
公投第１４案,高雄市,鳳山區,中正里,1367,1507,151,658,809,27,836
公投第１４案,高雄市,鳳山區,中正里,1368,1284,151,634,785,45,830
公投第１４案,高雄市,鳳山區,海光里,1369,1441,252,512,764,34,798
公投第１４案,高雄市,鳳山區,海光里,1370,1485,241,617,858,64,922
公投第１４案,高雄市,鳳山區,國泰里,1371,1205,160,495,655,55,710
公投第１４案,高雄市,鳳山區,國泰里,1372,1284,209,500,709,22,731
公投第１４案,高雄市,鳳山區,國泰里,1373,1326,512,274,786,48,834
公投第１４案,高雄市,鳳山區,國光里,1374,1096,199,422,621,32,653
公投第１４案,高雄市,鳳山區,國光里,1375,1182,250,465,715,55,770
公投第１４案,高雄市,鳳山區,國光里,1376,1017,203,441,644,51,695
公投第１４案,高雄市,鳳山區,國隆里,1377,1198,216,438,654,68,722
公投第１４案,高雄市,鳳山區,國隆里,1378,1281,222,449,671,30,701
公投第１４案,高雄市,鳳山區,國富里,1379,1358,280,556,836,33,869
公投第１４案,高雄市,鳳山區,國富里,1380,1226,272,514,786,35,821
公投第１４案,高雄市,鳳山區,武慶里,1381,1098,218,447,665,52,717
公投第１４案,高雄市,鳳山區,武慶里,1382,1200,238,476,714,25,739
公投第１４案,高雄市,鳳山區,武漢里,1383,942,188,345,533,44,577
公投第１４案,高雄市,鳳山區,武漢里,1384,1206,214,477,691,22,713
公投第１４案,高雄市,鳳山區,武漢里,1385,1159,265,471,736,25,761
公投第１４案,高雄市,鳳山區,武漢里,1386,1401,302,527,829,47,876
公投第１４案,高雄市,鳳山區,新甲里,1387,1525,287,548,835,23,858
公投第１４案,高雄市,鳳山區,新甲里,1388,1345,224,533,757,39,796
公投第１４案,高雄市,鳳山區,新武里,1389,1180,213,511,724,36,760
公投第１４案,高雄市,鳳山區,新武里,1390,1106,201,400,601,23,624
公投第１４案,高雄市,鳳山區,新泰里,1391,1442,286,566,852,59,911
公投第１４案,高雄市,鳳山區,新泰里,1392,1376,316,504,820,42,862
公投第１４案,高雄市,鳳山區,新泰里,1393,1243,255,489,744,13,757
公投第１４案,高雄市,鳳山區,新樂里,1394,1361,255,535,790,23,813
公投第１４案,高雄市,鳳山區,新樂里,1395,1416,281,558,839,50,889
公投第１４案,高雄市,鳳山區,新樂里,1396,1536,335,625,960,46,1006
公投第１４案,高雄市,鳳山區,新強里,1397,1388,234,511,745,29,774
公投第１４案,高雄市,鳳山區,新強里,1398,1241,220,488,708,82,790
公投第１４案,高雄市,鳳山區,新強里,1399,1394,285,550,835,50,885
公投第１４案,高雄市,鳳山區,新強里,1400,1188,236,534,770,18,788
公投第１４案,高雄市,鳳山區,海洋里,1401,1112,208,467,675,27,702
公投第１４案,高雄市,鳳山區,海洋里,1402,1198,266,493,759,39,798
公投第１４案,高雄市,鳳山區,海洋里,1403,1475,298,545,843,25,868
公投第１４案,高雄市,鳳山區,新富里,1404,1216,218,435,653,34,687
公投第１４案,高雄市,鳳山區,新富里,1405,1318,243,447,690,38,728
公投第１４案,高雄市,鳳山區,新富里,1406,1465,273,561,834,19,853
公投第１４案,高雄市,鳳山區,老爺里,1407,1314,214,475,689,41,730
公投第１４案,高雄市,鳳山區,老爺里,1408,1649,256,565,821,29,850
公投第１４案,高雄市,鳳山區,老爺里,1409,1601,264,556,820,94,914
公投第１４案,高雄市,鳳山區,老爺里,1410,1155,225,449,674,24,698
公投第１４案,高雄市,鳳山區,老爺里,1411,1050,183,421,604,43,647
公投第１４案,高雄市,鳳山區,中民里,1412,1417,233,501,734,16,750
公投第１４案,高雄市,鳳山區,中民里,1413,1525,256,576,832,55,887
公投第１４案,高雄市,鳳山區,中民里,1414,1514,267,605,872,55,927
公投第１４案,高雄市,鳳山區,中崙里,1415,1190,225,438,663,43,706
公投第１４案,高雄市,鳳山區,中崙里,1416,1325,221,491,712,29,741
公投第１４案,高雄市,鳳山區,中榮里,1417,1049,198,413,611,50,661
公投第１４案,高雄市,鳳山區,中榮里,1418,1026,182,411,593,27,620
公投第１４案,高雄市,鳳山區,中榮里,1419,1152,221,457,678,45,723
公投第１４案,高雄市,鳳山區,中榮里,1420,1254,216,437,653,13,666
公投第１４案,高雄市,鳳山區,過埤里,1421,1688,254,619,873,41,914
公投第１４案,高雄市,鳳山區,過埤里,1422,1657,267,662,929,54,983
公投第１４案,高雄市,鳳山區,過埤里,1423,1729,283,603,886,34,920
公投第１４案,高雄市,鳳山區,過埤里,1424,1628,311,633,944,47,991
公投第１４案,高雄市,鳳山區,過埤里,1425,1891,311,642,953,12,965
公投第１４案,高雄市,鳳山區,過埤里,1426,1594,214,730,944,34,978
公投第１４案,高雄市,鳳山區,過埤里,1427,1342,254,593,847,20,867
公投第１４案,高雄市,鳳山區,過埤里,1428,1448,275,640,915,36,951
公投第１４案,高雄市,鳳山區,正義里,1429,1405,262,555,817,61,878
公投第１４案,高雄市,鳳山區,正義里,1430,1097,215,440,655,67,722
公投第１４案,高雄市,鳳山區,正義里,1431,1248,227,519,746,71,817
公投第１４案,高雄市,鳳山區,正義里,1432,1225,250,444,694,70,764
公投第１４案,高雄市,鳳山區,正義里,1433,1214,204,495,699,26,725
公投第１４案,高雄市,鳳山區,保安里,1434,2032,328,842,1170,84,1254
公投第１４案,高雄市,鳳山區,保安里,1435,1927,417,691,1108,50,1158
公投第１４案,高雄市,鳳山區,保安里,1436,2097,380,876,1256,45,1301
公投第１４案,高雄市,鳳山區,一甲里,1437,968,141,383,524,42,566
公投第１４案,高雄市,鳳山區,一甲里,1438,1200,196,440,636,47,683
公投第１４案,高雄市,鳳山區,一甲里,1439,1101,199,428,627,47,674
公投第１４案,高雄市,鳳山區,二甲里,1440,1369,215,501,716,43,759
公投第１４案,高雄市,鳳山區,二甲里,1441,1542,262,598,860,52,912
公投第１４案,高雄市,鳳山區,二甲里,1442,1536,277,635,912,46,958
公投第１４案,高雄市,鳳山區,龍成里,1443,1382,263,480,743,37,780
公投第１４案,高雄市,鳳山區,龍成里,1444,1452,294,541,835,67,902
公投第１４案,高雄市,鳳山區,鎮南里,1445,1058,154,453,607,34,641
公投第１４案,高雄市,鳳山區,鎮南里,1446,976,172,423,595,46,641
公投第１４案,高雄市,鳳山區,鎮南里,1447,1545,269,523,792,30,822
公投第１４案,高雄市,鳳山區,鎮南里,1448,1143,215,412,627,50,677
公投第１４案,高雄市,鳳山區,富甲里,1449,1301,110,224,334,17,351
公投第１４案,高雄市,鳳山區,富甲里,1450,1250,189,429,618,32,650
公投第１４案,高雄市,鳳山區,善美里,1451,1208,220,444,664,48,712
公投第１４案,高雄市,鳳山區,善美里,1452,1202,227,460,687,56,743
公投第１４案,高雄市,鳳山區,善美里,1453,1499,296,511,807,62,869
公投第１４案,高雄市,鳳山區,善美里,1454,1522,260,534,794,43,837
公投第１４案,高雄市,鳳山區,富榮里,1455,1125,217,475,692,45,737
公投第１４案,高雄市,鳳山區,富榮里,1456,1307,244,527,771,19,790
公投第１４案,高雄市,鳳山區,南和里,1457,1405,286,516,802,57,859
公投第１４案,高雄市,鳳山區,南和里,1458,1252,226,489,715,50,765
公投第１４案,高雄市,鳳山區,南成里,1459,1291,231,568,799,25,824
公投第１４案,高雄市,鳳山區,南成里,1460,938,192,361,553,50,603
公投第１４案,高雄市,鳳山區,南成里,1461,1783,298,728,1026,29,1055
公投第１４案,高雄市,鳳山區,南成里,1462,1105,216,439,655,36,691
公投第１４案,高雄市,鳳山區,南成里,1463,1392,523,237,760,72,832
公投第１４案,高雄市,鳳山區,南成里,1464,1244,236,556,792,43,835
公投第１４案,高雄市,鳳山區,天興里,1465,1154,219,406,625,43,668
公投第１４案,高雄市,鳳山區,天興里,1466,1153,233,426,659,47,706
公投第１４案,高雄市,鳳山區,天興里,1467,1148,178,407,585,18,603
公投第１４案,高雄市,鳳山區,大德里,1468,1432,321,379,700,127,827
公投第１４案,高雄市,鳳山區,大德里,1469,1429,222,389,611,25,636
公投第１４案,高雄市,鳳山區,大德里,1470,1479,251,554,805,31,836
公投第１４案,高雄市,鳳山區,五福里,1471,1026,180,445,625,35,660
公投第１４案,高雄市,鳳山區,五福里,1472,993,193,399,592,91,683
公投第１４案,高雄市,鳳山區,五福里,1473,947,182,380,562,58,620
公投第１４案,高雄市,鳳山區,福興里,1474,1042,185,393,578,46,624
公投第１４案,高雄市,鳳山區,福興里,1475,1098,195,415,610,55,665
公投第１４案,高雄市,鳳山區,福興里,1476,1284,222,450,672,18,690
公投第１４案,高雄市,鳳山區,福興里,1477,1242,212,428,640,45,685
公投第１４案,高雄市,鳳山區,福興里,1478,1093,212,412,624,69,693
公投第１４案,高雄市,鳳山區,福祥里,1479,1353,352,371,723,43,766
公投第１４案,高雄市,鳳山區,福祥里,1480,1353,232,485,717,46,763
公投第１４案,高雄市,鳳山區,福誠里,1481,1309,234,529,763,38,801
公投第１４案,高雄市,鳳山區,福誠里,1482,1627,342,574,916,47,963
公投第１４案,高雄市,鳳山區,福誠里,1483,1372,234,548,782,68,850
公投第１４案,高雄市,前鎮區,草衙里,1484,1809,279,627,906,98,1004
公投第１４案,高雄市,前鎮區,草衙里,1485,1835,289,654,943,60,1003
公投第１４案,高雄市,前鎮區,草衙里,1486,1890,291,503,794,50,844
公投第１４案,高雄市,前鎮區,草衙里,1487,2013,324,640,964,53,1017
公投第１４案,高雄市,前鎮區,草衙里,1488,1776,279,623,902,51,953
公投第１４案,高雄市,前鎮區,明孝里,1489,1705,279,492,771,71,842
公投第１４案,高雄市,前鎮區,明孝里,1490,672,129,231,360,61,421
公投第１４案,高雄市,前鎮區,明正里,1491,1726,251,524,775,80,855
公投第１４案,高雄市,前鎮區,明正里,1492,1597,305,500,805,104,909
公投第１４案,高雄市,前鎮區,明正里,1493,1690,352,582,934,74,1008
公投第１４案,高雄市,前鎮區,明義里,1494,1080,180,458,638,54,692
公投第１４案,高雄市,前鎮區,明義里,1495,1159,218,498,716,57,773
公投第１４案,高雄市,前鎮區,仁愛里,1496,1314,219,463,682,59,741
公投第１４案,高雄市,前鎮區,德昌里,1497,896,159,364,523,42,565
公投第１４案,高雄市,前鎮區,德昌里,1498,1002,183,370,553,44,597
公投第１４案,高雄市,前鎮區,平等里,1499,2765,339,654,993,83,1076
公投第１４案,高雄市,前鎮區,平昌里,1500,600,98,330,428,57,485
公投第１４案,高雄市,前鎮區,明禮里,1501,1466,187,337,524,33,557
公投第１４案,高雄市,前鎮區,信義里,1502,1449,239,522,761,51,812
公投第１４案,高雄市,前鎮區,信德里,1503,991,151,361,512,48,560
公投第１４案,高雄市,前鎮區,信德里,1504,1248,208,486,694,72,766
公投第１４案,高雄市,前鎮區,明道里,1505,1066,204,390,594,92,686
公投第１４案,高雄市,前鎮區,興化里,1506,706,132,240,372,27,399
公投第１４案,高雄市,前鎮區,興仁里,1507,713,101,264,365,27,392
公投第１４案,高雄市,前鎮區,前鎮里,1508,1344,244,449,693,35,728
公投第１４案,高雄市,前鎮區,鎮東里,1509,856,154,328,482,46,528
公投第１４案,高雄市,前鎮區,鎮東里,1510,873,156,284,440,47,487
公投第１４案,高雄市,前鎮區,鎮榮里,1511,1114,176,381,557,43,600
公投第１４案,高雄市,前鎮區,鎮榮里,1512,1112,210,357,567,13,580
公投第１４案,高雄市,前鎮區,鎮昌里,1513,1044,191,352,543,58,601
公投第１４案,高雄市,前鎮區,鎮昌里,1514,940,166,320,486,33,519
公投第１４案,高雄市,前鎮區,鎮海里,1515,1342,202,441,643,70,713
公投第１４案,高雄市,前鎮區,鎮海里,1516,1402,317,566,883,48,931
公投第１４案,高雄市,前鎮區,鎮海里,1517,1320,278,500,778,36,814
公投第１４案,高雄市,前鎮區,鎮陽里,1518,958,178,359,537,42,579
公投第１４案,高雄市,前鎮區,興邦里,1519,1276,269,568,837,40,877
公投第１４案,高雄市,前鎮區,興邦里,1520,1459,288,566,854,65,919
公投第１４案,高雄市,前鎮區,鎮中里,1521,761,131,249,380,11,391
公投第１４案,高雄市,前鎮區,鎮北里,1522,1093,204,387,591,18,609
公投第１４案,高雄市,前鎮區,忠純里,1523,1521,221,715,936,30,966
公投第１４案,高雄市,前鎮區,忠純里,1524,1557,242,709,951,21,972
公投第１４案,高雄市,前鎮區,忠純里,1525,1821,302,656,958,30,988
公投第１４案,高雄市,前鎮區,忠誠里,1526,1066,150,560,710,27,737
公投第１４案,高雄市,前鎮區,忠誠里,1527,1046,174,494,668,12,680
公投第１４案,高雄市,前鎮區,西山里,1528,1709,323,639,962,40,1002
公投第１４案,高雄市,前鎮區,西山里,1529,1723,309,686,995,69,1064
公投第１４案,高雄市,前鎮區,民權里,1530,1202,260,498,758,33,791
公投第１４案,高雄市,前鎮區,民權里,1531,1279,291,540,831,34,865
公投第１４案,高雄市,前鎮區,民權里,1532,1513,301,642,943,37,980
公投第１４案,高雄市,前鎮區,建隆里,1533,1260,231,506,737,16,753
公投第１４案,高雄市,前鎮區,振興里,1534,1139,226,458,684,72,756
公投第１４案,高雄市,前鎮區,振興里,1535,1140,260,473,733,33,766
公投第１４案,高雄市,前鎮區,良和里,1536,1462,295,600,895,68,963
公投第１４案,高雄市,前鎮區,良和里,1537,1359,263,554,817,31,848
公投第１４案,高雄市,前鎮區,西甲里,1538,2037,344,681,1025,56,1081
公投第１４案,高雄市,前鎮區,盛興里,1539,1410,264,525,789,14,803
公投第１４案,高雄市,前鎮區,盛興里,1540,1307,243,506,749,17,766
公投第１４案,高雄市,前鎮區,盛豐里,1541,1512,264,551,815,71,886
公投第１４案,高雄市,前鎮區,盛豐里,1542,1491,299,557,856,60,916
公投第１４案,高雄市,前鎮區,興中里,1543,1621,277,619,896,59,955
公投第１４案,高雄市,前鎮區,興中里,1544,1522,262,503,765,49,814
公投第１４案,高雄市,前鎮區,興東里,1545,1593,300,611,911,51,962
公投第１４案,高雄市,前鎮區,興東里,1546,1885,379,712,1091,67,1158
公投第１４案,高雄市,前鎮區,興東里,1547,1870,382,710,1092,70,1162
公投第１４案,高雄市,前鎮區,忠孝里,1548,1388,278,549,827,23,850
公投第１４案,高雄市,前鎮區,忠孝里,1549,1348,244,534,778,53,831
公投第１４案,高雄市,前鎮區,復國里,1550,1341,198,493,691,89,780
公投第１４案,高雄市,前鎮區,復國里,1551,1364,287,563,850,33,883
公投第１４案,高雄市,前鎮區,竹內里,1552,1367,265,512,777,58,835
公投第１４案,高雄市,前鎮區,竹內里,1553,1326,231,482,713,70,783
公投第１４案,高雄市,前鎮區,竹東里,1554,1059,202,385,587,33,620
公投第１４案,高雄市,前鎮區,竹東里,1555,1119,224,452,676,20,696
公投第１４案,高雄市,前鎮區,竹南里,1556,1565,306,542,848,32,880
公投第１４案,高雄市,前鎮區,竹南里,1557,1549,288,562,850,65,915
公投第１４案,高雄市,前鎮區,竹南里,1558,1691,376,702,1078,19,1097
公投第１４案,高雄市,前鎮區,竹南里,1559,1837,362,708,1070,27,1097
公投第１４案,高雄市,前鎮區,竹北里,1560,1092,208,466,674,15,689
公投第１４案,高雄市,前鎮區,竹北里,1561,1126,227,438,665,49,714
公投第１４案,高雄市,前鎮區,竹西里,1562,1215,208,435,643,64,707
公投第１４案,高雄市,前鎮區,竹西里,1563,1443,296,541,837,39,876
公投第１４案,高雄市,前鎮區,竹西里,1564,1448,304,666,970,16,986
公投第１４案,高雄市,前鎮區,竹中里,1565,1648,319,635,954,60,1014
公投第１４案,高雄市,前鎮區,竹中里,1566,1603,253,593,846,60,906
公投第１４案,高雄市,前鎮區,瑞竹里,1567,1596,285,502,787,30,817
公投第１４案,高雄市,前鎮區,瑞南里,1568,1450,207,538,745,27,772
公投第１４案,高雄市,前鎮區,瑞南里,1569,1510,253,516,769,81,850
公投第１４案,高雄市,前鎮區,瑞南里,1570,1647,323,651,974,67,1041
公投第１４案,高雄市,前鎮區,瑞豐里,1571,1342,220,506,726,57,783
公投第１４案,高雄市,前鎮區,瑞豐里,1572,1384,249,467,716,41,757
公投第１４案,高雄市,前鎮區,瑞祥里,1573,1479,261,531,792,53,845
公投第１４案,高雄市,前鎮區,瑞祥里,1574,1546,212,672,884,27,911
公投第１４案,高雄市,前鎮區,瑞祥里,1575,1595,372,567,939,35,974
公投第１４案,高雄市,前鎮區,瑞東里,1576,1201,207,491,698,50,748
公投第１４案,高雄市,前鎮區,瑞東里,1577,1082,183,377,560,22,582
公投第１４案,高雄市,前鎮區,瑞和里,1578,996,161,356,517,31,548
公投第１４案,高雄市,前鎮區,瑞和里,1579,932,167,346,513,71,584
公投第１４案,高雄市,前鎮區,瑞平里,1580,1146,208,449,657,42,699
公投第１４案,高雄市,前鎮區,瑞平里,1581,1096,232,413,645,28,673
公投第１４案,高雄市,前鎮區,瑞平里,1582,1332,293,539,832,22,854
公投第１４案,高雄市,前鎮區,瑞隆里,1583,1175,238,432,670,32,702
公投第１４案,高雄市,前鎮區,瑞隆里,1584,986,182,376,558,46,604
公投第１４案,高雄市,前鎮區,瑞隆里,1585,1316,275,494,769,56,825
公投第１４案,高雄市,前鎮區,瑞北里,1586,1559,263,512,775,58,833
公投第１４案,高雄市,前鎮區,瑞北里,1587,1622,304,633,937,64,1001
公投第１４案,高雄市,前鎮區,瑞西里,1588,1310,227,506,733,27,760
公投第１４案,高雄市,前鎮區,瑞西里,1589,1299,254,505,759,60,819
公投第１４案,高雄市,前鎮區,瑞崗里,1590,1191,223,520,743,54,797
公投第１４案,高雄市,前鎮區,瑞崗里,1591,1375,235,517,752,28,780
公投第１４案,高雄市,前鎮區,瑞興里,1592,1338,241,520,761,28,789
公投第１４案,高雄市,前鎮區,瑞興里,1593,1175,234,418,652,22,674
公投第１４案,高雄市,前鎮區,瑞誠里,1594,1357,247,578,825,28,853
公投第１４案,高雄市,前鎮區,瑞誠里,1595,1187,136,595,731,50,781
公投第１４案,高雄市,前鎮區,瑞文里,1596,1164,189,465,654,35,689
公投第１４案,高雄市,前鎮區,瑞文里,1597,1219,154,562,716,62,778
公投第１４案,高雄市,前鎮區,瑞華里,1598,1428,267,517,784,16,800
公投第１４案,高雄市,前鎮區,瑞華里,1599,1495,272,534,806,75,881
公投第１４案,高雄市,前鎮區,瑞華里,1600,1531,348,563,911,37,948
公投第１４案,高雄市,前鎮區,瑞昌里,1601,1509,308,549,857,48,905
公投第１４案,高雄市,前鎮區,瑞昌里,1602,1591,258,598,856,58,914
公投第１４案,高雄市,小港區,小港里,1603,1108,228,478,706,24,730
公投第１４案,高雄市,小港區,小港里,1604,1171,204,484,688,54,742
公投第１４案,高雄市,小港區,港口里,1605,1557,356,617,973,16,989
公投第１４案,高雄市,小港區,港口里,1606,1668,253,622,875,23,898
公投第１４案,高雄市,小港區,港正里,1607,1183,215,513,728,21,749
公投第１４案,高雄市,小港區,港正里,1608,1372,255,557,812,30,842
公投第１４案,高雄市,小港區,港墘里,1609,1737,304,703,1007,56,1063
公投第１４案,高雄市,小港區,港明里,1610,1586,297,545,842,64,906
公投第１４案,高雄市,小港區,港明里,1611,1558,233,574,807,56,863
公投第１４案,高雄市,小港區,港后里,1612,1284,262,538,800,59,859
公投第１４案,高雄市,小港區,港后里,1613,1249,243,497,740,40,780
公投第１４案,高雄市,小港區,港南里,1614,2400,370,665,1035,82,1117
公投第１４案,高雄市,小港區,港興里,1615,1181,225,477,702,32,734
公投第１４案,高雄市,小港區,港興里,1616,1079,190,410,600,28,628
公投第１４案,高雄市,小港區,鳳宮里,1617,1335,276,468,744,45,789
公投第１４案,高雄市,小港區,鳳宮里,1618,1241,230,490,720,48,768
公投第１４案,高雄市,小港區,店鎮里,1619,1513,256,580,836,45,881
公投第１４案,高雄市,小港區,店鎮里,1620,1349,229,564,793,50,843
公投第１４案,高雄市,小港區,店鎮里,1621,1483,252,562,814,41,855
公投第１４案,高雄市,小港區,店鎮里,1622,1451,298,541,839,24,863
公投第１４案,高雄市,小港區,大苓里,1623,1241,212,442,654,26,680
公投第１４案,高雄市,小港區,大苓里,1624,1262,261,527,788,57,845
公投第１４案,高雄市,小港區,二苓里,1625,1813,315,728,1043,65,1108
公投第１４案,高雄市,小港區,二苓里,1626,1877,312,614,926,37,963
公投第１４案,高雄市,小港區,三苓里,1627,1391,248,530,778,26,804
公投第１４案,高雄市,小港區,三苓里,1628,1453,280,586,866,35,901
公投第１４案,高雄市,小港區,正苓里,1629,1374,246,539,785,32,817
公投第１４案,高雄市,小港區,正苓里,1630,1348,236,520,756,39,795
公投第１４案,高雄市,小港區,正苓里,1631,1334,237,554,791,46,837
公投第１４案,高雄市,小港區,順苓里,1632,1433,290,522,812,27,839
公投第１４案,高雄市,小港區,順苓里,1633,1448,279,481,760,18,778
公投第１４案,高雄市,小港區,順苓里,1634,1488,306,601,907,53,960
公投第１４案,高雄市,小港區,六苓里,1635,1278,231,519,750,50,800
公投第１４案,高雄市,小港區,六苓里,1636,1306,275,583,858,38,896
公投第１４案,高雄市,小港區,宏亮里,1637,1625,290,642,932,68,1000
公投第１４案,高雄市,小港區,宏亮里,1638,1640,304,686,990,63,1053
公投第１４案,高雄市,小港區,山東里,1639,1506,243,597,840,46,886
公投第１４案,高雄市,小港區,山東里,1640,1438,240,506,746,55,801
公投第１４案,高雄市,小港區,青島里,1641,1105,229,482,711,32,743
公投第１４案,高雄市,小港區,青島里,1642,1167,189,446,635,22,657
公投第１４案,高雄市,小港區,濟南里,1643,1420,261,600,861,31,892
公投第１４案,高雄市,小港區,濟南里,1644,1380,284,575,859,51,910
公投第１４案,高雄市,小港區,濟南里,1645,1239,221,478,699,29,728
公投第１４案,高雄市,小港區,泰山里,1646,1563,620,314,934,40,974
公投第１４案,高雄市,小港區,泰山里,1647,1644,257,682,939,53,992
公投第１４案,高雄市,小港區,山明里,1648,1895,595,440,1035,64,1099
公投第１４案,高雄市,小港區,山明里,1649,1748,287,640,927,79,1006
公投第１４案,高雄市,小港區,山明里,1650,1579,267,630,897,57,954
公投第１４案,高雄市,小港區,山明里,1651,2135,391,756,1147,38,1185
公投第１４案,高雄市,小港區,山明里,1652,1728,277,686,963,55,1018
公投第１４案,高雄市,小港區,山明里,1653,2022,361,692,1053,43,1096
公投第１４案,高雄市,小港區,高松里,1654,1329,178,461,639,28,667
公投第１４案,高雄市,小港區,高松里,1655,1320,220,515,735,30,765
公投第１４案,高雄市,小港區,高松里,1656,1267,219,491,710,71,781
公投第１４案,高雄市,小港區,松金里,1657,1298,245,509,754,76,830
公投第１４案,高雄市,小港區,松金里,1658,1289,270,520,790,28,818
公投第１４案,高雄市,小港區,松山里,1659,1534,263,634,897,47,944
公投第１４案,高雄市,小港區,松山里,1660,1494,247,619,866,31,897
公投第１４案,高雄市,小港區,大坪里,1661,1377,218,557,775,61,836
公投第１４案,高雄市,小港區,大坪里,1662,1344,261,553,814,49,863
公投第１４案,高雄市,小港區,坪頂里,1663,1508,277,559,836,39,875
公投第１４案,高雄市,小港區,坪頂里,1664,1400,247,498,745,26,771
公投第１４案,高雄市,小港區,坪頂里,1665,1457,261,587,848,48,896
公投第１４案,高雄市,小港區,坪頂里,1666,1392,223,538,761,25,786
公投第１４案,高雄市,小港區,孔宅里,1667,1983,281,770,1051,48,1099
公投第１４案,高雄市,小港區,孔宅里,1668,1204,225,448,673,28,701
公投第１４案,高雄市,小港區,孔宅里,1669,1300,262,466,728,33,761
公投第１４案,高雄市,小港區,廈莊里,1670,1857,302,763,1065,91,1156
公投第１４案,高雄市,小港區,廈莊里,1671,1566,488,393,881,31,912
公投第１４案,高雄市,小港區,合作里,1672,1343,276,564,840,50,890
公投第１４案,高雄市,小港區,合作里,1673,1236,259,498,757,66,823
公投第１４案,高雄市,小港區,桂林里,1674,1564,297,624,921,71,992
公投第１４案,高雄市,小港區,桂林里,1675,1484,261,572,833,23,856
公投第１４案,高雄市,小港區,桂林里,1676,1477,256,572,828,29,857
公投第１４案,高雄市,小港區,桂林里,1677,1482,340,570,910,19,929
公投第１４案,高雄市,小港區,桂林里,1678,1708,310,600,910,29,939
公投第１４案,高雄市,小港區,中厝里,1679,1867,304,720,1024,63,1087
公投第１４案,高雄市,小港區,中厝里,1680,1709,335,596,931,17,948
公投第１４案,高雄市,小港區,鳳鳴里,1681,1425,218,517,735,50,785
公投第１４案,高雄市,小港區,鳳鳴里,1682,1696,225,579,804,35,839
公投第１４案,高雄市,小港區,龍鳳里,1683,1522,242,496,738,40,778
公投第１４案,高雄市,小港區,龍鳳里,1684,1531,258,577,835,69,904
公投第１４案,高雄市,小港區,鳳森里,1685,2215,351,781,1132,103,1235
公投第１４案,高雄市,小港區,鳳林里,1686,1515,266,541,807,38,845
公投第１４案,高雄市,小港區,鳳林里,1687,1535,276,512,788,27,815
公投第１４案,高雄市,小港區,鳳興里,1688,1276,237,453,690,25,715
公投第１４案,高雄市,小港區,鳳興里,1689,1217,216,393,609,31,640
公投第１４案,高雄市,小港區,鳳源里,1690,1707,246,545,791,65,856
公投第１４案,高雄市,小港區,鳳源里,1691,1920,288,641,929,99,1028
公投第１４案,高雄市,大寮區,拷潭里,1692,727,225,121,346,27,373
公投第１４案,高雄市,大寮區,拷潭里,1693,718,116,226,342,15,357
公投第１４案,高雄市,大寮區,內坑里,1694,1340,214,457,671,36,707
公投第１４案,高雄市,大寮區,內坑里,1695,1575,217,481,698,46,744
公投第１４案,高雄市,大寮區,內坑里,1696,444,60,188,248,15,263
公投第１４案,高雄市,大寮區,內坑里,1697,2374,294,726,1020,42,1062
公投第１４案,高雄市,大寮區,大寮里,1698,1291,211,461,672,62,734
公投第１４案,高雄市,大寮區,大寮里,1699,1400,293,449,742,72,814
公投第１４案,高雄市,大寮區,大寮里,1700,1390,216,520,736,23,759
公投第１４案,高雄市,大寮區,大寮里,1701,1401,230,495,725,58,783
公投第１４案,高雄市,大寮區,大寮里,1702,1199,185,423,608,29,637
公投第１４案,高雄市,大寮區,上寮里,1703,1210,198,387,585,25,610
公投第１４案,高雄市,大寮區,上寮里,1704,1195,196,440,636,41,677
公投第１４案,高雄市,大寮區,三隆里,1705,1166,188,415,603,19,622
公投第１４案,高雄市,大寮區,三隆里,1706,1353,246,484,730,33,763
公投第１４案,高雄市,大寮區,三隆里,1707,1052,221,371,592,56,648
公投第１４案,高雄市,大寮區,三隆里,1708,1024,164,315,479,14,493
公投第１４案,高雄市,大寮區,琉球里,1709,1189,198,460,658,24,682
公投第１４案,高雄市,大寮區,琉球里,1710,1512,263,580,843,74,917
公投第１４案,高雄市,大寮區,琉球里,1711,1633,257,567,824,56,880
公投第１４案,高雄市,大寮區,翁園里,1712,1214,213,480,693,54,747
公投第１４案,高雄市,大寮區,翁園里,1713,1258,237,524,761,60,821
公投第１４案,高雄市,大寮區,翁園里,1714,1323,260,508,768,32,800
公投第１４案,高雄市,大寮區,前庄里,1715,1253,516,213,729,36,765
公投第１４案,高雄市,大寮區,前庄里,1716,1035,175,420,595,53,648
公投第１４案,高雄市,大寮區,中庄里,1717,1106,170,429,599,36,635
公投第１４案,高雄市,大寮區,中庄里,1718,1195,172,479,651,38,689
公投第１４案,高雄市,大寮區,中庄里,1719,1051,198,413,611,26,637
公投第１４案,高雄市,大寮區,中庄里,1720,1425,263,535,798,58,856
公投第１４案,高雄市,大寮區,中庄里,1721,1635,262,590,852,52,904
公投第１４案,高雄市,大寮區,中庄里,1722,1359,229,538,767,48,815
公投第１４案,高雄市,大寮區,中庄里,1723,1361,240,522,762,57,819
公投第１４案,高雄市,大寮區,中庄里,1724,1629,256,643,899,33,932
公投第１４案,高雄市,大寮區,後庄里,1725,1518,210,632,842,41,883
公投第１４案,高雄市,大寮區,後庄里,1726,1620,257,579,836,60,896
公投第１４案,高雄市,大寮區,後庄里,1727,1648,263,596,859,14,873
公投第１４案,高雄市,大寮區,後庄里,1728,1385,235,532,767,46,813
公投第１４案,高雄市,大寮區,後庄里,1729,1435,230,535,765,27,792
公投第１４案,高雄市,大寮區,義仁里,1730,1046,164,402,566,24,590
公投第１４案,高雄市,大寮區,義仁里,1731,789,118,282,400,26,426
公投第１４案,高雄市,大寮區,新厝里,1732,909,168,293,461,31,492
公投第１４案,高雄市,大寮區,新厝里,1733,733,129,275,404,33,437
公投第１４案,高雄市,大寮區,過溪里,1734,1553,267,513,780,60,840
公投第１４案,高雄市,大寮區,過溪里,1735,922,165,326,491,28,519
公投第１４案,高雄市,大寮區,潮寮里,1736,1012,158,365,523,65,588
公投第１４案,高雄市,大寮區,潮寮里,1737,968,177,307,484,58,542
公投第１４案,高雄市,大寮區,潮寮里,1738,1021,182,377,559,35,594
公投第１４案,高雄市,大寮區,會結里,1739,1554,232,470,702,60,762
公投第１４案,高雄市,大寮區,會社里,1740,1120,187,459,646,41,687
公投第１４案,高雄市,大寮區,會社里,1741,1225,233,498,731,43,774
公投第１４案,高雄市,大寮區,會社里,1742,1320,139,352,491,21,512
公投第１４案,高雄市,大寮區,會社里,1743,1317,227,485,712,39,751
公投第１４案,高雄市,大寮區,會社里,1744,1119,203,398,601,24,625
公投第１４案,高雄市,大寮區,山頂里,1745,1190,203,478,681,42,723
公投第１４案,高雄市,大寮區,山頂里,1746,1229,212,503,715,41,756
公投第１４案,高雄市,大寮區,山頂里,1747,1178,206,510,716,37,753
公投第１４案,高雄市,大寮區,山頂里,1748,1272,226,534,760,31,791
公投第１４案,高雄市,大寮區,山頂里,1749,1413,248,521,769,24,793
公投第１４案,高雄市,大寮區,山頂里,1750,1185,209,484,693,48,741
公投第１４案,高雄市,大寮區,忠義里,1751,553,77,236,313,10,323
公投第１４案,高雄市,大寮區,永芳里,1752,1121,164,409,573,57,630
公投第１４案,高雄市,大寮區,永芳里,1753,1227,228,454,682,24,706
公投第１４案,高雄市,大寮區,永芳里,1754,1058,205,449,654,59,713
公投第１４案,高雄市,大寮區,永芳里,1755,1209,204,469,673,24,697
公投第１４案,高雄市,大寮區,永芳里,1756,1100,178,462,640,18,658
公投第１４案,高雄市,大寮區,永芳里,1757,1122,195,392,587,26,613
公投第１４案,高雄市,大寮區,義和里,1758,983,180,412,592,52,644
公投第１４案,高雄市,大寮區,義和里,1759,1192,155,443,598,24,622
公投第１４案,高雄市,大寮區,溪寮里,1760,719,101,281,382,24,406
公投第１４案,高雄市,大寮區,溪寮里,1761,829,123,377,500,28,528
公投第１４案,高雄市,大寮區,江山里,1762,771,129,344,473,60,533
公投第１４案,高雄市,大寮區,江山里,1763,1075,226,406,632,49,681
公投第１４案,高雄市,大寮區,昭明里,1764,1280,220,506,726,72,798
公投第１４案,高雄市,大寮區,昭明里,1765,1179,173,446,619,77,696
公投第１４案,高雄市,大寮區,昭明里,1766,1210,295,339,634,31,665
公投第１４案,高雄市,大寮區,光武里,1767,189,28,81,109,6,115
公投第１４案,高雄市,大寮區,中興里,1768,1228,189,521,710,45,755
公投第１４案,高雄市,大寮區,中興里,1769,1170,162,477,639,37,676
公投第１４案,高雄市,大寮區,中興里,1770,1416,249,581,830,43,873
公投第１４案,高雄市,大寮區,中興里,1771,1482,267,605,872,33,905
公投第１４案,高雄市,大寮區,中興里,1772,1478,246,523,769,51,820
公投第１４案,高雄市,林園區,東林里,1773,1262,227,480,707,60,767
公投第１４案,高雄市,林園區,東林里,1774,1562,252,550,802,50,852
公投第１４案,高雄市,林園區,林園里,1775,1078,204,400,604,17,621
公投第１４案,高雄市,林園區,林園里,1776,979,194,397,591,37,628
公投第１４案,高雄市,林園區,林園里,1777,1195,196,432,628,57,685
公投第１４案,高雄市,林園區,溪州里,1778,1380,217,478,695,60,755
公投第１４案,高雄市,林園區,溪州里,1779,1280,200,462,662,73,735
公投第１４案,高雄市,林園區,溪州里,1780,1269,182,475,657,22,679
公投第１４案,高雄市,林園區,潭頭里,1781,1568,227,433,660,20,680
公投第１４案,高雄市,林園區,潭頭里,1782,1226,209,483,692,44,736
公投第１４案,高雄市,林園區,中厝里,1783,1480,229,543,772,47,819
公投第１４案,高雄市,林園區,中厝里,1784,1459,223,588,811,52,863
公投第１４案,高雄市,林園區,中門里,1785,1593,265,544,809,45,854
公投第１４案,高雄市,林園區,中門里,1786,895,155,317,472,73,545
公投第１４案,高雄市,林園區,頂厝里,1787,1110,165,386,551,30,581
公投第１４案,高雄市,林園區,頂厝里,1788,1348,214,472,686,48,734
公投第１４案,高雄市,林園區,頂厝里,1789,912,163,335,498,49,547
公投第１４案,高雄市,林園區,頂厝里,1790,1085,198,461,659,44,703
公投第１４案,高雄市,林園區,港埔里,1791,955,358,167,525,19,544
公投第１４案,高雄市,林園區,港埔里,1792,879,148,364,512,37,549
公投第１４案,高雄市,林園區,西溪里,1793,1103,193,390,583,58,641
公投第１４案,高雄市,林園區,西溪里,1794,1054,205,425,630,54,684
公投第１４案,高雄市,林園區,西溪里,1795,1292,198,449,647,14,661
公投第１４案,高雄市,林園區,港嘴里,1796,1683,268,531,799,21,820
公投第１４案,高雄市,林園區,北汕里,1797,607,90,237,327,26,353
公投第１４案,高雄市,林園區,北汕里,1798,1012,161,374,535,60,595
公投第１４案,高雄市,林園區,林內里,1799,1046,173,398,571,49,620
公投第１４案,高雄市,林園區,林內里,1800,914,111,309,420,21,441
公投第１４案,高雄市,林園區,王公里,1801,1405,289,496,785,48,833
公投第１４案,高雄市,林園區,王公里,1802,1299,258,483,741,55,796
公投第１４案,高雄市,林園區,王公里,1803,1170,103,433,536,29,565
公投第１４案,高雄市,林園區,林家里,1804,1299,192,391,583,36,619
公投第１４案,高雄市,林園區,龔厝里,1805,1031,179,385,564,25,589
公投第１４案,高雄市,林園區,龔厝里,1806,849,132,301,433,18,451
公投第１４案,高雄市,林園區,鳳芸里,1807,838,156,259,415,43,458
公投第１４案,高雄市,林園區,鳳芸里,1808,938,146,364,510,29,539
公投第１４案,高雄市,林園區,中芸里,1809,1051,169,349,518,25,543
公投第１４案,高雄市,林園區,中芸里,1810,786,144,294,438,46,484
公投第１４案,高雄市,林園區,東汕里,1811,894,140,360,500,57,557
公投第１４案,高雄市,林園區,西汕里,1812,749,99,205,304,19,323
公投第１４案,高雄市,林園區,仁愛里,1813,1485,258,605,863,27,890
公投第１４案,高雄市,林園區,仁愛里,1814,1478,256,588,844,61,905
公投第１４案,高雄市,林園區,文賢里,1815,1345,169,535,704,63,767
公投第１４案,高雄市,林園區,文賢里,1816,1038,170,367,537,41,578
公投第１４案,高雄市,林園區,廣應里,1817,1203,227,452,679,22,701
公投第１４案,高雄市,林園區,廣應里,1818,1138,184,458,642,16,658
公投第１４案,高雄市,林園區,廣應里,1819,1025,157,347,504,13,517
公投第１４案,高雄市,林園區,五福里,1820,1341,224,497,721,69,790
公投第１４案,高雄市,林園區,五福里,1821,1218,174,400,574,8,582
公投第１４案,高雄市,林園區,中汕里,1822,1147,149,353,502,19,521
公投第１４案,高雄市,林園區,中汕里,1823,1176,148,384,532,18,550
公投第１４案,新北市,石門區,德茂里,1,1121,197,333,530,51,581
公投第１４案,新北市,石門區,富基里,2,1389,195,317,512,161,673
公投第１４案,新北市,石門區,老梅里,3,933,128,319,447,46,493
公投第１４案,新北市,石門區,老梅里,4,1244,182,378,560,59,619
公投第１４案,新北市,石門區,山溪里,5,883,122,303,425,60,485
公投第１４案,新北市,石門區,石門里,6,1564,240,555,795,46,841
公投第１４案,新北市,石門區,尖鹿里,7,1500,229,518,747,50,797
公投第１４案,新北市,石門區,乾華里,8,328,34,102,136,15,151
公投第１４案,新北市,石門區,茂林里,9,651,116,258,374,31,405
公投第１４案,新北市,石門區,草里里,10,915,92,269,361,51,412
公投第１４案,新北市,三芝區,八賢里,11,312,46,90,136,12,148
公投第１４案,新北市,三芝區,埔頭里,12,1421,239,429,668,32,700
公投第１４案,新北市,三芝區,埔頭里,13,1557,268,487,755,50,805
公投第１４案,新北市,三芝區,埔頭里,14,1828,310,561,871,64,935
公投第１４案,新北市,三芝區,古庄里,15,1060,172,329,501,42,543
公投第１４案,新北市,三芝區,新庄里,16,819,110,206,316,40,356
公投第１４案,新北市,三芝區,埔坪里,17,1701,214,469,683,36,719
公投第１４案,新北市,三芝區,埔坪里,18,1740,281,505,786,53,839
公投第１４案,新北市,三芝區,埔坪里,19,1451,214,426,640,47,687
公投第１４案,新北市,三芝區,埔坪里,20,1248,161,374,535,40,575
公投第１４案,新北市,三芝區,茂長里,21,629,100,221,321,13,334
公投第１４案,新北市,三芝區,橫山里,22,504,55,160,215,19,234
公投第１４案,新北市,三芝區,錫板里,23,698,95,200,295,23,318
公投第１４案,新北市,三芝區,後厝里,24,2069,307,621,928,46,974
公投第１４案,新北市,三芝區,福德里,25,784,140,247,387,30,417
公投第１４案,新北市,三芝區,圓山里,26,522,70,167,237,29,266
公投第１４案,新北市,三芝區,店子里,27,587,90,174,264,44,308
公投第１４案,新北市,三芝區,興華里,28,1189,201,360,561,51,612
公投第１４案,新北市,淡水區,中和里,29,544,90,172,262,30,292
公投第１４案,新北市,淡水區,屯山里,30,1044,152,374,526,55,581
公投第１４案,新北市,淡水區,賢孝里,31,1462,213,480,693,53,746
公投第１４案,新北市,淡水區,興仁里,32,1525,232,496,728,71,799
公投第１４案,新北市,淡水區,蕃薯里,33,986,140,297,437,41,478
公投第１４案,新北市,淡水區,忠山里,34,806,112,307,419,42,461
公投第１４案,新北市,淡水區,義山里,35,1173,176,416,592,65,657
公投第１４案,新北市,淡水區,義山里,36,1343,179,431,610,38,648
公投第１４案,新北市,淡水區,水源里,37,1153,165,328,493,21,514
公投第１４案,新北市,淡水區,水源里,38,874,118,295,413,31,444
公投第１４案,新北市,淡水區,忠寮里,39,1063,249,279,528,69,597
公投第１４案,新北市,淡水區,樹興里,40,1309,194,436,630,31,661
公投第１４案,新北市,淡水區,坪頂里,41,1290,232,428,660,45,705
公投第１４案,新北市,淡水區,福德里,42,1675,300,624,924,27,951
公投第１４案,新北市,淡水區,福德里,43,1589,291,542,833,45,878
公投第１４案,新北市,淡水區,福德里,44,1624,343,558,901,41,942
公投第１４案,新北市,淡水區,福德里,45,1241,238,398,636,25,661
公投第１４案,新北市,淡水區,竹圍里,46,1317,217,447,664,41,705
公投第１４案,新北市,淡水區,竹圍里,47,1225,231,451,682,25,707
公投第１４案,新北市,淡水區,竹圍里,48,1426,276,483,759,29,788
公投第１４案,新北市,淡水區,竹圍里,49,1610,359,534,893,42,935
公投第１４案,新北市,淡水區,民權里,50,1982,400,670,1070,36,1106
公投第１４案,新北市,淡水區,民權里,51,1924,304,550,854,46,900
公投第１４案,新北市,淡水區,民生里,52,1822,340,537,877,42,919
公投第１４案,新北市,淡水區,民生里,53,1232,250,415,665,73,738
公投第１４案,新北市,淡水區,民生里,54,1588,254,593,847,63,910
公投第１４案,新北市,淡水區,民生里,55,1784,348,520,868,29,897
公投第１４案,新北市,淡水區,八勢里,56,1762,331,529,860,67,927
公投第１４案,新北市,淡水區,八勢里,57,1546,315,479,794,30,824
公投第１４案,新北市,淡水區,八勢里,58,1897,379,600,979,43,1022
公投第１４案,新北市,淡水區,竿蓁里,59,1489,286,480,766,33,799
公投第１４案,新北市,淡水區,竿蓁里,60,1679,283,535,818,40,858
公投第１４案,新北市,淡水區,竿蓁里,61,1693,300,508,808,32,840
公投第１４案,新北市,淡水區,竿蓁里,62,1674,266,544,810,19,829
公投第１４案,新北市,淡水區,竿蓁里,63,1330,237,463,700,28,728
公投第１４案,新北市,淡水區,竿蓁里,64,1467,266,486,752,16,768
公投第１４案,新北市,淡水區,崁頂里,65,1837,287,660,947,33,980
公投第１４案,新北市,淡水區,崁頂里,66,1924,235,401,636,15,651
公投第１４案,新北市,淡水區,崁頂里,67,2340,414,736,1150,30,1180
公投第１４案,新北市,淡水區,崁頂里,68,1704,263,498,761,46,807
公投第１４案,新北市,淡水區,崁頂里,69,1363,246,436,682,38,720
公投第１４案,新北市,淡水區,崁頂里,70,3068,469,924,1393,27,1420
公投第１４案,新北市,淡水區,埤島里,71,1528,228,491,719,38,757
公投第１４案,新北市,淡水區,水碓里,72,1600,285,504,789,44,833
公投第１４案,新北市,淡水區,水碓里,73,1874,317,681,998,55,1053
公投第１４案,新北市,淡水區,水碓里,74,1567,568,210,778,56,834
公投第１４案,新北市,淡水區,北新里,75,1245,279,393,672,31,703
公投第１４案,新北市,淡水區,北新里,76,1211,233,379,612,16,628
公投第１４案,新北市,淡水區,正德里,77,1992,399,681,1080,41,1121
公投第１４案,新北市,淡水區,正德里,78,2028,388,681,1069,26,1095
公投第１４案,新北市,淡水區,新興里,79,1373,214,529,743,38,781
公投第１４案,新北市,淡水區,新興里,80,1732,325,582,907,38,945
公投第１４案,新北市,淡水區,新興里,81,1519,286,447,733,33,766
公投第１４案,新北市,淡水區,新興里,82,1727,285,531,816,20,836
公投第１４案,新北市,淡水區,新義里,83,1297,225,474,699,28,727
公投第１４案,新北市,淡水區,新義里,84,1066,182,342,524,47,571
公投第１４案,新北市,淡水區,新義里,85,1387,237,506,743,35,778
公投第１４案,新北市,淡水區,新春里,86,1909,326,683,1009,34,1043
公投第１４案,新北市,淡水區,新春里,87,1770,301,614,915,42,957
公投第１４案,新北市,淡水區,新春里,88,2049,335,661,996,39,1035
公投第１４案,新北市,淡水區,新春里,89,1680,418,458,876,30,906
公投第１４案,新北市,淡水區,新民里,90,1433,287,509,796,50,846
公投第１４案,新北市,淡水區,新民里,91,1365,239,438,677,28,705
公投第１４案,新北市,淡水區,新民里,92,1452,275,491,766,44,810
公投第１４案,新北市,淡水區,北投里,93,1804,304,619,923,38,961
公投第１４案,新北市,淡水區,北投里,94,1322,245,452,697,40,737
公投第１４案,新北市,淡水區,北投里,95,2019,392,642,1034,37,1071
公投第１４案,新北市,淡水區,北投里,96,1696,330,610,940,41,981
公投第１４案,新北市,淡水區,北投里,97,1576,572,285,857,21,878
公投第１４案,新北市,淡水區,鄧公里,98,1781,343,615,958,36,994
公投第１４案,新北市,淡水區,鄧公里,99,1665,339,567,906,60,966
公投第１４案,新北市,淡水區,鄧公里,100,2013,362,668,1030,47,1077
公投第１４案,新北市,淡水區,幸福里,101,1108,203,353,556,38,594
公投第１４案,新北市,淡水區,幸福里,102,1305,237,440,677,41,718
公投第１４案,新北市,淡水區,幸福里,103,1199,221,416,637,15,652
公投第１４案,新北市,淡水區,學府里,104,2017,672,359,1031,38,1069
公投第１４案,新北市,淡水區,學府里,105,2125,371,627,998,44,1042
公投第１４案,新北市,淡水區,中興里,106,1289,192,386,578,23,601
公投第１４案,新北市,淡水區,中興里,107,1319,263,488,751,34,785
公投第１４案,新北市,淡水區,中興里,108,1051,198,383,581,22,603
公投第１４案,新北市,淡水區,長庚里,109,1348,231,472,703,35,738
公投第１４案,新北市,淡水區,清文里,110,1106,188,373,561,30,591
公投第１４案,新北市,淡水區,草東里,111,717,129,263,392,28,420
公投第１４案,新北市,淡水區,協元里,112,1385,247,453,700,34,734
公投第１４案,新北市,淡水區,永吉里,113,841,296,164,460,42,502
公投第１４案,新北市,淡水區,民安里,114,665,132,230,362,25,387
公投第１４案,新北市,淡水區,新生里,115,419,80,159,239,12,251
公投第１４案,新北市,淡水區,文化里,116,1599,282,596,878,25,903
公投第１４案,新北市,淡水區,油車里,117,1670,291,541,832,51,883
公投第１４案,新北市,淡水區,油車里,118,1683,321,592,913,50,963
公投第１４案,新北市,淡水區,油車里,119,1577,246,514,760,45,805
公投第１４案,新北市,淡水區,沙崙里,120,1618,244,517,761,52,813
公投第１４案,新北市,淡水區,沙崙里,121,2214,344,671,1015,19,1034
公投第１４案,新北市,淡水區,大庄里,122,1832,328,585,913,46,959
公投第１４案,新北市,淡水區,大庄里,123,2123,363,716,1079,48,1127
公投第１４案,新北市,淡水區,大庄里,124,2998,383,900,1283,25,1308
公投第１４案,新北市,八里區,龍源里,125,1498,243,454,697,46,743
公投第１４案,新北市,八里區,龍源里,126,1939,330,535,865,34,899
公投第１４案,新北市,八里區,龍源里,127,1516,237,521,758,55,813
公投第１４案,新北市,八里區,龍源里,128,1642,304,579,883,55,938
公投第１４案,新北市,八里區,米倉里,129,1927,326,549,875,67,942
公投第１４案,新北市,八里區,米倉里,130,1276,222,435,657,36,693
公投第１４案,新北市,八里區,大崁里,131,1349,263,487,750,39,789
公投第１４案,新北市,八里區,大崁里,132,1403,248,492,740,46,786
公投第１４案,新北市,八里區,埤頭里,133,1644,270,575,845,44,889
公投第１４案,新北市,八里區,埤頭里,134,1853,299,635,934,61,995
公投第１４案,新北市,八里區,頂罟里,135,1793,314,668,982,64,1046
公投第１４案,新北市,八里區,舊城里,136,1644,277,569,846,37,883
公投第１４案,新北市,八里區,舊城里,137,1846,307,620,927,36,963
公投第１４案,新北市,八里區,舊城里,138,1346,231,441,672,47,719
公投第１４案,新北市,八里區,舊城里,139,1621,298,527,825,50,875
公投第１４案,新北市,八里區,訊塘里,140,2110,250,621,871,69,940
公投第１４案,新北市,八里區,訊塘里,141,1967,326,622,948,59,1007
公投第１４案,新北市,八里區,荖阡里,142,1626,287,553,840,53,893
公投第１４案,新北市,八里區,長坑里,143,1514,250,518,768,65,833
公投第１４案,新北市,八里區,下罟里,144,1456,336,418,754,84,838
公投第１４案,新北市,林口區,東林里,145,1268,195,445,640,43,683
公投第１４案,新北市,林口區,東林里,146,1171,209,363,572,35,607
公投第１４案,新北市,林口區,東林里,147,1218,223,425,648,52,700
公投第１４案,新北市,林口區,林口里,148,1788,323,556,879,41,920
公投第１４案,新北市,林口區,林口里,149,1625,279,485,764,56,820
公投第１４案,新北市,林口區,林口里,150,1448,256,448,704,55,759
公投第１４案,新北市,林口區,西林里,151,1328,198,422,620,65,685
公投第１４案,新北市,林口區,西林里,152,1523,224,431,655,51,706
公投第１４案,新北市,林口區,西林里,153,1245,218,429,647,36,683
公投第１４案,新北市,林口區,西林里,154,1329,261,536,797,29,826
公投第１４案,新北市,林口區,西林里,155,1465,303,514,817,39,856
公投第１４案,新北市,林口區,西林里,156,1369,289,499,788,24,812
公投第１４案,新北市,林口區,菁湖里,157,1346,264,491,755,35,790
公投第１４案,新北市,林口區,菁湖里,158,1181,203,389,592,57,649
公投第１４案,新北市,林口區,菁湖里,159,1291,261,514,775,26,801
公投第１４案,新北市,林口區,中湖里,160,1213,209,420,629,44,673
公投第１４案,新北市,林口區,中湖里,161,1256,231,473,704,30,734
公投第１４案,新北市,林口區,中湖里,162,1185,200,409,609,38,647
公投第１４案,新北市,林口區,湖北里,163,1361,218,493,711,47,758
公投第１４案,新北市,林口區,湖南里,164,1756,290,590,880,21,901
公投第１４案,新北市,林口區,湖南里,165,1676,274,570,844,23,867
公投第１４案,新北市,林口區,湖南里,166,1540,290,562,852,17,869
公投第１４案,新北市,林口區,湖南里,167,1569,290,530,820,30,850
公投第１４案,新北市,林口區,湖南里,168,1514,303,510,813,24,837
公投第１４案,新北市,林口區,湖南里,169,1193,268,405,673,20,693
公投第１４案,新北市,林口區,湖南里,170,1610,308,581,889,23,912
公投第１４案,新北市,林口區,湖南里,171,1338,287,456,743,34,777
公投第１４案,新北市,林口區,湖南里,172,1141,201,416,617,31,648
公投第１４案,新北市,林口區,湖南里,173,1307,271,443,714,27,741
公投第１４案,新北市,林口區,湖南里,174,1327,256,475,731,32,763
公投第１４案,新北市,林口區,湖南里,175,1285,273,445,718,28,746
公投第１４案,新北市,林口區,南勢里,176,1481,275,529,804,34,838
公投第１４案,新北市,林口區,南勢里,177,1510,334,516,850,16,866
公投第１４案,新北市,林口區,南勢里,178,1785,339,574,913,41,954
公投第１４案,新北市,林口區,南勢里,179,1792,342,603,945,25,970
公投第１４案,新北市,林口區,南勢里,180,1517,315,526,841,17,858
公投第１４案,新北市,林口區,南勢里,181,1564,311,557,868,29,897
公投第１４案,新北市,林口區,南勢里,182,1560,290,582,872,22,894
公投第１４案,新北市,林口區,南勢里,183,1544,326,483,809,30,839
公投第１４案,新北市,林口區,南勢里,184,1593,308,528,836,26,862
公投第１４案,新北市,林口區,南勢里,185,1431,300,478,778,25,803
公投第１４案,新北市,林口區,仁愛里,186,1571,320,492,812,28,840
公投第１４案,新北市,林口區,仁愛里,187,1439,314,486,800,30,830
公投第１４案,新北市,林口區,仁愛里,188,1451,305,506,811,33,844
公投第１４案,新北市,林口區,仁愛里,189,1391,315,491,806,35,841
公投第１４案,新北市,林口區,麗林里,190,1461,273,502,775,38,813
公投第１４案,新北市,林口區,麗林里,191,1691,338,560,898,18,916
公投第１４案,新北市,林口區,麗林里,192,1524,297,503,800,46,846
公投第１４案,新北市,林口區,麗林里,193,1343,271,532,803,36,839
公投第１４案,新北市,林口區,麗林里,194,1398,303,514,817,23,840
公投第１４案,新北市,林口區,東勢里,195,1380,270,525,795,25,820
公投第１４案,新北市,林口區,東勢里,196,1367,242,481,723,45,768
公投第１４案,新北市,林口區,東勢里,197,1350,256,482,738,41,779
公投第１４案,新北市,林口區,東勢里,198,1194,238,421,659,44,703
公投第１４案,新北市,林口區,麗園里,199,1344,226,460,686,51,737
公投第１４案,新北市,林口區,麗園里,200,1154,214,408,622,31,653
公投第１４案,新北市,林口區,麗園里,201,1119,241,429,670,27,697
公投第１４案,新北市,林口區,頂福里,202,1026,142,317,459,45,504
公投第１４案,新北市,林口區,下福里,203,1210,214,405,619,58,677
公投第１４案,新北市,林口區,嘉寶里,204,912,159,290,449,68,517
公投第１４案,新北市,林口區,瑞平里,205,824,173,277,450,34,484
公投第１４案,新北市,林口區,太平里,206,1411,261,496,757,74,831
公投第１４案,新北市,五股區,興珍里,207,1456,269,459,728,74,802
公投第１４案,新北市,五股區,興珍里,208,1482,258,484,742,44,786
公投第１４案,新北市,五股區,興珍里,209,1287,249,439,688,37,725
公投第１４案,新北市,五股區,更寮里,210,1106,210,332,542,33,575
公投第１４案,新北市,五股區,觀音里,211,1283,202,417,619,63,682
公投第１４案,新北市,五股區,集福里,212,1833,319,595,914,46,960
公投第１４案,新北市,五股區,集福里,213,1141,229,389,618,38,656
公投第１４案,新北市,五股區,集福里,214,463,73,173,246,38,284
公投第１４案,新北市,五股區,集賢里,215,1786,291,632,923,50,973
公投第１４案,新北市,五股區,集賢里,216,1660,304,520,824,41,865
公投第１４案,新北市,五股區,成德里,217,1534,294,479,773,70,843
公投第１４案,新北市,五股區,成德里,218,1285,224,454,678,57,735
公投第１４案,新北市,五股區,成州里,219,1832,314,569,883,83,966
公投第１４案,新北市,五股區,成州里,220,1542,280,513,793,28,821
公投第１４案,新北市,五股區,成州里,221,1897,287,564,851,45,896
公投第１４案,新北市,五股區,成功里,222,1964,308,565,873,89,962
公投第１４案,新北市,五股區,成功里,223,1779,284,545,829,56,885
公投第１４案,新北市,五股區,成功里,224,1735,288,549,837,64,901
公投第１４案,新北市,五股區,成泰里,225,2299,420,683,1103,31,1134
公投第１４案,新北市,五股區,成泰里,226,1755,256,547,803,52,855
公投第１４案,新北市,五股區,成泰里,227,1674,281,589,870,56,926
公投第１４案,新北市,五股區,成泰里,228,1661,263,584,847,71,918
公投第１４案,新北市,五股區,五龍里,229,1281,238,349,587,33,620
公投第１４案,新北市,五股區,五福里,230,1566,245,549,794,54,848
公投第１４案,新北市,五股區,五福里,231,1560,219,509,728,33,761
公投第１４案,新北市,五股區,六福里,232,1622,284,559,843,33,876
公投第１４案,新北市,五股區,六福里,233,1779,306,616,922,38,960
公投第１４案,新北市,五股區,民義里,234,1487,241,475,716,61,777
公投第１４案,新北市,五股區,民義里,235,1567,295,513,808,50,858
公投第１４案,新北市,五股區,五股里,236,1333,198,300,498,34,532
公投第１４案,新北市,五股區,五股里,237,1263,285,427,712,48,760
公投第１４案,新北市,五股區,五股里,238,1314,382,458,840,61,901
公投第１４案,新北市,五股區,德音里,239,1513,269,486,755,32,787
公投第１４案,新北市,五股區,德音里,240,1517,259,569,828,32,860
公投第１４案,新北市,五股區,德音里,241,1613,285,523,808,65,873
公投第１４案,新北市,五股區,水碓里,242,1616,254,564,818,56,874
公投第１４案,新北市,五股區,水碓里,243,1616,304,515,819,48,867
公投第１４案,新北市,五股區,水碓里,244,1689,292,575,867,52,919
公投第１４案,新北市,五股區,水碓里,245,1894,371,581,952,28,980
公投第１４案,新北市,五股區,福德里,246,1210,237,473,710,53,763
公投第１４案,新北市,五股區,福德里,247,1643,271,540,811,32,843
公投第１４案,新北市,五股區,德泰里,248,1441,247,488,735,27,762
公投第１４案,新北市,五股區,德泰里,249,1305,234,489,723,32,755
公投第１４案,新北市,五股區,德泰里,250,1170,222,455,677,42,719
公投第１４案,新北市,五股區,貿商里,251,1397,209,585,794,59,853
公投第１４案,新北市,五股區,貿商里,252,1312,212,555,767,43,810
公投第１４案,新北市,五股區,陸一里,253,1127,146,403,549,22,571
公投第１４案,新北市,五股區,陸一里,254,1154,155,414,569,33,602
公投第１４案,新北市,泰山區,大科里,255,643,97,208,305,21,326
公投第１４案,新北市,泰山區,大科里,256,186,43,68,111,5,116
公投第１４案,新北市,泰山區,黎明里,257,1457,223,494,717,30,747
公投第１４案,新北市,泰山區,黎明里,258,1594,277,558,835,56,891
公投第１４案,新北市,泰山區,山腳里,259,1598,218,547,765,41,806
公投第１４案,新北市,泰山區,山腳里,260,1503,273,468,741,26,767
公投第１４案,新北市,泰山區,山腳里,261,1436,231,455,686,63,749
公投第１４案,新北市,泰山區,山腳里,262,1384,232,498,730,39,769
公投第１４案,新北市,泰山區,福泰里,263,1231,209,455,664,38,702
公投第１４案,新北市,泰山區,福泰里,264,1295,213,438,651,33,684
公投第１４案,新北市,泰山區,福興里,265,1563,314,538,852,48,900
公投第１４案,新北市,泰山區,福興里,266,1610,282,599,881,54,935
公投第１４案,新北市,泰山區,楓樹里,267,1253,231,416,647,29,676
公投第１４案,新北市,泰山區,楓樹里,268,1294,184,452,636,30,666
公投第１４案,新北市,泰山區,楓樹里,269,1354,266,474,740,50,790
公投第１４案,新北市,泰山區,同榮里,270,1259,223,442,665,25,690
公投第１４案,新北市,泰山區,同榮里,271,1252,254,439,693,26,719
公投第１４案,新北市,泰山區,同榮里,272,1094,185,372,557,32,589
公投第１４案,新北市,泰山區,同興里,273,1590,295,560,855,37,892
公投第１４案,新北市,泰山區,同興里,274,1634,274,572,846,67,913
公投第１４案,新北市,泰山區,全興里,275,1536,246,448,694,35,729
公投第１４案,新北市,泰山區,全興里,276,1534,308,550,858,30,888
公投第１４案,新北市,泰山區,全興里,277,1545,257,653,910,40,950
公投第１４案,新北市,泰山區,全興里,278,1399,246,501,747,37,784
公投第１４案,新北市,泰山區,全興里,279,1315,238,452,690,20,710
公投第１４案,新北市,泰山區,義學里,280,1201,274,418,692,42,734
公投第１４案,新北市,泰山區,義學里,281,1182,232,386,618,45,663
公投第１４案,新北市,泰山區,義學里,282,1665,284,540,824,57,881
公投第１４案,新北市,泰山區,義仁里,283,1855,305,653,958,52,1010
公投第１４案,新北市,泰山區,義仁里,284,1866,329,620,949,81,1030
公投第１４案,新北市,泰山區,義仁里,285,1935,364,619,983,52,1035
公投第１４案,新北市,泰山區,義仁里,286,1589,283,502,785,34,819
公投第１４案,新北市,泰山區,明志里,287,1152,196,389,585,31,616
公投第１４案,新北市,泰山區,明志里,288,1114,234,367,601,23,624
公投第１４案,新北市,泰山區,明志里,289,1040,200,415,615,34,649
公投第１４案,新北市,泰山區,泰友里,290,1003,208,359,567,38,605
公投第１４案,新北市,泰山區,泰友里,291,975,222,356,578,21,599
公投第１４案,新北市,泰山區,新明里,292,1440,239,503,742,44,786
公投第１４案,新北市,泰山區,新明里,293,1480,260,488,748,37,785
公投第１４案,新北市,泰山區,貴子里,294,1211,227,432,659,29,688
公投第１４案,新北市,泰山區,貴子里,295,1237,233,457,690,23,713
公投第１４案,新北市,泰山區,貴子里,296,1069,184,381,565,25,590
公投第１４案,新北市,泰山區,貴賢里,297,1680,317,622,939,50,989
公投第１４案,新北市,泰山區,貴賢里,298,1651,307,602,909,30,939
公投第１４案,新北市,泰山區,貴和里,299,1420,232,481,713,34,747
公投第１４案,新北市,泰山區,貴和里,300,1337,259,473,732,51,783
公投第１４案,新北市,泰山區,貴和里,301,1591,275,594,869,44,913
公投第１４案,新北市,新莊區,海山里,302,1123,216,392,608,55,663
公投第１４案,新北市,新莊區,海山里,303,1278,243,468,711,55,766
公投第１４案,新北市,新莊區,海山里,304,1163,251,438,689,48,737
公投第１４案,新北市,新莊區,海山里,305,1228,240,469,709,48,757
公投第１４案,新北市,新莊區,全安里,306,1211,239,417,656,55,711
公投第１４案,新北市,新莊區,全安里,307,1176,230,421,651,52,703
公投第１４案,新北市,新莊區,全安里,308,1536,318,577,895,48,943
公投第１４案,新北市,新莊區,全泰里,309,1486,305,587,892,41,933
公投第１４案,新北市,新莊區,全泰里,310,1513,310,588,898,65,963
公投第１４案,新北市,新莊區,全泰里,311,1395,284,542,826,63,889
公投第１４案,新北市,新莊區,忠孝里,312,1353,236,481,717,53,770
公投第１４案,新北市,新莊區,忠孝里,313,1409,284,527,811,63,874
公投第１４案,新北市,新莊區,忠孝里,314,1478,248,548,796,29,825
公投第１４案,新北市,新莊區,文衡里,315,921,194,340,534,45,579
公投第１４案,新北市,新莊區,文衡里,316,971,198,387,585,39,624
公投第１４案,新北市,新莊區,文聖里,317,1534,298,603,901,65,966
公投第１４案,新北市,新莊區,文聖里,318,1516,259,546,805,39,844
公投第１４案,新北市,新莊區,興漢里,319,697,145,243,388,23,411
公投第１４案,新北市,新莊區,興漢里,320,1235,243,450,693,29,722
公投第１４案,新北市,新莊區,興漢里,321,1138,211,413,624,37,661
公投第１４案,新北市,新莊區,榮和里,322,1063,189,360,549,21,570
公投第１４案,新北市,新莊區,榮和里,323,3399,292,518,810,36,846
公投第１４案,新北市,新莊區,文德里,324,1575,296,570,866,68,934
公投第１４案,新北市,新莊區,文明里,325,1615,377,581,958,55,1013
公投第１４案,新北市,新莊區,化成里,326,1612,269,523,792,61,853
公投第１４案,新北市,新莊區,化成里,327,1514,271,519,790,50,840
公投第１４案,新北市,新莊區,頭前里,328,1382,270,401,671,32,703
公投第１４案,新北市,新莊區,頭前里,329,1475,348,438,786,45,831
公投第１４案,新北市,新莊區,頭前里,330,1462,306,506,812,35,847
公投第１４案,新北市,新莊區,頭前里,331,1426,291,462,753,34,787
公投第１４案,新北市,新莊區,頭前里,332,1421,262,475,737,54,791
公投第１４案,新北市,新莊區,福基里,333,1536,294,536,830,30,860
公投第１４案,新北市,新莊區,福基里,334,1587,343,531,874,48,922
公投第１４案,新北市,新莊區,福基里,335,749,135,252,387,16,403
公投第１４案,新北市,新莊區,福興里,336,1276,233,492,725,43,768
公投第１４案,新北市,新莊區,福興里,337,1303,267,427,694,34,728
公投第１４案,新北市,新莊區,福興里,338,1259,241,477,718,55,773
公投第１４案,新北市,新莊區,福興里,339,1291,267,477,744,37,781
公投第１４案,新北市,新莊區,昌平里,340,1493,315,515,830,12,842
公投第１４案,新北市,新莊區,昌平里,341,1507,280,550,830,48,878
公投第１４案,新北市,新莊區,昌平里,342,1456,296,502,798,20,818
公投第１４案,新北市,新莊區,昌平里,343,1396,283,516,799,20,819
公投第１４案,新北市,新莊區,和平里,344,1351,238,414,652,53,705
公投第１４案,新北市,新莊區,和平里,345,1403,296,439,735,64,799
公投第１４案,新北市,新莊區,和平里,346,1497,277,502,779,57,836
公投第１４案,新北市,新莊區,幸福里,347,1272,267,443,710,66,776
公投第１４案,新北市,新莊區,幸福里,348,1269,218,372,590,31,621
公投第１４案,新北市,新莊區,幸福里,349,1335,276,450,726,66,792
公投第１４案,新北市,新莊區,昌隆里,350,1300,294,460,754,38,792
公投第１４案,新北市,新莊區,昌隆里,351,1286,263,457,720,53,773
公投第１４案,新北市,新莊區,昌隆里,352,1255,276,501,777,46,823
公投第１４案,新北市,新莊區,信義里,353,1558,277,554,831,68,899
公投第１４案,新北市,新莊區,信義里,354,1567,286,500,786,71,857
公投第１４案,新北市,新莊區,信義里,355,1603,289,609,898,55,953
公投第１４案,新北市,新莊區,昌信里,356,1538,321,517,838,31,869
公投第１４案,新北市,新莊區,昌信里,357,1671,345,582,927,40,967
公投第１４案,新北市,新莊區,昌明里,358,1698,296,568,864,34,898
公投第１４案,新北市,新莊區,昌明里,359,1545,353,548,901,45,946
公投第１４案,新北市,新莊區,仁義里,360,1696,322,621,943,93,1036
公投第１４案,新北市,新莊區,仁義里,361,1626,246,566,812,81,893
公投第１４案,新北市,新莊區,仁愛里,362,1170,187,389,576,60,636
公投第１４案,新北市,新莊區,仁愛里,363,1236,229,417,646,76,722
公投第１４案,新北市,新莊區,自信里,364,1071,168,376,544,55,599
公投第１４案,新北市,新莊區,自信里,365,1129,210,403,613,35,648
公投第１４案,新北市,新莊區,自立里,366,1586,325,597,922,34,956
公投第１４案,新北市,新莊區,自立里,367,1597,256,507,763,62,825
公投第１４案,新北市,新莊區,自立里,368,1573,239,490,729,91,820
公投第１４案,新北市,新莊區,自強里,369,1225,219,437,656,43,699
公投第１４案,新北市,新莊區,自強里,370,1217,185,419,604,32,636
公投第１４案,新北市,新莊區,思源里,371,1571,283,505,788,59,847
公投第１４案,新北市,新莊區,思源里,372,1594,283,521,804,58,862
公投第１４案,新北市,新莊區,思源里,373,1583,286,527,813,57,870
公投第１４案,新北市,新莊區,思賢里,374,1245,208,502,710,60,770
公投第１４案,新北市,新莊區,思賢里,375,1203,437,339,776,38,814
公投第１４案,新北市,新莊區,思賢里,376,1265,276,480,756,41,797
公投第１４案,新北市,新莊區,中華里,377,1255,227,466,693,65,758
公投第１４案,新北市,新莊區,中華里,378,1287,257,464,721,36,757
公投第１４案,新北市,新莊區,中美里,379,1167,235,439,674,58,732
公投第１４案,新北市,新莊區,中美里,380,1299,223,447,670,50,720
公投第１４案,新北市,新莊區,中美里,381,1207,251,406,657,40,697
公投第１４案,新北市,新莊區,中美里,382,1415,274,513,787,45,832
公投第１４案,新北市,新莊區,恆安里,383,1342,262,437,699,61,760
公投第１４案,新北市,新莊區,恆安里,384,1341,268,442,710,59,769
公投第１４案,新北市,新莊區,恆安里,385,1247,254,405,659,58,717
公投第１４案,新北市,新莊區,立人里,386,984,182,471,653,21,674
公投第１４案,新北市,新莊區,立人里,387,1043,198,354,552,38,590
公投第１４案,新北市,新莊區,立德里,388,1135,256,460,716,38,754
公投第１４案,新北市,新莊區,立德里,389,1185,252,417,669,33,702
公投第１４案,新北市,新莊區,中和里,390,1346,290,462,752,33,785
公投第１４案,新北市,新莊區,中和里,391,1372,261,500,761,57,818
公投第１４案,新北市,新莊區,中和里,392,1350,257,520,777,54,831
公投第１４案,新北市,新莊區,中泰里,393,1307,252,427,679,49,728
公投第１４案,新北市,新莊區,中泰里,394,1353,244,476,720,64,784
公投第１４案,新北市,新莊區,中泰里,395,1287,234,478,712,53,765
公投第１４案,新北市,新莊區,中宏里,396,1567,256,454,710,32,742
公投第１４案,新北市,新莊區,中宏里,397,1709,351,614,965,56,1021
公投第１４案,新北市,新莊區,中全里,398,1616,284,521,805,39,844
公投第１４案,新北市,新莊區,中全里,399,1628,308,481,789,55,844
公投第１４案,新北市,新莊區,立志里,400,1148,225,425,650,58,708
公投第１４案,新北市,新莊區,立志里,401,1201,226,439,665,7,672
公投第１４案,新北市,新莊區,立志里,402,1135,246,448,694,39,733
公投第１４案,新北市,新莊區,立廷里,403,1495,315,552,867,86,953
公投第１４案,新北市,新莊區,立廷里,404,1486,295,553,848,61,909
公投第１４案,新北市,新莊區,立廷里,405,1483,336,555,891,38,929
公投第１４案,新北市,新莊區,立廷里,406,1553,276,532,808,29,837
公投第１４案,新北市,新莊區,立廷里,407,1625,365,618,983,23,1006
公投第１４案,新北市,新莊區,立廷里,408,1671,343,579,922,32,954
公投第１４案,新北市,新莊區,立基里,409,1389,281,531,812,58,870
公投第１４案,新北市,新莊區,立基里,410,1272,243,448,691,49,740
公投第１４案,新北市,新莊區,立基里,411,1409,311,526,837,34,871
公投第１４案,新北市,新莊區,立基里,412,1372,302,506,808,35,843
公投第１４案,新北市,新莊區,中誠里,413,955,177,342,519,34,553
公投第１４案,新北市,新莊區,中誠里,414,952,147,350,497,44,541
公投第１４案,新北市,新莊區,中港里,415,1412,287,488,775,31,806
公投第１４案,新北市,新莊區,中港里,416,1415,243,527,770,54,824
公投第１４案,新北市,新莊區,中港里,417,1421,279,518,797,62,859
公投第１４案,新北市,新莊區,中港里,418,1293,287,480,767,42,809
公投第１４案,新北市,新莊區,中信里,419,1475,283,492,775,23,798
公投第１４案,新北市,新莊區,中信里,420,1429,251,512,763,61,824
公投第１４案,新北市,新莊區,中信里,421,1481,275,528,803,43,846
公投第１４案,新北市,新莊區,中信里,422,1472,266,559,825,64,889
公投第１４案,新北市,新莊區,中信里,423,1474,309,535,844,27,871
公投第１４案,新北市,新莊區,中平里,424,1462,321,527,848,21,869
公投第１４案,新北市,新莊區,中平里,425,1484,533,328,861,18,879
公投第１４案,新北市,新莊區,中平里,426,1461,280,533,813,30,843
公投第１４案,新北市,新莊區,中平里,427,1444,315,507,822,28,850
公投第１４案,新北市,新莊區,中平里,428,1437,290,532,822,34,856
公投第１４案,新北市,新莊區,中原里,429,1641,301,500,801,35,836
公投第１４案,新北市,新莊區,中原里,430,1633,318,504,822,46,868
公投第１４案,新北市,新莊區,中原里,431,1531,292,556,848,25,873
公投第１４案,新北市,新莊區,中原里,432,1517,306,553,859,46,905
公投第１４案,新北市,新莊區,中原里,433,1487,253,503,756,51,807
公投第１４案,新北市,新莊區,中原里,434,1560,305,549,854,35,889
公投第１４案,新北市,新莊區,中隆里,435,1584,301,0,301,46,347
公投第１４案,新北市,新莊區,中隆里,436,1602,292,545,837,32,869
公投第１４案,新北市,新莊區,中隆里,437,818,152,287,439,42,481
公投第１４案,新北市,新莊區,立功里,438,1633,254,496,750,54,804
公投第１４案,新北市,新莊區,立功里,439,1652,275,567,842,51,893
公投第１４案,新北市,新莊區,立泰里,440,1498,271,514,785,45,830
公投第１４案,新北市,新莊區,立泰里,441,1379,256,473,729,50,779
公投第１４案,新北市,新莊區,立泰里,442,1381,251,529,780,34,814
公投第１４案,新北市,新莊區,立言里,443,1535,278,555,833,72,905
公投第１４案,新北市,新莊區,立言里,444,1492,282,622,904,46,950
公投第１４案,新北市,新莊區,立言里,445,1450,314,543,857,62,919
公投第１４案,新北市,新莊區,豐年里,446,1107,227,386,613,46,659
公投第１４案,新北市,新莊區,豐年里,447,1063,220,401,621,25,646
公投第１４案,新北市,新莊區,豐年里,448,1143,222,419,641,47,688
公投第１４案,新北市,新莊區,國泰里,449,1341,244,429,673,79,752
公投第１４案,新北市,新莊區,泰豐里,450,1063,208,373,581,38,619
公投第１４案,新北市,新莊區,泰豐里,451,1096,224,406,630,35,665
公投第１４案,新北市,新莊區,瓊林里,452,1309,237,486,723,27,750
公投第１４案,新北市,新莊區,瓊林里,453,1216,248,447,695,46,741
公投第１４案,新北市,新莊區,瓊林里,454,1278,201,438,639,50,689
公投第１４案,新北市,新莊區,瓊林里,455,1352,256,457,713,63,776
公投第１４案,新北市,新莊區,福營里,456,1298,238,391,629,49,678
公投第１４案,新北市,新莊區,福營里,457,1042,187,377,564,47,611
公投第１４案,新北市,新莊區,營盤里,458,881,159,283,442,26,468
公投第１４案,新北市,新莊區,營盤里,459,1109,222,445,667,52,719
公投第１４案,新北市,新莊區,丹鳳里,460,1291,238,440,678,41,719
公投第１４案,新北市,新莊區,丹鳳里,461,1293,259,426,685,20,705
公投第１４案,新北市,新莊區,丹鳳里,462,1336,267,475,742,46,788
公投第１４案,新北市,新莊區,丹鳳里,463,1384,232,473,705,40,745
公投第１４案,新北市,新莊區,丹鳳里,464,1231,197,402,599,29,628
公投第１４案,新北市,新莊區,丹鳳里,465,940,272,333,605,26,631
公投第１４案,新北市,新莊區,合鳳里,466,1369,237,450,687,78,765
公投第１４案,新北市,新莊區,合鳳里,467,1384,212,490,702,75,777
公投第１４案,新北市,新莊區,合鳳里,468,1272,238,449,687,58,745
公投第１４案,新北市,新莊區,祥鳳里,469,1073,195,409,604,36,640
公投第１４案,新北市,新莊區,祥鳳里,470,1058,358,226,584,40,624
公投第１４案,新北市,新莊區,雙鳳里,471,1528,314,506,820,20,840
公投第１４案,新北市,新莊區,雙鳳里,472,1244,183,454,637,41,678
公投第１４案,新北市,新莊區,雙鳳里,473,1356,202,488,690,37,727
公投第１４案,新北市,新莊區,雙鳳里,474,1164,169,420,589,19,608
公投第１４案,新北市,新莊區,雙鳳里,475,1423,257,535,792,48,840
公投第１４案,新北市,新莊區,雙鳳里,476,1250,278,468,746,31,777
公投第１４案,新北市,新莊區,雙鳳里,477,1252,240,417,657,24,681
公投第１４案,新北市,新莊區,龍福里,478,1022,179,360,539,21,560
公投第１４案,新北市,新莊區,龍福里,479,959,182,349,531,37,568
公投第１４案,新北市,新莊區,龍鳳里,480,1646,351,550,901,56,957
公投第１４案,新北市,新莊區,龍鳳里,481,1551,328,491,819,53,872
公投第１４案,新北市,新莊區,龍鳳里,482,1526,317,567,884,35,919
公投第１４案,新北市,新莊區,龍鳳里,483,1518,322,517,839,27,866
公投第１４案,新北市,新莊區,龍鳳里,484,1547,338,532,870,36,906
公投第１４案,新北市,新莊區,裕民里,485,1505,245,510,755,70,825
公投第１４案,新北市,新莊區,裕民里,486,1527,251,508,759,65,824
公投第１４案,新北市,新莊區,裕民里,487,1482,245,493,738,42,780
公投第１４案,新北市,新莊區,裕民里,488,1586,266,498,764,65,829
公投第１４案,新北市,新莊區,龍安里,489,1065,174,383,557,66,623
公投第１４案,新北市,新莊區,龍安里,490,1040,207,421,628,47,675
公投第１４案,新北市,新莊區,富國里,491,1090,206,361,567,43,610
公投第１４案,新北市,新莊區,富國里,492,1071,193,383,576,43,619
公投第１４案,新北市,新莊區,富民里,493,1704,309,529,838,40,878
公投第１４案,新北市,新莊區,富民里,494,1698,293,530,823,29,852
公投第１４案,新北市,新莊區,後德里,495,1362,292,520,812,41,853
公投第１４案,新北市,新莊區,後德里,496,1350,296,488,784,30,814
公投第１４案,新北市,新莊區,萬安里,497,1689,313,593,906,63,969
公投第１４案,新北市,新莊區,萬安里,498,1612,287,577,864,72,936
公投第１４案,新北市,新莊區,建福里,499,1130,208,434,642,44,686
公投第１４案,新北市,新莊區,建福里,500,1111,226,426,652,48,700
公投第１４案,新北市,新莊區,後港里,501,1539,273,518,791,47,838
公投第１４案,新北市,新莊區,後港里,502,1586,312,551,863,37,900
公投第１４案,新北市,新莊區,後港里,503,1631,318,565,883,50,933
公投第１４案,新北市,新莊區,後港里,504,1540,313,516,829,38,867
公投第１４案,新北市,新莊區,四維里,505,1388,240,426,666,45,711
公投第１４案,新北市,新莊區,四維里,506,1388,508,127,635,77,712
公投第１４案,新北市,新莊區,四維里,507,1387,229,423,652,46,698
公投第１４案,新北市,新莊區,南港里,508,1181,217,377,594,43,637
公投第１４案,新北市,新莊區,南港里,509,1135,201,403,604,54,658
公投第１４案,新北市,新莊區,南港里,510,1173,237,413,650,36,686
公投第１４案,新北市,新莊區,南港里,511,1215,282,380,662,40,702
公投第１４案,新北市,新莊區,建安里,512,1488,312,499,811,55,866
公投第１４案,新北市,新莊區,建安里,513,1444,295,488,783,39,822
公投第１４案,新北市,新莊區,建安里,514,1499,273,527,800,29,829
公投第１４案,新北市,新莊區,建安里,515,1449,280,496,776,27,803
公投第１４案,新北市,新莊區,民全里,516,1640,312,559,871,55,926
公投第１４案,新北市,新莊區,民全里,517,1648,313,538,851,54,905
公投第１４案,新北市,新莊區,八德里,518,1371,243,425,668,54,722
公投第１４案,新北市,新莊區,八德里,519,1400,269,451,720,50,770
公投第１４案,新北市,新莊區,成德里,520,1457,246,512,758,64,822
公投第１４案,新北市,新莊區,成德里,521,1502,274,496,770,58,828
公投第１４案,新北市,新莊區,成德里,522,1412,264,457,721,63,784
公投第１４案,新北市,新莊區,民安里,523,1318,225,467,692,46,738
公投第１４案,新北市,新莊區,民安里,524,1411,282,508,790,40,830
公投第１４案,新北市,新莊區,民安里,525,1262,259,446,705,30,735
公投第１４案,新北市,新莊區,民安里,526,1228,253,473,726,22,748
公投第１４案,新北市,新莊區,民有里,527,1748,422,542,964,62,1026
公投第１４案,新北市,新莊區,民有里,528,1761,332,621,953,74,1027
公投第１４案,新北市,新莊區,民本里,529,1326,219,442,661,47,708
公投第１４案,新北市,新莊區,民本里,530,1344,201,436,637,46,683
公投第１４案,新北市,新莊區,光明里,531,1355,233,498,731,38,769
公投第１４案,新北市,新莊區,光明里,532,1306,218,471,689,68,757
公投第１４案,新北市,新莊區,光明里,533,1349,286,471,757,40,797
公投第１４案,新北市,新莊區,光正里,534,1265,248,447,695,31,726
公投第１４案,新北市,新莊區,光正里,535,1282,244,492,736,43,779
公投第１４案,新北市,新莊區,光正里,536,1237,217,488,705,41,746
公投第１４案,新北市,新莊區,光榮里,537,1301,230,497,727,20,747
公投第１４案,新北市,新莊區,光榮里,538,1262,234,449,683,43,726
公投第１４案,新北市,新莊區,光榮里,539,1270,224,464,688,35,723
公投第１４案,新北市,新莊區,光和里,540,1245,253,421,674,58,732
公投第１４案,新北市,新莊區,光和里,541,1220,207,418,625,59,684
公投第１４案,新北市,新莊區,光華里,542,1245,204,419,623,44,667
公投第１４案,新北市,新莊區,光華里,543,1212,216,396,612,47,659
公投第１４案,新北市,新莊區,光華里,544,1253,214,420,634,47,681
公投第１４案,新北市,新莊區,光華里,545,1272,211,421,632,45,677
公投第１４案,新北市,新莊區,光華里,546,1227,254,448,702,30,732
公投第１４案,新北市,新莊區,西盛里,547,1126,213,434,647,30,677
公投第１４案,新北市,新莊區,西盛里,548,1240,243,447,690,34,724
公投第１４案,新北市,新莊區,西盛里,549,1460,276,498,774,38,812
公投第１４案,新北市,新莊區,西盛里,550,1072,201,373,574,26,600
公投第１４案,新北市,新莊區,西盛里,551,1127,210,352,562,31,593
公投第１４案,新北市,新莊區,西盛里,552,1332,253,501,754,26,780
公投第１４案,新北市,新莊區,西盛里,553,1341,290,395,685,21,706
公投第１４案,新北市,新莊區,西盛里,554,1140,160,337,497,19,516
公投第１４案,新北市,蘆洲區,光華里,555,1600,323,526,849,74,923
公投第１４案,新北市,蘆洲區,光華里,556,1549,279,526,805,56,861
公投第１４案,新北市,蘆洲區,光華里,557,1516,297,529,826,66,892
公投第１４案,新北市,蘆洲區,光明里,558,1404,243,480,723,52,775
公投第１４案,新北市,蘆洲區,光明里,559,1381,233,459,692,65,757
公投第１４案,新北市,蘆洲區,光明里,560,1485,286,525,811,30,841
公投第１４案,新北市,蘆洲區,中路里,561,1779,213,430,643,43,686
公投第１４案,新北市,蘆洲區,中路里,562,1797,216,699,915,50,965
公投第１４案,新北市,蘆洲區,永安里,563,1364,251,487,738,50,788
公投第１４案,新北市,蘆洲區,永安里,564,1635,306,563,869,57,926
公投第１４案,新北市,蘆洲區,永安里,565,1567,234,490,724,32,756
公投第１４案,新北市,蘆洲區,九芎里,566,1524,267,505,772,41,813
公投第１４案,新北市,蘆洲區,九芎里,567,1612,275,503,778,58,836
公投第１４案,新北市,蘆洲區,九芎里,568,1674,289,556,845,32,877
公投第１４案,新北市,蘆洲區,延平里,569,1838,311,559,870,45,915
公投第１４案,新北市,蘆洲區,延平里,570,1814,274,524,798,31,829
公投第１４案,新北市,蘆洲區,中華里,571,1473,300,489,789,40,829
公投第１４案,新北市,蘆洲區,中華里,572,1465,372,382,754,43,797
公投第１４案,新北市,蘆洲區,中原里,573,1652,324,540,864,50,914
公投第１４案,新北市,蘆洲區,中原里,574,1650,330,518,848,64,912
公投第１４案,新北市,蘆洲區,中原里,575,1656,279,590,869,47,916
公投第１４案,新北市,蘆洲區,長安里,576,1571,282,498,780,45,825
公投第１４案,新北市,蘆洲區,長安里,577,1523,295,471,766,50,816
公投第１４案,新北市,蘆洲區,長安里,578,1475,288,474,762,38,800
公投第１４案,新北市,蘆洲區,忠義里,579,1367,252,432,684,42,726
公投第１４案,新北市,蘆洲區,忠義里,580,1514,279,538,817,44,861
公投第１４案,新北市,蘆洲區,正義里,581,1791,380,646,1026,33,1059
公投第１４案,新北市,蘆洲區,正義里,582,1714,374,632,1006,39,1045
公投第１４案,新北市,蘆洲區,正義里,583,1780,376,613,989,28,1017
公投第１４案,新北市,蘆洲區,正義里,584,1713,331,601,932,29,961
公投第１４案,新北市,蘆洲區,正義里,585,1720,321,637,958,32,990
公投第１４案,新北市,蘆洲區,正義里,586,1766,327,615,942,41,983
公投第１４案,新北市,蘆洲區,南港里,587,1623,272,566,838,49,887
公投第１４案,新北市,蘆洲區,南港里,588,1740,392,572,964,31,995
公投第１４案,新北市,蘆洲區,南港里,589,1759,344,616,960,60,1020
公投第１４案,新北市,蘆洲區,永樂里,590,1775,365,597,962,64,1026
公投第１４案,新北市,蘆洲區,永樂里,591,1909,378,668,1046,42,1088
公投第１４案,新北市,蘆洲區,永樂里,592,1805,364,615,979,71,1050
公投第１４案,新北市,蘆洲區,成功里,593,1642,309,525,834,40,874
公投第１４案,新北市,蘆洲區,成功里,594,1713,329,543,872,59,931
公投第１４案,新北市,蘆洲區,成功里,595,1746,317,518,835,57,892
公投第１４案,新北市,蘆洲區,成功里,596,1596,307,521,828,49,877
公投第１４案,新北市,蘆洲區,永康里,597,1434,244,472,716,47,763
公投第１４案,新北市,蘆洲區,永康里,598,1450,289,476,765,45,810
公投第１４案,新北市,蘆洲區,永康里,599,1543,296,469,765,15,780
公投第１４案,新北市,蘆洲區,永康里,600,1525,287,485,772,44,816
公投第１４案,新北市,蘆洲區,永德里,601,1419,257,424,681,54,735
公投第１４案,新北市,蘆洲區,永德里,602,1298,262,443,705,35,740
公投第１４案,新北市,蘆洲區,永德里,603,1304,229,434,663,45,708
公投第１４案,新北市,蘆洲區,樓厝里,604,1806,324,596,920,41,961
公投第１４案,新北市,蘆洲區,樓厝里,605,1910,334,598,932,64,996
公投第１４案,新北市,蘆洲區,樓厝里,606,1873,282,533,815,52,867
公投第１４案,新北市,蘆洲區,信義里,607,1785,297,533,830,44,874
公投第１４案,新北市,蘆洲區,信義里,608,1760,273,559,832,56,888
公投第１４案,新北市,蘆洲區,玉清里,609,1841,333,643,976,36,1012
公投第１４案,新北市,蘆洲區,玉清里,610,1855,318,579,897,37,934
公投第１４案,新北市,蘆洲區,玉清里,611,1450,249,426,675,55,730
公投第１４案,新北市,蘆洲區,復興里,612,1585,275,497,772,58,830
公投第１４案,新北市,蘆洲區,復興里,613,1541,245,462,707,83,790
公投第１４案,新北市,蘆洲區,福安里,614,1626,294,524,818,54,872
公投第１４案,新北市,蘆洲區,福安里,615,1241,253,414,667,51,718
公投第１４案,新北市,蘆洲區,鷺江里,616,1634,289,558,847,42,889
公投第１４案,新北市,蘆洲區,鷺江里,617,1573,284,536,820,51,871
公投第１４案,新北市,蘆洲區,鷺江里,618,1619,297,577,874,40,914
公投第１４案,新北市,蘆洲區,恆德里,619,1878,334,597,931,82,1013
公投第１４案,新北市,蘆洲區,恆德里,620,1797,287,605,892,67,959
公投第１４案,新北市,蘆洲區,恆德里,621,1816,359,621,980,42,1022
公投第１４案,新北市,蘆洲區,溪墘里,622,1344,244,482,726,67,793
公投第１４案,新北市,蘆洲區,溪墘里,623,1492,290,531,821,58,879
公投第１４案,新北市,蘆洲區,仁復里,624,1959,318,644,962,92,1054
公投第１４案,新北市,蘆洲區,仁德里,625,1611,280,530,810,74,884
公投第１４案,新北市,蘆洲區,仁德里,626,1574,323,575,898,45,943
公投第１４案,新北市,蘆洲區,仁德里,627,1653,313,564,877,52,929
公投第１４案,新北市,蘆洲區,仁義里,628,3085,357,656,1013,47,1060
公投第１４案,新北市,蘆洲區,仁義里,629,1812,337,577,914,58,972
公投第１４案,新北市,蘆洲區,得勝里,630,1332,263,419,682,54,736
公投第１４案,新北市,蘆洲區,得勝里,631,1648,297,481,778,66,844
公投第１４案,新北市,蘆洲區,得仁里,632,1355,245,444,689,32,721
公投第１４案,新北市,蘆洲區,得仁里,633,1371,235,456,691,35,726
公投第１４案,新北市,蘆洲區,保和里,634,1111,233,348,581,61,642
公投第１４案,新北市,蘆洲區,保和里,635,1176,197,443,640,59,699
公投第１４案,新北市,蘆洲區,樹德里,636,1602,331,527,858,46,904
公投第１４案,新北市,蘆洲區,樹德里,637,1361,223,420,643,48,691
公投第１４案,新北市,蘆洲區,民和里,638,1530,251,523,774,61,835
公投第１４案,新北市,蘆洲區,民和里,639,925,150,311,461,66,527
公投第１４案,新北市,蘆洲區,水湳里,640,1851,328,637,965,55,1020
公投第１４案,新北市,蘆洲區,水湳里,641,1791,284,557,841,41,882
公投第１４案,新北市,蘆洲區,水湳里,642,1853,332,532,864,58,922
公投第１４案,新北市,蘆洲區,水湳里,643,1758,288,536,824,38,862
公投第１４案,新北市,蘆洲區,水湳里,644,1798,344,572,916,52,968
公投第１４案,新北市,蘆洲區,水河里,645,1645,324,528,852,56,908
公投第１４案,新北市,蘆洲區,水河里,646,1612,271,469,740,52,792
公投第１４案,新北市,蘆洲區,水河里,647,1784,320,501,821,44,865
公投第１４案,新北市,蘆洲區,水河里,648,1701,260,476,736,56,792
公投第１４案,新北市,蘆洲區,水河里,649,1581,351,430,781,30,811
公投第１４案,新北市,蘆洲區,仁愛里,650,1534,318,481,799,47,846
公投第１４案,新北市,蘆洲區,仁愛里,651,1620,326,554,880,49,929
公投第１４案,新北市,蘆洲區,仁愛里,652,1494,295,542,837,52,889
公投第１４案,新北市,蘆洲區,忠孝里,653,1183,251,379,630,29,659
公投第１４案,新北市,蘆洲區,忠孝里,654,985,212,327,539,32,571
公投第１４案,新北市,蘆洲區,保佑里,655,1673,295,516,811,65,876
公投第１４案,新北市,蘆洲區,保佑里,656,1688,324,555,879,67,946
公投第１４案,新北市,蘆洲區,保新里,657,1249,216,427,643,39,682
公投第１４案,新北市,蘆洲區,保新里,658,1476,257,486,743,54,797
公投第１４案,新北市,三重區,大有里,659,1509,272,485,757,52,809
公投第１４案,新北市,三重區,大有里,660,1591,288,578,866,52,918
公投第１４案,新北市,三重區,大有里,661,1653,316,577,893,69,962
公投第１４案,新北市,三重區,博愛里,662,1392,253,507,760,68,828
公投第１４案,新北市,三重區,博愛里,663,1451,281,533,814,64,878
公投第１４案,新北市,三重區,博愛里,664,1329,253,456,709,63,772
公投第１４案,新北市,三重區,二重里,665,1459,261,528,789,52,841
公投第１４案,新北市,三重區,頂崁里,666,1024,189,380,569,53,622
公投第１４案,新北市,三重區,頂崁里,667,1066,196,386,582,60,642
公投第１４案,新北市,三重區,谷王里,668,856,201,303,504,59,563
公投第１４案,新北市,三重區,五谷里,669,764,142,251,393,42,435
公投第１４案,新北市,三重區,五谷里,670,821,161,304,465,45,510
公投第１４案,新北市,三重區,中興里,671,1887,419,504,923,66,989
公投第１４案,新北市,三重區,中興里,672,1646,321,505,826,60,886
公投第１４案,新北市,三重區,德厚里,673,358,74,132,206,12,218
公投第１４案,新北市,三重區,成功里,674,1039,219,366,585,41,626
公投第１４案,新北市,三重區,成功里,675,1114,231,386,617,29,646
公投第１４案,新北市,三重區,成功里,676,1588,334,571,905,32,937
公投第１４案,新北市,三重區,成功里,677,1702,292,576,868,36,904
公投第１４案,新北市,三重區,福祉里,678,1288,272,463,735,52,787
公投第１４案,新北市,三重區,福祉里,679,1629,330,593,923,54,977
公投第１４案,新北市,三重區,福祉里,680,1861,362,639,1001,50,1051
公投第１４案,新北市,三重區,福德里,681,1727,300,561,861,46,907
公投第１４案,新北市,三重區,福德里,682,1813,353,616,969,41,1010
公投第１４案,新北市,三重區,福民里,683,1595,276,563,839,64,903
公投第１４案,新北市,三重區,福民里,684,1513,302,514,816,68,884
公投第１４案,新北市,三重區,過田里,685,4433,290,426,716,43,759
公投第１４案,新北市,三重區,過田里,686,1283,232,467,699,50,749
公投第１４案,新北市,三重區,過田里,687,1430,265,553,818,54,872
公投第１４案,新北市,三重區,過田里,688,1357,286,499,785,26,811
公投第１４案,新北市,三重區,錦田里,689,963,189,347,536,35,571
公投第１４案,新北市,三重區,錦田里,690,883,190,296,486,42,528
公投第１４案,新北市,三重區,重明里,691,1494,261,502,763,88,851
公投第１４案,新北市,三重區,重明里,692,1616,336,544,880,63,943
公投第１４案,新北市,三重區,光田里,693,1329,273,434,707,53,760
公投第１４案,新北市,三重區,光田里,694,1289,268,493,761,47,808
公投第１４案,新北市,三重區,光田里,695,1380,262,480,742,63,805
公投第１４案,新北市,三重區,光陽里,696,1668,377,556,933,34,967
公投第１４案,新北市,三重區,光陽里,697,1226,256,453,709,67,776
公投第１４案,新北市,三重區,光陽里,698,1421,285,533,818,42,860
公投第１４案,新北市,三重區,光陽里,699,1364,258,498,756,53,809
公投第１４案,新北市,三重區,田心里,700,1232,239,447,686,46,732
公投第１４案,新北市,三重區,田心里,701,1248,252,479,731,51,782
公投第１４案,新北市,三重區,田心里,702,1256,280,421,701,52,753
公投第１４案,新北市,三重區,福田里,703,1506,327,564,891,43,934
公投第１４案,新北市,三重區,福田里,704,1669,347,589,936,49,985
公投第１４案,新北市,三重區,田中里,705,1308,251,453,704,64,768
公投第１４案,新北市,三重區,田中里,706,1263,276,490,766,62,828
公投第１４案,新北市,三重區,田中里,707,1471,301,473,774,64,838
公投第１４案,新北市,三重區,田中里,708,1447,309,486,795,81,876
公投第１４案,新北市,三重區,田安里,709,1693,372,412,784,51,835
公投第１４案,新北市,三重區,田安里,710,2015,393,644,1037,51,1088
公投第１４案,新北市,三重區,田安里,711,1812,284,606,890,68,958
公投第１４案,新北市,三重區,三民里,712,1509,307,460,767,30,797
公投第１４案,新北市,三重區,三民里,713,1439,285,503,788,49,837
公投第１４案,新北市,三重區,光明里,714,1437,278,504,782,41,823
公投第１４案,新北市,三重區,光明里,715,1697,346,518,864,57,921
公投第１４案,新北市,三重區,光明里,716,1793,340,564,904,33,937
公投第１４案,新北市,三重區,光明里,717,1603,340,593,933,28,961
公投第１４案,新北市,三重區,光正里,718,1166,243,372,615,19,634
公投第１４案,新北市,三重區,光正里,719,1126,243,380,623,44,667
公投第１４案,新北市,三重區,同安里,720,1291,182,412,594,56,650
公投第１４案,新北市,三重區,同慶里,721,1597,316,530,846,55,901
公投第１４案,新北市,三重區,菜寮里,722,1081,219,389,608,57,665
公投第１４案,新北市,三重區,菜寮里,723,911,363,184,547,42,589
公投第１４案,新北市,三重區,永春里,724,1719,297,514,811,45,856
公投第１４案,新北市,三重區,中正里,725,1289,266,390,656,71,727
公投第１４案,新北市,三重區,吉利里,726,1318,259,485,744,60,804
公投第１４案,新北市,三重區,大同里,727,1822,357,553,910,50,960
公投第１４案,新北市,三重區,中民里,728,1185,212,395,607,84,691
公投第１４案,新北市,三重區,平和里,729,1369,427,236,663,59,722
公投第１４案,新北市,三重區,大安里,730,1507,285,519,804,57,861
公投第１４案,新北市,三重區,仁德里,731,926,189,311,500,55,555
公投第１４案,新北市,三重區,仁德里,732,950,170,294,464,22,486
公投第１４案,新北市,三重區,忠孝里,733,1678,306,513,819,70,889
公投第１４案,新北市,三重區,仁義里,734,1117,209,361,570,68,638
公投第１４案,新北市,三重區,光榮里,735,1318,256,404,660,51,711
公投第１４案,新北市,三重區,光輝里,736,1388,299,483,782,33,815
公投第１４案,新北市,三重區,福星里,737,1026,224,309,533,65,598
公投第１４案,新北市,三重區,福利里,738,1096,231,403,634,46,680
公投第１４案,新北市,三重區,福利里,739,967,199,340,539,33,572
公投第１４案,新北市,三重區,清和里,740,1871,350,595,945,44,989
公投第１４案,新北市,三重區,清和里,741,1663,326,548,874,62,936
公投第１４案,新北市,三重區,永興里,742,1208,217,419,636,26,662
公投第１４案,新北市,三重區,中山里,743,1398,275,397,672,66,738
公投第１４案,新北市,三重區,中山里,744,1078,213,342,555,28,583
公投第１４案,新北市,三重區,大園里,745,1102,166,372,538,61,599
公投第１４案,新北市,三重區,大園里,746,1393,267,423,690,77,767
公投第１４案,新北市,三重區,國隆里,747,1251,230,440,670,71,741
公投第１４案,新北市,三重區,國隆里,748,1234,276,448,724,63,787
公投第１４案,新北市,三重區,重陽里,749,1661,332,559,891,69,960
公投第１４案,新北市,三重區,重陽里,750,1590,313,531,844,65,909
公投第１４案,新北市,三重區,民生里,751,1182,229,415,644,58,702
公投第１４案,新北市,三重區,民生里,752,1369,272,474,746,72,818
公投第１４案,新北市,三重區,民生里,753,1222,265,447,712,46,758
公投第１４案,新北市,三重區,重新里,754,1304,237,426,663,81,744
公投第１４案,新北市,三重區,正德里,755,1054,175,353,528,36,564
公投第１４案,新北市,三重區,正義里,756,1635,301,550,851,69,920
公投第１４案,新北市,三重區,正安里,757,1779,319,561,880,60,940
公投第１４案,新北市,三重區,自強里,758,1633,310,545,855,78,933
公投第１４案,新北市,三重區,文化里,759,1107,224,380,604,38,642
公投第１４案,新北市,三重區,文化里,760,1021,200,299,499,40,539
公投第１４案,新北市,三重區,中央里,761,1649,265,503,768,83,851
公投第１４案,新北市,三重區,雙園里,762,874,166,297,463,32,495
公投第１４案,新北市,三重區,錦通里,763,1402,260,469,729,95,824
公投第１４案,新北市,三重區,錦安里,764,1713,274,524,798,72,870
公投第１４案,新北市,三重區,長安里,765,973,163,284,447,43,490
公投第１４案,新北市,三重區,長安里,766,1038,219,346,565,49,614
公投第１４案,新北市,三重區,光華里,767,1833,298,523,821,124,945
公投第１４案,新北市,三重區,長生里,768,817,158,270,428,35,463
公投第１４案,新北市,三重區,開元里,769,1387,271,497,768,55,823
公投第１４案,新北市,三重區,大德里,770,784,165,282,447,32,479
公投第１４案,新北市,三重區,長元里,771,1096,211,332,543,34,577
公投第１４案,新北市,三重區,長元里,772,1163,229,396,625,65,690
公投第１４案,新北市,三重區,長江里,773,1868,326,599,925,52,977
公投第１４案,新北市,三重區,長泰里,774,1117,187,372,559,56,615
公投第１４案,新北市,三重區,長泰里,775,934,167,297,464,33,497
公投第１４案,新北市,三重區,長福里,776,1412,240,444,684,61,745
公投第１４案,新北市,三重區,介壽里,777,1062,209,416,625,46,671
公投第１４案,新北市,三重區,萬壽里,778,891,160,293,453,58,511
公投第１４案,新北市,三重區,萬壽里,779,936,199,360,559,82,641
公投第１４案,新北市,三重區,錦江里,780,1085,183,344,527,66,593
公投第１４案,新北市,三重區,錦江里,781,1065,215,293,508,24,532
公投第１４案,新北市,三重區,龍濱里,782,1398,269,473,742,59,801
公投第１４案,新北市,三重區,龍濱里,783,1550,289,542,831,47,878
公投第１４案,新北市,三重區,龍門里,784,1674,289,556,845,65,910
公投第１４案,新北市,三重區,秀江里,785,1215,216,428,644,53,697
公投第１４案,新北市,三重區,奕壽里,786,1606,288,531,819,66,885
公投第１４案,新北市,三重區,三安里,787,1182,222,395,617,47,664
公投第１４案,新北市,三重區,三安里,788,1238,218,451,669,62,731
公投第１４案,新北市,三重區,福安里,789,1342,262,472,734,67,801
公投第１４案,新北市,三重區,福安里,790,1408,279,494,773,46,819
公投第１４案,新北市,三重區,信安里,791,1770,326,594,920,76,996
公投第１４案,新北市,三重區,安慶里,792,940,214,290,504,47,551
公投第１４案,新北市,三重區,安慶里,793,975,191,322,513,24,537
公投第１４案,新北市,三重區,幸福里,794,1507,295,459,754,48,802
公投第１４案,新北市,三重區,幸福里,795,1419,263,486,749,64,813
公投第１４案,新北市,三重區,幸福里,796,1257,198,465,663,57,720
公投第１４案,新北市,三重區,六合里,797,1619,311,544,855,67,922
公投第１４案,新北市,三重區,六合里,798,1745,300,576,876,66,942
公投第１４案,新北市,三重區,六福里,799,1519,306,478,784,74,858
公投第１４案,新北市,三重區,六福里,800,1682,272,569,841,48,889
公投第１４案,新北市,三重區,六福里,801,1697,442,597,1039,69,1108
公投第１４案,新北市,三重區,順德里,802,1073,134,303,437,46,483
公投第１４案,新北市,三重區,順德里,803,924,146,322,468,44,512
公投第１４案,新北市,三重區,承德里,804,1613,231,504,735,57,792
公投第１４案,新北市,三重區,瑞德里,805,1034,159,412,571,57,628
公投第１４案,新北市,三重區,瑞德里,806,1118,299,299,598,58,656
公投第１４案,新北市,三重區,崇德里,807,1269,224,418,642,76,718
公投第１４案,新北市,三重區,崇德里,808,990,189,321,510,49,559
公投第１４案,新北市,三重區,崇德里,809,1336,241,463,704,58,762
公投第１４案,新北市,三重區,厚德里,810,1601,287,562,849,52,901
公投第１４案,新北市,三重區,厚德里,811,1581,312,590,902,59,961
公投第１４案,新北市,三重區,維德里,812,1345,261,463,724,59,783
公投第１４案,新北市,三重區,維德里,813,1226,245,474,719,37,756
公投第１４案,新北市,三重區,尚德里,814,1650,263,514,777,87,864
公投第１４案,新北市,三重區,尚德里,815,1140,200,406,606,50,656
公投第１４案,新北市,三重區,培德里,816,1639,274,521,795,47,842
公投第１４案,新北市,三重區,培德里,817,1699,305,593,898,59,957
公投第１４案,新北市,三重區,立德里,818,1501,310,616,926,68,994
公投第１４案,新北市,三重區,立德里,819,1538,291,517,808,60,868
公投第１４案,新北市,三重區,永德里,820,1540,256,526,782,62,844
公投第１４案,新北市,三重區,永德里,821,1276,204,467,671,48,719
公投第１４案,新北市,三重區,永德里,822,1539,267,491,758,63,821
公投第１４案,新北市,三重區,永煇里,823,1170,257,408,665,40,705
公投第１４案,新北市,三重區,永煇里,824,1120,228,359,587,51,638
公投第１４案,新北市,三重區,永發里,825,1789,331,615,946,63,1009
公投第１４案,新北市,三重區,永發里,826,1520,300,448,748,62,810
公投第１４案,新北市,三重區,永發里,827,1821,352,595,947,67,1014
公投第１４案,新北市,三重區,永盛里,828,1407,264,470,734,63,797
公投第１４案,新北市,三重區,永盛里,829,1491,277,492,769,63,832
公投第１４案,新北市,三重區,永吉里,830,1381,273,495,768,54,822
公投第１４案,新北市,三重區,永吉里,831,1222,230,418,648,65,713
公投第１４案,新北市,三重區,永安里,832,1938,321,630,951,130,1081
公投第１４案,新北市,三重區,永安里,833,1639,299,576,875,37,912
公投第１４案,新北市,三重區,永豐里,834,1614,302,529,831,78,909
公投第１４案,新北市,三重區,永豐里,835,1709,298,593,891,46,937
公投第１４案,新北市,三重區,永豐里,836,1753,263,574,837,61,898
公投第１４案,新北市,三重區,永福里,837,1398,262,488,750,68,818
公投第１４案,新北市,三重區,永福里,838,1706,320,539,859,68,927
公投第１４案,新北市,三重區,永福里,839,1614,296,565,861,64,925
公投第１４案,新北市,三重區,永清里,840,1591,316,547,863,68,931
公投第１４案,新北市,三重區,永清里,841,1627,330,501,831,50,881
公投第１４案,新北市,三重區,永清里,842,1505,288,505,793,71,864
公投第１４案,新北市,三重區,永順里,843,1331,260,458,718,43,761
公投第１４案,新北市,三重區,永順里,844,1678,327,503,830,53,883
公投第１４案,新北市,三重區,永順里,845,1498,297,498,795,53,848
公投第１４案,新北市,三重區,溪美里,846,1800,389,601,990,65,1055
公投第１４案,新北市,三重區,溪美里,847,1703,295,490,785,49,834
公投第１４案,新北市,三重區,溪美里,848,1975,361,582,943,44,987
公投第１４案,新北市,三重區,溪美里,849,1894,321,605,926,57,983
公投第１４案,新北市,三重區,福隆里,850,1405,259,511,770,53,823
公投第１４案,新北市,三重區,福隆里,851,1293,251,474,725,25,750
公投第１４案,新北市,三重區,福隆里,852,1259,263,433,696,37,733
公投第１４案,新北市,三重區,五常里,853,1144,225,417,642,67,709
公投第１４案,新北市,三重區,五常里,854,1254,258,446,704,62,766
公投第１４案,新北市,三重區,五常里,855,1313,277,423,700,48,748
公投第１４案,新北市,三重區,五福里,856,1594,302,499,801,77,878
公投第１４案,新北市,三重區,五福里,857,1775,349,565,914,63,977
公投第１４案,新北市,三重區,仁忠里,858,1516,248,521,769,80,849
公投第１４案,新北市,三重區,仁忠里,859,1315,264,519,783,74,857
公投第１４案,新北市,三重區,慈福里,860,843,177,293,470,49,519
公投第１４案,新北市,三重區,慈福里,861,1160,179,374,553,54,607
公投第１４案,新北市,三重區,慈生里,862,1052,174,388,562,50,612
公投第１４案,新北市,三重區,慈生里,863,1054,218,398,616,51,667
公投第１４案,新北市,三重區,慈惠里,864,997,191,346,537,55,592
公投第１４案,新北市,三重區,慈惠里,865,936,168,306,474,41,515
公投第１４案,新北市,三重區,慈愛里,866,1658,302,531,833,84,917
公投第１４案,新北市,三重區,慈愛里,867,1496,265,486,751,59,810
公投第１４案,新北市,三重區,慈化里,868,1064,212,400,612,43,655
公投第１４案,新北市,三重區,慈化里,869,1152,213,440,653,51,704
公投第１４案,新北市,三重區,慈祐里,870,1532,283,497,780,43,823
公投第１４案,新北市,三重區,慈祐里,871,1338,222,415,637,31,668
公投第１４案,新北市,三重區,慈祐里,872,1303,268,434,702,54,756
公投第１４案,新北市,三重區,富華里,873,1369,253,493,746,76,822
公投第１４案,新北市,三重區,富華里,874,1491,256,504,760,64,824
公投第１４案,新北市,三重區,富貴里,875,1821,296,562,858,90,948
公投第１４案,新北市,三重區,富貴里,876,1906,342,586,928,41,969
公投第１４案,新北市,三重區,富貴里,877,1842,364,630,994,54,1048
公投第１４案,新北市,三重區,富福里,878,878,133,309,442,35,477
公投第１４案,新北市,三重區,富福里,879,963,220,351,571,46,617
公投第１４案,新北市,三重區,五華里,880,1381,244,412,656,28,684
公投第１４案,新北市,三重區,五華里,881,1681,279,495,774,69,843
公投第１４案,新北市,三重區,五華里,882,1548,286,490,776,32,808
公投第１４案,新北市,三重區,碧華里,883,1542,339,505,844,50,894
公投第１４案,新北市,三重區,碧華里,884,1557,295,499,794,68,862
公投第１４案,新北市,三重區,碧華里,885,1661,306,553,859,40,899
公投第１４案,新北市,三重區,碧華里,886,2024,391,677,1068,30,1098
公投第１４案,新北市,三重區,福樂里,887,1588,247,498,745,54,799
公投第１４案,新北市,三重區,福樂里,888,1706,267,570,837,91,928
公投第１４案,新北市,三重區,仁華里,889,1341,277,469,746,39,785
公投第１４案,新北市,三重區,仁華里,890,1025,174,351,525,40,565
公投第１４案,新北市,三重區,仁華里,891,1339,245,459,704,57,761
公投第１４案,新北市,三重區,五順里,892,1725,306,569,875,80,955
公投第１４案,新北市,三重區,五順里,893,1826,347,587,934,65,999
公投第１４案,新北市,板橋區,留侯里,894,1388,279,424,703,73,776
公投第１４案,新北市,板橋區,流芳里,895,1294,300,426,726,35,761
公投第１４案,新北市,板橋區,赤松里,896,667,171,233,404,15,419
公投第１４案,新北市,板橋區,黃石里,897,898,163,295,458,28,486
公投第１４案,新北市,板橋區,挹秀里,898,829,168,310,478,28,506
公投第１４案,新北市,板橋區,挹秀里,899,739,135,294,429,33,462
公投第１４案,新北市,板橋區,湳興里,900,1035,215,379,594,43,637
公投第１４案,新北市,板橋區,湳興里,901,1713,310,463,773,25,798
公投第１４案,新北市,板橋區,湳興里,902,658,110,217,327,13,340
公投第１４案,新北市,板橋區,湳興里,903,1312,226,432,658,79,737
公投第１４案,新北市,板橋區,新興里,904,1492,243,484,727,46,773
公投第１４案,新北市,板橋區,新興里,905,1393,216,450,666,57,723
公投第１４案,新北市,板橋區,社後里,906,4742,403,535,938,40,978
公投第１４案,新北市,板橋區,社後里,907,1439,280,467,747,39,786
公投第１４案,新北市,板橋區,社後里,908,1187,251,408,659,69,728
公投第１４案,新北市,板橋區,社後里,909,1122,226,367,593,34,627
公投第１４案,新北市,板橋區,香社里,910,1363,255,484,739,61,800
公投第１４案,新北市,板橋區,香社里,911,1093,215,380,595,52,647
公投第１４案,新北市,板橋區,香社里,912,1331,297,465,762,42,804
公投第１４案,新北市,板橋區,香雅里,913,1026,216,387,603,39,642
公投第１４案,新北市,板橋區,香雅里,914,1244,251,421,672,58,730
公投第１４案,新北市,板橋區,中正里,915,1268,233,385,618,70,688
公投第１４案,新北市,板橋區,中正里,916,1313,217,442,659,33,692
公投第１４案,新北市,板橋區,中正里,917,1196,279,410,689,43,732
公投第１４案,新北市,板橋區,自強里,918,1137,276,470,746,31,777
公投第１４案,新北市,板橋區,自強里,919,1269,300,473,773,38,811
公投第１４案,新北市,板橋區,自強里,920,1117,228,431,659,31,690
公投第１４案,新北市,板橋區,自強里,921,1042,209,417,626,36,662
公投第１４案,新北市,板橋區,自立里,922,1257,234,452,686,76,762
公投第１４案,新北市,板橋區,自立里,923,1216,222,454,676,49,725
公投第１４案,新北市,板橋區,光華里,924,1126,249,357,606,54,660
公投第１４案,新北市,板橋區,光華里,925,1290,293,502,795,47,842
公投第１４案,新北市,板橋區,光榮里,926,1215,227,389,616,14,630
公投第１４案,新北市,板橋區,光榮里,927,1099,194,388,582,26,608
公投第１４案,新北市,板橋區,國光里,928,1329,251,564,815,34,849
公投第１４案,新北市,板橋區,國光里,929,996,161,420,581,23,604
公投第１４案,新北市,板橋區,國光里,930,1047,209,391,600,30,630
公投第１４案,新北市,板橋區,港尾里,931,1272,237,478,715,54,769
公投第１４案,新北市,板橋區,港尾里,932,1252,344,377,721,36,757
公投第１４案,新北市,板橋區,新生里,933,1238,220,457,677,54,731
公投第１４案,新北市,板橋區,新生里,934,1389,310,510,820,63,883
公投第１４案,新北市,板橋區,新生里,935,1194,252,441,693,53,746
公投第１４案,新北市,板橋區,金華里,936,1093,198,348,546,53,599
公投第１４案,新北市,板橋區,金華里,937,1148,210,388,598,70,668
公投第１４案,新北市,板橋區,金華里,938,1268,257,462,719,48,767
公投第１４案,新北市,板橋區,港德里,939,1230,236,415,651,67,718
公投第１４案,新北市,板橋區,港德里,940,1012,161,381,542,36,578
公投第１４案,新北市,板橋區,港德里,941,811,158,290,448,41,489
公投第１４案,新北市,板橋區,港德里,942,1197,253,452,705,51,756
公投第１４案,新北市,板橋區,民權里,943,1142,207,413,620,30,650
公投第１４案,新北市,板橋區,民權里,944,1222,236,436,672,37,709
公投第１４案,新北市,板橋區,民安里,945,796,145,324,469,38,507
公投第１４案,新北市,板橋區,民安里,946,997,232,348,580,67,647
公投第１４案,新北市,板橋區,建國里,947,1011,213,352,565,33,598
公投第１４案,新北市,板橋區,建國里,948,1157,241,387,628,54,682
公投第１４案,新北市,板橋區,建國里,949,1040,200,385,585,49,634
公投第１４案,新北市,板橋區,漢生里,950,1173,237,431,668,37,705
公投第１４案,新北市,板橋區,漢生里,951,1193,132,390,522,26,548
公投第１４案,新北市,板橋區,漢生里,952,1255,246,477,723,40,763
公投第１４案,新北市,板橋區,公舘里,953,1306,294,446,740,35,775
公投第１４案,新北市,板橋區,公舘里,954,1050,217,391,608,17,625
公投第１４案,新北市,板橋區,公舘里,955,942,195,337,532,30,562
公投第１４案,新北市,板橋區,新民里,956,1133,212,460,672,44,716
公投第１４案,新北市,板橋區,新民里,957,1251,235,470,705,33,738
公投第１４案,新北市,板橋區,新民里,958,1293,256,489,745,36,781
公投第１４案,新北市,板橋區,幸福里,959,1208,219,384,603,57,660
公投第１４案,新北市,板橋區,幸福里,960,1223,234,424,658,55,713
公投第１４案,新北市,板橋區,幸福里,961,1061,203,352,555,49,604
公投第１４案,新北市,板橋區,文德里,962,1515,310,527,837,45,882
公投第１４案,新北市,板橋區,文德里,963,1225,230,481,711,44,755
公投第１４案,新北市,板橋區,忠誠里,964,1120,214,468,682,35,717
公投第１４案,新北市,板橋區,忠誠里,965,1091,228,425,653,42,695
公投第１４案,新北市,板橋區,忠誠里,966,1385,240,579,819,29,848
公投第１４案,新北市,板橋區,陽明里,967,1283,260,485,745,50,795
公投第１４案,新北市,板橋區,陽明里,968,1204,234,421,655,68,723
公投第１４案,新北市,板橋區,百壽里,969,1191,253,461,714,42,756
公投第１４案,新北市,板橋區,百壽里,970,1078,208,431,639,47,686
公投第１４案,新北市,板橋區,介壽里,971,1351,248,493,741,64,805
公投第１４案,新北市,板橋區,介壽里,972,1322,277,456,733,47,780
公投第１４案,新北市,板橋區,新埔里,973,868,154,320,474,51,525
公投第１４案,新北市,板橋區,新埔里,974,1029,226,410,636,55,691
公投第１４案,新北市,板橋區,華江里,975,1602,309,585,894,35,929
公投第１４案,新北市,板橋區,華江里,976,1362,255,516,771,54,825
公投第１４案,新北市,板橋區,華江里,977,1698,344,553,897,68,965
公投第１４案,新北市,板橋區,華江里,978,1495,297,527,824,28,852
公投第１４案,新北市,板橋區,江翠里,979,1522,319,474,793,58,851
公投第１４案,新北市,板橋區,江翠里,980,1279,256,443,699,58,757
公投第１４案,新北市,板橋區,江翠里,981,1559,260,453,713,44,757
公投第１４案,新北市,板橋區,純翠里,982,1537,282,473,755,74,829
公投第１４案,新北市,板橋區,純翠里,983,1531,282,461,743,59,802
公投第１４案,新北市,板橋區,純翠里,984,1720,328,570,898,28,926
公投第１４案,新北市,板橋區,溪頭里,985,1165,210,393,603,37,640
公投第１４案,新北市,板橋區,溪頭里,986,1857,386,625,1011,50,1061
公投第１４案,新北市,板橋區,溪頭里,987,1078,209,359,568,62,630
公投第１４案,新北市,板橋區,溪頭里,988,1177,221,395,616,20,636
公投第１４案,新北市,板橋區,聯翠里,989,1798,371,620,991,55,1046
公投第１４案,新北市,板橋區,聯翠里,990,1455,284,524,808,72,880
公投第１４案,新北市,板橋區,文化里,991,1245,254,449,703,59,762
公投第１４案,新北市,板橋區,文化里,992,1704,342,528,870,70,940
公投第１４案,新北市,板橋區,宏翠里,993,1600,362,506,868,31,899
公投第１４案,新北市,板橋區,宏翠里,994,1409,233,470,703,30,733
公投第１４案,新北市,板橋區,宏翠里,995,1286,252,445,697,45,742
公投第１４案,新北市,板橋區,仁翠里,996,1359,193,387,580,92,672
公投第１４案,新北市,板橋區,仁翠里,997,1188,220,374,594,34,628
公投第１４案,新北市,板橋區,新翠里,998,1627,298,518,816,55,871
公投第１４案,新北市,板橋區,新翠里,999,1633,314,478,792,35,827
公投第１４案,新北市,板橋區,新翠里,1000,1814,402,626,1028,54,1082
公投第１４案,新北市,板橋區,新翠里,1001,1810,358,624,982,55,1037
公投第１４案,新北市,板橋區,朝陽里,1002,1133,203,407,610,52,662
公投第１４案,新北市,板橋區,朝陽里,1003,841,155,299,454,34,488
公投第１４案,新北市,板橋區,朝陽里,1004,1050,206,397,603,51,654
公投第１４案,新北市,板橋區,吉翠里,1005,1130,211,371,582,56,638
公投第１４案,新北市,板橋區,吉翠里,1006,1056,229,371,600,60,660
公投第１４案,新北市,板橋區,吉翠里,1007,1129,217,356,573,31,604
公投第１４案,新北市,板橋區,德翠里,1008,1713,316,590,906,69,975
公投第１４案,新北市,板橋區,德翠里,1009,1622,302,573,875,62,937
公投第１４案,新北市,板橋區,德翠里,1010,1427,312,540,852,47,899
公投第１４案,新北市,板橋區,德翠里,1011,1471,319,571,890,27,917
公投第１４案,新北市,板橋區,新海里,1012,1076,192,390,582,16,598
公投第１４案,新北市,板橋區,新海里,1013,979,184,305,489,20,509
公投第１４案,新北市,板橋區,新海里,1014,1079,199,464,663,22,685
公投第１４案,新北市,板橋區,滿翠里,1015,828,163,288,451,36,487
公投第１４案,新北市,板橋區,滿翠里,1016,820,149,308,457,60,517
公投第１４案,新北市,板橋區,滿翠里,1017,989,210,358,568,34,602
公投第１４案,新北市,板橋區,明翠里,1018,1023,192,354,546,55,601
公投第１４案,新北市,板橋區,明翠里,1019,1044,200,349,549,32,581
公投第１４案,新北市,板橋區,明翠里,1020,968,174,349,523,50,573
公投第１４案,新北市,板橋區,明翠里,1021,1222,422,266,688,30,718
公投第１４案,新北市,板橋區,松翠里,1022,1385,255,473,728,41,769
公投第１４案,新北市,板橋區,松翠里,1023,1585,314,501,815,55,870
公投第１４案,新北市,板橋區,柏翠里,1024,1840,350,615,965,62,1027
公投第１４案,新北市,板橋區,柏翠里,1025,1806,367,688,1055,69,1124
公投第１４案,新北市,板橋區,龍翠里,1026,1506,286,506,792,68,860
公投第１４案,新北市,板橋區,龍翠里,1027,1476,275,491,766,61,827
公投第１４案,新北市,板橋區,龍翠里,1028,1500,315,514,829,54,883
公投第１４案,新北市,板橋區,松柏里,1029,1096,223,405,628,64,692
公投第１４案,新北市,板橋區,松柏里,1030,963,196,357,553,49,602
公投第１４案,新北市,板橋區,華翠里,1031,1601,307,542,849,44,893
公投第１４案,新北市,板橋區,華翠里,1032,1507,336,542,878,54,932
公投第１４案,新北市,板橋區,莒光里,1033,1315,280,480,760,56,816
公投第１４案,新北市,板橋區,莒光里,1034,1178,217,422,639,31,670
公投第１４案,新北市,板橋區,忠翠里,1035,1822,396,636,1032,74,1106
公投第１４案,新北市,板橋區,忠翠里,1036,1605,340,599,939,64,1003
公投第１４案,新北市,板橋區,忠翠里,1037,1549,314,569,883,23,906
公投第１４案,新北市,板橋區,忠翠里,1038,1948,460,676,1136,26,1162
公投第１４案,新北市,板橋區,忠翠里,1039,1935,370,664,1034,40,1074
公投第１４案,新北市,板橋區,嵐翠里,1040,1097,193,349,542,48,590
公投第１４案,新北市,板橋區,嵐翠里,1041,1095,214,361,575,36,611
公投第１４案,新北市,板橋區,文聖里,1042,1678,270,574,844,77,921
公投第１４案,新北市,板橋區,文聖里,1043,1750,316,589,905,75,980
公投第１４案,新北市,板橋區,文翠里,1044,1187,214,399,613,51,664
公投第１４案,新北市,板橋區,文翠里,1045,1154,248,403,651,29,680
公投第１４案,新北市,板橋區,文翠里,1046,1262,285,445,730,32,762
公投第１４案,新北市,板橋區,青翠里,1047,1271,200,444,644,78,722
公投第１４案,新北市,板橋區,青翠里,1048,1410,481,261,742,64,806
公投第１４案,新北市,板橋區,懷翠里,1049,1745,339,522,861,71,932
公投第１４案,新北市,板橋區,懷翠里,1050,1867,318,639,957,100,1057
公投第１４案,新北市,板橋區,懷翠里,1051,1753,349,624,973,73,1046
公投第１４案,新北市,板橋區,福翠里,1052,1204,235,429,664,62,726
公投第１４案,新北市,板橋區,港嘴里,1053,1614,297,525,822,58,880
公投第１４案,新北市,板橋區,港嘴里,1054,1237,266,432,698,44,742
公投第１４案,新北市,板橋區,港嘴里,1055,1361,295,461,756,54,810
公投第１４案,新北市,板橋區,港嘴里,1056,1243,278,421,699,27,726
公投第１４案,新北市,板橋區,振興里,1057,1515,281,474,755,29,784
公投第１４案,新北市,板橋區,振興里,1058,1515,317,541,858,52,910
公投第１４案,新北市,板橋區,振興里,1059,949,172,368,540,45,585
公投第１４案,新北市,板橋區,振義里,1060,1629,292,547,839,60,899
公投第１４案,新北市,板橋區,振義里,1061,1238,237,451,688,37,725
公投第１４案,新北市,板橋區,振義里,1062,901,130,238,368,29,397
公投第１４案,新北市,板橋區,光復里,1063,1475,296,508,804,62,866
公投第１４案,新北市,板橋區,光復里,1064,1481,281,496,777,55,832
公投第１４案,新北市,板橋區,埔墘里,1065,1800,300,588,888,68,956
公投第１４案,新北市,板橋區,埔墘里,1066,1630,303,514,817,51,868
公投第１４案,新北市,板橋區,埔墘里,1067,1298,272,471,743,36,779
公投第１４案,新北市,板橋區,埔墘里,1068,874,191,308,499,26,525
公投第１４案,新北市,板橋區,富貴里,1069,992,199,353,552,17,569
公投第１４案,新北市,板橋區,富貴里,1070,1034,227,424,651,16,667
公投第１４案,新北市,板橋區,長壽里,1071,1451,314,486,800,63,863
公投第１４案,新北市,板橋區,長壽里,1072,1130,225,423,648,41,689
公投第１４案,新北市,板橋區,福壽里,1073,1440,261,548,809,39,848
公投第１４案,新北市,板橋區,福壽里,1074,1531,301,531,832,76,908
公投第１４案,新北市,板橋區,居仁里,1075,1349,290,517,807,62,869
公投第１４案,新北市,板橋區,居仁里,1076,1593,200,622,822,31,853
公投第１４案,新北市,板橋區,海山里,1077,1174,221,441,662,25,687
公投第１４案,新北市,板橋區,海山里,1078,1228,199,472,671,42,713
公投第１４案,新北市,板橋區,海山里,1079,1187,231,445,676,32,708
公投第１４案,新北市,板橋區,海山里,1080,870,151,346,497,43,540
公投第１４案,新北市,板橋區,海山里,1081,2033,448,745,1193,26,1219
公投第１４案,新北市,板橋區,九如里,1082,1418,269,452,721,46,767
公投第１４案,新北市,板橋區,九如里,1083,1075,200,391,591,30,621
公投第１４案,新北市,板橋區,正泰里,1084,1515,286,515,801,34,835
公投第１４案,新北市,板橋區,正泰里,1085,1182,246,478,724,33,757
公投第１４案,新北市,板橋區,玉光里,1086,1893,396,587,983,65,1048
公投第１４案,新北市,板橋區,玉光里,1087,1302,237,437,674,50,724
公投第１４案,新北市,板橋區,玉光里,1088,1366,265,433,698,36,734
公投第１４案,新北市,板橋區,光仁里,1089,1318,275,479,754,76,830
公投第１４案,新北市,板橋區,光仁里,1090,1200,249,393,642,45,687
公投第１４案,新北市,板橋區,埤墘里,1091,2028,439,660,1099,44,1143
公投第１４案,新北市,板橋區,埤墘里,1092,1746,323,610,933,91,1024
公投第１４案,新北市,板橋區,莊敬里,1093,1954,369,607,976,28,1004
公投第１４案,新北市,板橋區,莊敬里,1094,1474,296,495,791,42,833
公投第１４案,新北市,板橋區,永安里,1095,1418,272,493,765,39,804
公投第１４案,新北市,板橋區,永安里,1096,1563,349,554,903,72,975
公投第１４案,新北市,板橋區,雙玉里,1097,1780,304,608,912,75,987
公投第１４案,新北市,板橋區,雙玉里,1098,1707,334,569,903,45,948
公投第１４案,新北市,板橋區,廣新里,1099,906,114,244,358,10,368
公投第１４案,新北市,板橋區,廣新里,1100,1030,185,349,534,59,593
公投第１４案,新北市,板橋區,廣新里,1101,1115,216,397,613,45,658
公投第１４案,新北市,板橋區,深丘里,1102,1836,326,677,1003,24,1027
公投第１４案,新北市,板橋區,深丘里,1103,1881,330,646,976,64,1040
公投第１４案,新北市,板橋區,深丘里,1104,1688,335,564,899,31,930
公投第１４案,新北市,板橋區,深丘里,1105,1760,371,635,1006,34,1040
公投第１４案,新北市,板橋區,香丘里,1106,1044,217,398,615,42,657
公投第１４案,新北市,板橋區,香丘里,1107,1043,227,391,618,37,655
公投第１４案,新北市,板橋區,香丘里,1108,1099,227,410,637,54,691
公投第１４案,新北市,板橋區,西安里,1109,1260,225,454,679,48,727
公投第１４案,新北市,板橋區,西安里,1110,1131,194,426,620,37,657
公投第１４案,新北市,板橋區,東丘里,1111,1225,224,456,680,41,721
公投第１４案,新北市,板橋區,東丘里,1112,1455,311,553,864,43,907
公投第１４案,新北市,板橋區,東丘里,1113,1267,220,442,662,62,724
公投第１４案,新北市,板橋區,民生里,1114,972,199,342,541,53,594
公投第１４案,新北市,板橋區,民生里,1115,994,204,367,571,30,601
公投第１４案,新北市,板橋區,長安里,1116,1111,223,398,621,19,640
公投第１４案,新北市,板橋區,長安里,1117,1177,247,463,710,71,781
公投第１４案,新北市,板橋區,長安里,1118,1544,307,498,805,57,862
公投第１４案,新北市,板橋區,東安里,1119,1021,161,378,539,56,595
公投第１４案,新北市,板橋區,東安里,1120,1040,176,359,535,54,589
公投第１４案,新北市,板橋區,福丘里,1121,1504,319,481,800,29,829
公投第１４案,新北市,板橋區,福丘里,1122,1373,256,455,711,35,746
公投第１４案,新北市,板橋區,福丘里,1123,1210,266,440,706,20,726
公投第１４案,新北市,板橋區,福祿里,1124,1809,309,599,908,60,968
公投第１４案,新北市,板橋區,福祿里,1125,1551,258,587,845,68,913
公投第１４案,新北市,板橋區,民族里,1126,1408,285,521,806,27,833
公投第１４案,新北市,板橋區,民族里,1127,1285,271,470,741,28,769
公投第１４案,新北市,板橋區,民族里,1128,1102,238,432,670,35,705
公投第１４案,新北市,板橋區,國泰里,1129,1399,241,471,712,31,743
公投第１４案,新北市,板橋區,國泰里,1130,1692,312,579,891,74,965
公投第１４案,新北市,板橋區,後埔里,1131,1625,336,635,971,27,998
公投第１４案,新北市,板橋區,後埔里,1132,1712,341,597,938,61,999
公投第１４案,新北市,板橋區,福德里,1133,1246,240,451,691,32,723
公投第１４案,新北市,板橋區,福德里,1134,1471,373,446,819,40,859
公投第１４案,新北市,板橋區,福德里,1135,1761,326,642,968,54,1022
公投第１４案,新北市,板橋區,景星里,1136,1499,308,509,817,51,868
公投第１４案,新北市,板橋區,景星里,1137,1528,300,492,792,42,834
公投第１４案,新北市,板橋區,福星里,1138,1536,327,546,873,47,920
公投第１４案,新北市,板橋區,福星里,1139,1550,308,558,866,35,901
公投第１４案,新北市,板橋區,鄉雲里,1140,2050,382,715,1097,78,1175
公投第１４案,新北市,板橋區,鄉雲里,1141,1300,491,246,737,37,774
公投第１４案,新北市,板橋區,廣德里,1142,1537,266,570,836,52,888
公投第１４案,新北市,板橋區,廣德里,1143,1341,267,415,682,23,705
公投第１４案,新北市,板橋區,廣德里,1144,1606,343,551,894,28,922
公投第１４案,新北市,板橋區,廣德里,1145,1433,263,463,726,33,759
公投第１４案,新北市,板橋區,大豐里,1146,1685,298,551,849,39,888
公投第１４案,新北市,板橋區,大豐里,1147,1248,250,479,729,45,774
公投第１４案,新北市,板橋區,大豐里,1148,1172,209,411,620,40,660
公投第１４案,新北市,板橋區,重慶里,1149,1640,290,504,794,30,824
公投第１４案,新北市,板橋區,重慶里,1150,1428,259,502,761,38,799
公投第１４案,新北市,板橋區,重慶里,1151,1527,296,527,823,62,885
公投第１４案,新北市,板橋區,重慶里,1152,1350,255,510,765,27,792
公投第１４案,新北市,板橋區,重慶里,1153,1582,264,575,839,56,895
公投第１４案,新北市,板橋區,仁愛里,1154,919,190,380,570,35,605
公投第１４案,新北市,板橋區,仁愛里,1155,930,191,332,523,22,545
公投第１４案,新北市,板橋區,仁愛里,1156,974,189,402,591,24,615
公投第１４案,新北市,板橋區,和平里,1157,1732,327,650,977,32,1009
公投第１４案,新北市,板橋區,和平里,1158,1438,275,478,753,56,809
公投第１４案,新北市,板橋區,廣福里,1159,1777,326,586,912,64,976
公投第１４案,新北市,板橋區,廣福里,1160,1764,287,552,839,44,883
公投第１４案,新北市,板橋區,五權里,1161,1289,225,482,707,23,730
公投第１４案,新北市,板橋區,五權里,1162,1182,225,432,657,37,694
公投第１４案,新北市,板橋區,五權里,1163,1174,219,434,653,55,708
公投第１４案,新北市,板橋區,華興里,1164,1870,358,568,926,83,1009
公投第１４案,新北市,板橋區,華興里,1165,1842,387,629,1016,58,1074
公投第１４案,新北市,板橋區,華貴里,1166,1094,195,397,592,45,637
公投第１４案,新北市,板橋區,華貴里,1167,1228,209,426,635,38,673
公投第１４案,新北市,板橋區,華福里,1168,998,214,404,618,46,664
公投第１４案,新北市,板橋區,華福里,1169,862,219,313,532,37,569
公投第１４案,新北市,板橋區,華德里,1170,1622,291,520,811,50,861
公投第１４案,新北市,板橋區,華德里,1171,1205,192,478,670,57,727
公投第１４案,新北市,板橋區,華德里,1172,1787,296,561,857,53,910
公投第１４案,新北市,板橋區,華德里,1173,1610,349,533,882,30,912
公投第１４案,新北市,板橋區,華東里,1174,2216,474,799,1273,38,1311
公投第１４案,新北市,板橋區,華東里,1175,2294,471,771,1242,42,1284
公投第１４案,新北市,板橋區,華東里,1176,2090,371,701,1072,64,1136
公投第１４案,新北市,板橋區,信義里,1177,1356,220,432,652,30,682
公投第１４案,新北市,板橋區,信義里,1178,1067,187,397,584,33,617
公投第１４案,新北市,板橋區,信義里,1179,1319,250,472,722,39,761
公投第１４案,新北市,板橋區,浮洲里,1180,1316,245,440,685,44,729
公投第１４案,新北市,板橋區,浮洲里,1181,1195,201,389,590,61,651
公投第１４案,新北市,板橋區,浮洲里,1182,857,165,302,467,23,490
公投第１４案,新北市,板橋區,華中里,1183,1417,251,460,711,63,774
公投第１４案,新北市,板橋區,華中里,1184,1560,220,620,840,64,904
公投第１４案,新北市,板橋區,華中里,1185,1747,337,587,924,76,1000
公投第１４案,新北市,板橋區,僑中里,1186,1176,237,464,701,43,744
公投第１４案,新北市,板橋區,僑中里,1187,1101,229,395,624,26,650
公投第１４案,新北市,板橋區,僑中里,1188,1458,316,508,824,24,848
公投第１４案,新北市,板橋區,大觀里,1189,1630,154,614,768,56,824
公投第１４案,新北市,板橋區,大觀里,1190,1611,300,490,790,100,890
公投第１４案,新北市,板橋區,歡園里,1191,1139,188,406,594,26,620
公投第１４案,新北市,板橋區,中山里,1192,1120,204,388,592,35,627
公投第１４案,新北市,板橋區,中山里,1193,1022,192,379,571,76,647
公投第１４案,新北市,板橋區,中山里,1194,1049,199,365,564,79,643
公投第１４案,新北市,板橋區,中山里,1195,1007,205,378,583,20,603
公投第１４案,新北市,板橋區,中山里,1196,1393,247,514,761,29,790
公投第１４案,新北市,板橋區,復興里,1197,474,56,114,170,30,200
公投第１４案,新北市,板橋區,復興里,1198,500,110,165,275,24,299
公投第１４案,新北市,板橋區,大安里,1199,1177,215,423,638,38,676
公投第１４案,新北市,板橋區,大安里,1200,1186,205,427,632,33,665
公投第１４案,新北市,板橋區,大安里,1201,1139,226,423,649,52,701
公投第１４案,新北市,板橋區,福安里,1202,1750,287,630,917,52,969
公投第１４案,新北市,板橋區,福安里,1203,3451,393,758,1151,33,1184
公投第１４案,新北市,板橋區,聚安里,1204,1620,277,516,793,70,863
公投第１４案,新北市,板橋區,聚安里,1205,903,161,270,431,24,455
公投第１４案,新北市,板橋區,聚安里,1206,1232,239,442,681,40,721
公投第１４案,新北市,板橋區,聚安里,1207,975,178,297,475,22,497
公投第１４案,新北市,板橋區,龍安里,1208,1224,220,419,639,34,673
公投第１４案,新北市,板橋區,龍安里,1209,1291,238,465,703,28,731
公投第１４案,新北市,板橋區,崑崙里,1210,1828,302,572,874,46,920
公投第１４案,新北市,板橋區,崑崙里,1211,1725,316,511,827,47,874
公投第１４案,新北市,板橋區,崑崙里,1212,1085,184,337,521,24,545
公投第１４案,新北市,板橋區,崑崙里,1213,2357,416,752,1168,53,1221
公投第１４案,新北市,板橋區,崑崙里,1214,1560,298,521,819,27,846
公投第１４案,新北市,板橋區,成和里,1215,2201,332,622,954,35,989
公投第１４案,新北市,板橋區,成和里,1216,1626,281,522,803,50,853
公投第１４案,新北市,板橋區,成和里,1217,1786,259,530,789,35,824
公投第１４案,新北市,板橋區,溪洲里,1218,1763,295,607,902,49,951
公投第１４案,新北市,板橋區,溪洲里,1219,1744,312,540,852,27,879
公投第１４案,新北市,板橋區,溪洲里,1220,1645,288,547,835,48,883
公投第１４案,新北市,板橋區,溪福里,1221,1861,303,584,887,40,927
公投第１４案,新北市,板橋區,溪福里,1222,1596,215,562,777,31,808
公投第１４案,新北市,板橋區,溪福里,1223,1871,325,638,963,45,1008
公投第１４案,新北市,板橋區,溪福里,1224,1938,361,652,1013,54,1067
公投第１４案,新北市,板橋區,溪福里,1225,1827,348,616,964,48,1012
公投第１４案,新北市,板橋區,溪福里,1226,1359,240,440,680,37,717
公投第１４案,新北市,板橋區,溪福里,1227,1613,279,570,849,43,892
公投第１４案,新北市,板橋區,溪北里,1228,1566,255,554,809,62,871
公投第１４案,新北市,板橋區,溪北里,1229,1552,341,556,897,46,943
公投第１４案,新北市,板橋區,堂春里,1230,1885,383,569,952,38,990
公投第１４案,新北市,板橋區,堂春里,1231,1893,334,619,953,53,1006
公投第１４案,新北市,中和區,中原里,1232,1630,286,507,793,51,844
公投第１４案,新北市,中和區,中原里,1233,1775,340,600,940,49,989
公投第１４案,新北市,中和區,中原里,1234,1844,317,596,913,27,940
公投第１４案,新北市,中和區,連和里,1235,1019,226,393,619,20,639
公投第１４案,新北市,中和區,連和里,1236,1138,215,457,672,22,694
公投第１４案,新北市,中和區,連城里,1237,1878,305,608,913,40,953
公投第１４案,新北市,中和區,連城里,1238,1980,301,784,1085,37,1122
公投第１４案,新北市,中和區,連城里,1239,1844,333,634,967,70,1037
公投第１４案,新北市,中和區,力行里,1240,2085,506,595,1101,37,1138
公投第１４案,新北市,中和區,力行里,1241,1498,231,559,790,43,833
公投第１４案,新北市,中和區,力行里,1242,1761,323,605,928,27,955
公投第１４案,新北市,中和區,正行里,1243,1254,262,396,658,40,698
公投第１４案,新北市,中和區,正行里,1244,1343,267,485,752,36,788
公投第１４案,新北市,中和區,德行里,1245,1789,380,584,964,34,998
公投第１４案,新北市,中和區,德行里,1246,2000,404,675,1079,37,1116
公投第１４案,新北市,中和區,德行里,1247,1953,382,551,933,35,968
公投第１４案,新北市,中和區,枋寮里,1248,1712,339,559,898,61,959
公投第１４案,新北市,中和區,枋寮里,1249,1582,278,585,863,45,908
公投第１４案,新北市,中和區,漳和里,1250,1742,321,582,903,55,958
公投第１４案,新北市,中和區,漳和里,1251,1493,294,583,877,49,926
公投第１４案,新北市,中和區,廟美里,1252,1352,257,421,678,47,725
公投第１４案,新北市,中和區,廟美里,1253,1244,210,491,701,40,741
公投第１４案,新北市,中和區,廟美里,1254,1394,204,496,700,56,756
公投第１４案,新北市,中和區,福真里,1255,1917,309,516,825,30,855
公投第１４案,新北市,中和區,福真里,1256,1830,315,579,894,63,957
公投第１４案,新北市,中和區,福善里,1257,1124,241,391,632,32,664
公投第１４案,新北市,中和區,福善里,1258,1412,252,421,673,48,721
公投第１４案,新北市,中和區,福善里,1259,1356,253,453,706,43,749
公投第１４案,新北市,中和區,福美里,1260,1425,205,503,708,37,745
公投第１４案,新北市,中和區,福美里,1261,1259,244,452,696,63,759
公投第１４案,新北市,中和區,福美里,1262,1256,229,446,675,60,735
公投第１４案,新北市,中和區,福祥里,1263,1423,253,505,758,44,802
公投第１４案,新北市,中和區,福祥里,1264,1221,242,454,696,45,741
公投第１４案,新北市,中和區,福祥里,1265,1858,315,575,890,48,938
公投第１４案,新北市,中和區,瓦磘里,1266,1804,308,590,898,48,946
公投第１４案,新北市,中和區,瓦磘里,1267,1669,336,582,918,42,960
公投第１４案,新北市,中和區,瓦磘里,1268,1485,252,531,783,54,837
公投第１４案,新北市,中和區,福和里,1269,1005,193,381,574,39,613
公投第１４案,新北市,中和區,福和里,1270,1175,259,445,704,49,753
公投第１４案,新北市,中和區,福和里,1271,1171,216,431,647,45,692
公投第１４案,新北市,中和區,佳和里,1272,1746,294,544,838,38,876
公投第１４案,新北市,中和區,佳和里,1273,1555,262,472,734,41,775
公投第１４案,新北市,中和區,佳和里,1274,1112,188,413,601,33,634
公投第１４案,新北市,中和區,新南里,1275,1780,363,648,1011,43,1054
公投第１４案,新北市,中和區,新南里,1276,1918,386,646,1032,27,1059
公投第１４案,新北市,中和區,新南里,1277,1689,269,474,743,25,768
公投第１４案,新北市,中和區,新南里,1278,1781,350,629,979,32,1011
公投第１４案,新北市,中和區,南山里,1279,1419,274,496,770,37,807
公投第１４案,新北市,中和區,南山里,1280,1344,230,463,693,33,726
公投第１４案,新北市,中和區,南山里,1281,1804,366,712,1078,46,1124
公投第１４案,新北市,中和區,平河里,1282,1788,337,556,893,68,961
公投第１４案,新北市,中和區,平河里,1283,1793,323,646,969,44,1013
公投第１４案,新北市,中和區,平河里,1284,1352,259,456,715,69,784
公投第１４案,新北市,中和區,平河里,1285,1813,444,625,1069,57,1126
公投第１４案,新北市,中和區,平河里,1286,1288,266,525,791,26,817
公投第１４案,新北市,中和區,信和里,1287,1186,229,409,638,39,677
公投第１４案,新北市,中和區,信和里,1288,1237,196,435,631,13,644
公投第１４案,新北市,中和區,信和里,1289,1406,252,484,736,52,788
公投第１４案,新北市,中和區,仁和里,1290,1442,272,485,757,51,808
公投第１４案,新北市,中和區,仁和里,1291,1040,229,382,611,42,653
公投第１４案,新北市,中和區,仁和里,1292,1292,232,509,741,44,785
公投第１４案,新北市,中和區,中正里,1293,1811,302,630,932,54,986
公投第１４案,新北市,中和區,中正里,1294,1789,338,593,931,70,1001
公投第１４案,新北市,中和區,建和里,1295,859,167,367,534,29,563
公投第１４案,新北市,中和區,建和里,1296,972,154,452,606,21,627
公投第１４案,新北市,中和區,建和里,1297,1346,231,496,727,40,767
公投第１４案,新北市,中和區,中山里,1298,1034,207,357,564,30,594
公投第１４案,新北市,中和區,中山里,1299,1387,255,514,769,34,803
公投第１４案,新北市,中和區,碧河里,1300,2067,371,737,1108,66,1174
公投第１４案,新北市,中和區,碧河里,1301,1670,261,497,758,48,806
公投第１４案,新北市,中和區,正南里,1302,1166,202,428,630,42,672
公投第１４案,新北市,中和區,正南里,1303,963,155,381,536,38,574
公投第１４案,新北市,中和區,正南里,1304,1070,159,373,532,40,572
公投第１４案,新北市,中和區,頂南里,1305,1319,228,480,708,41,749
公投第１４案,新北市,中和區,頂南里,1306,1438,257,559,816,67,883
公投第１４案,新北市,中和區,華新里,1307,1808,300,592,892,34,926
公投第１４案,新北市,中和區,華新里,1308,1191,170,444,614,20,634
公投第１４案,新北市,中和區,華新里,1309,1632,278,567,845,63,908
公投第１４案,新北市,中和區,華新里,1310,1765,267,602,869,34,903
公投第１４案,新北市,中和區,東南里,1311,1168,190,468,658,26,684
公投第１４案,新北市,中和區,東南里,1312,1176,190,452,642,18,660
公投第１４案,新北市,中和區,東南里,1313,1565,262,681,943,53,996
公投第１４案,新北市,中和區,華南里,1314,1578,253,512,765,45,810
公投第１４案,新北市,中和區,華南里,1315,2029,364,708,1072,28,1100
公投第１４案,新北市,中和區,華南里,1316,905,163,335,498,23,521
公投第１４案,新北市,中和區,忠孝里,1317,839,113,306,419,24,443
公投第１４案,新北市,中和區,忠孝里,1318,762,134,285,419,25,444
公投第１４案,新北市,中和區,忠孝里,1319,1420,237,531,768,53,821
公投第１４案,新北市,中和區,忠孝里,1320,1272,201,445,646,52,698
公投第１４案,新北市,中和區,崇南里,1321,1976,342,659,1001,50,1051
公投第１４案,新北市,中和區,崇南里,1322,1779,287,660,947,22,969
公投第１４案,新北市,中和區,興南里,1323,1454,229,455,684,37,721
公投第１４案,新北市,中和區,興南里,1324,1374,179,513,692,39,731
公投第１４案,新北市,中和區,景南里,1325,1369,218,430,648,49,697
公投第１４案,新北市,中和區,景南里,1326,1501,297,472,769,52,821
公投第１４案,新北市,中和區,景本里,1327,920,171,377,548,54,602
公投第１４案,新北市,中和區,景本里,1328,1050,199,402,601,48,649
公投第１４案,新北市,中和區,橫路里,1329,321,64,119,183,14,197
公投第１４案,新北市,中和區,內南里,1330,1474,237,490,727,61,788
公投第１４案,新北市,中和區,內南里,1331,1461,253,516,769,74,843
公投第１４案,新北市,中和區,內南里,1332,1621,260,563,823,42,865
公投第１４案,新北市,中和區,壽南里,1333,1327,259,520,779,54,833
公投第１４案,新北市,中和區,壽南里,1334,775,147,283,430,21,451
公投第１４案,新北市,中和區,福南里,1335,1916,352,597,949,69,1018
公投第１４案,新北市,中和區,福南里,1336,1901,310,613,923,63,986
公投第１４案,新北市,中和區,外南里,1337,4411,241,519,760,35,795
公投第１４案,新北市,中和區,外南里,1338,1212,217,427,644,37,681
公投第１４案,新北市,中和區,外南里,1339,1126,204,424,628,22,650
公投第１４案,新北市,中和區,中興里,1340,1507,270,506,776,27,803
公投第１４案,新北市,中和區,中興里,1341,1519,293,526,819,22,841
公投第１４案,新北市,中和區,中興里,1342,1467,294,520,814,32,846
公投第１４案,新北市,中和區,中興里,1343,1453,266,564,830,58,888
公投第１４案,新北市,中和區,吉興里,1344,1364,260,528,788,35,823
公投第１４案,新北市,中和區,吉興里,1345,1302,237,462,699,36,735
公投第１４案,新北市,中和區,復興里,1346,1627,249,473,722,28,750
公投第１４案,新北市,中和區,復興里,1347,1503,253,527,780,30,810
公投第１４案,新北市,中和區,復興里,1348,1392,212,509,721,24,745
公投第１４案,新北市,中和區,和興里,1349,1067,196,416,612,26,638
公投第１４案,新北市,中和區,和興里,1350,1623,261,553,814,45,859
公投第１４案,新北市,中和區,和興里,1351,1208,254,428,682,27,709
公投第１４案,新北市,中和區,景平里,1352,1991,260,590,850,38,888
公投第１４案,新北市,中和區,景平里,1353,1932,296,577,873,36,909
公投第１４案,新北市,中和區,景平里,1354,947,222,392,614,16,630
公投第１４案,新北市,中和區,景新里,1355,1660,292,620,912,51,963
公投第１４案,新北市,中和區,景新里,1356,1574,242,504,746,44,790
公投第１４案,新北市,中和區,景福里,1357,2136,360,677,1037,48,1085
公投第１４案,新北市,中和區,景福里,1358,1462,256,478,734,48,782
公投第１４案,新北市,中和區,景福里,1359,1548,242,512,754,59,813
公投第１４案,新北市,中和區,景安里,1360,692,139,297,436,21,457
公投第１４案,新北市,中和區,景安里,1361,1221,224,504,728,40,768
公投第１４案,新北市,中和區,景安里,1362,1331,267,506,773,46,819
公投第１４案,新北市,中和區,景安里,1363,984,190,396,586,37,623
公投第１４案,新北市,中和區,景文里,1364,1871,296,608,904,36,940
公投第１４案,新北市,中和區,景文里,1365,1279,203,476,679,30,709
公投第１４案,新北市,中和區,錦和里,1366,1629,302,574,876,49,925
公投第１４案,新北市,中和區,錦和里,1367,1482,300,509,809,36,845
公投第１４案,新北市,中和區,錦和里,1368,1715,310,644,954,45,999
公投第１４案,新北市,中和區,錦昌里,1369,1952,329,712,1041,51,1092
公投第１４案,新北市,中和區,灰磘里,1370,686,124,249,373,28,401
公投第１４案,新北市,中和區,積穗里,1371,1577,231,471,702,36,738
公投第１４案,新北市,中和區,積穗里,1372,1158,161,467,628,33,661
公投第１４案,新北市,中和區,積穗里,1373,1195,256,484,740,19,759
公投第１４案,新北市,中和區,積穗里,1374,1054,231,416,647,28,675
公投第１４案,新北市,中和區,積穗里,1375,612,136,242,378,18,396
公投第１４案,新北市,中和區,積穗里,1376,1668,294,632,926,31,957
公投第１４案,新北市,中和區,民享里,1377,1071,208,435,643,48,691
公投第１４案,新北市,中和區,民享里,1378,1169,262,489,751,50,801
公投第１４案,新北市,中和區,員山里,1379,1370,239,482,721,33,754
公投第１４案,新北市,中和區,員山里,1380,1574,295,587,882,64,946
公投第１４案,新北市,中和區,員山里,1381,2614,389,763,1152,28,1180
公投第１４案,新北市,中和區,嘉穗里,1382,1477,261,583,844,37,881
公投第１４案,新北市,中和區,嘉穗里,1383,1041,218,348,566,46,612
公投第１４案,新北市,中和區,文元里,1384,1538,265,491,756,56,812
公投第１４案,新北市,中和區,文元里,1385,1599,306,523,829,48,877
公投第１４案,新北市,中和區,文元里,1386,1586,299,572,871,67,938
公投第１４案,新北市,中和區,嘉新里,1387,1726,324,668,992,53,1045
公投第１４案,新北市,中和區,嘉新里,1388,1854,391,668,1059,74,1133
公投第１４案,新北市,中和區,民安里,1389,1472,280,547,827,56,883
公投第１４案,新北市,中和區,民安里,1390,1430,278,544,822,52,874
公投第１４案,新北市,中和區,民安里,1391,1488,305,549,854,47,901
公投第１４案,新北市,中和區,安穗里,1392,1251,245,417,662,31,693
公投第１４案,新北市,中和區,安穗里,1393,1487,279,542,821,41,862
公投第１４案,新北市,中和區,安穗里,1394,1328,347,326,673,70,743
公投第１４案,新北市,中和區,瑞穗里,1395,1128,243,417,660,38,698
公投第１４案,新北市,中和區,瑞穗里,1396,1008,184,445,629,32,661
公投第１４案,新北市,中和區,明穗里,1397,1786,355,642,997,34,1031
公投第１４案,新北市,中和區,明穗里,1398,2219,384,758,1142,54,1196
公投第１４案,新北市,中和區,清穗里,1399,1322,210,453,663,32,695
公投第１４案,新北市,中和區,清穗里,1400,1495,271,515,786,18,804
公投第１４案,新北市,中和區,自強里,1401,1414,259,480,739,44,783
公投第１４案,新北市,中和區,自強里,1402,1681,256,655,911,58,969
公投第１４案,新北市,中和區,自強里,1403,1361,256,474,730,43,773
公投第１４案,新北市,中和區,德穗里,1404,1442,255,500,755,49,804
公投第１４案,新北市,中和區,德穗里,1405,1383,262,466,728,28,756
公投第１４案,新北市,中和區,德穗里,1406,1264,224,468,692,35,727
公投第１４案,新北市,中和區,民生里,1407,1810,317,682,999,83,1082
公投第１４案,新北市,中和區,民生里,1408,1951,328,594,922,38,960
公投第１４案,新北市,中和區,國光里,1409,1582,260,506,766,37,803
公投第１４案,新北市,中和區,國光里,1410,1945,354,741,1095,57,1152
公投第１４案,新北市,中和區,壽德里,1411,1390,235,532,767,40,807
公投第１４案,新北市,中和區,壽德里,1412,1161,224,420,644,24,668
公投第１４案,新北市,中和區,壽德里,1413,1399,191,568,759,32,791
公投第１４案,新北市,中和區,明德里,1414,1070,167,400,567,41,608
公投第１４案,新北市,中和區,明德里,1415,1169,184,434,618,26,644
公投第１４案,新北市,中和區,明德里,1416,1214,211,504,715,54,769
公投第１４案,新北市,中和區,錦中里,1417,1398,275,510,785,47,832
公投第１４案,新北市,中和區,錦中里,1418,1049,193,391,584,34,618
公投第１４案,新北市,中和區,錦中里,1419,1324,267,521,788,41,829
公投第１４案,新北市,中和區,錦盛里,1420,1765,296,526,822,26,848
公投第１４案,新北市,中和區,錦盛里,1421,1709,278,557,835,54,889
公投第１４案,新北市,中和區,民有里,1422,1186,183,453,636,60,696
公投第１４案,新北市,中和區,民有里,1423,1318,224,511,735,48,783
公投第１４案,新北市,中和區,員富里,1424,1430,307,494,801,39,840
公投第１４案,新北市,中和區,員富里,1425,1637,255,424,679,46,725
公投第１４案,新北市,中和區,嘉慶里,1426,1283,253,437,690,45,735
公投第１４案,新北市,中和區,嘉慶里,1427,1310,244,450,694,39,733
公投第１４案,新北市,中和區,嘉慶里,1428,1301,260,453,713,43,756
公投第１４案,新北市,中和區,冠穗里,1429,1681,339,562,901,64,965
公投第１４案,新北市,中和區,冠穗里,1430,1384,280,500,780,35,815
公投第１４案,新北市,中和區,國華里,1431,1187,242,410,652,34,686
公投第１４案,新北市,中和區,國華里,1432,1779,287,497,784,6,790
公投第１４案,新北市,中和區,宜安里,1433,1712,298,636,934,39,973
公投第１４案,新北市,中和區,安樂里,1434,1462,284,476,760,43,803
公投第１４案,新北市,中和區,安樂里,1435,1824,323,616,939,28,967
公投第１４案,新北市,中和區,安和里,1436,1389,272,475,747,38,785
公投第１４案,新北市,中和區,安和里,1437,1434,289,525,814,31,845
公投第１４案,新北市,中和區,安順里,1438,1953,303,692,995,60,1055
公投第１４案,新北市,中和區,安順里,1439,2002,398,676,1074,52,1126
公投第１４案,新北市,中和區,安平里,1440,1858,306,670,976,24,1000
公投第１４案,新北市,中和區,安平里,1441,1801,346,583,929,26,955
公投第１４案,新北市,中和區,安平里,1442,1691,301,629,930,46,976
公投第１４案,新北市,中和區,中安里,1443,1363,282,503,785,28,813
公投第１４案,新北市,中和區,中安里,1444,1220,249,488,737,27,764
公投第１４案,新北市,中和區,中安里,1445,1365,284,559,843,23,866
公投第１４案,新北市,中和區,泰安里,1446,1178,204,453,657,26,683
公投第１４案,新北市,中和區,泰安里,1447,830,161,312,473,33,506
公投第１４案,新北市,中和區,泰安里,1448,1197,208,367,575,55,630
公投第１４案,新北市,中和區,秀山里,1449,1369,231,523,754,48,802
公投第１４案,新北市,中和區,秀山里,1450,1336,242,506,748,53,801
公投第１４案,新北市,中和區,秀山里,1451,1377,257,555,812,51,863
公投第１４案,新北市,中和區,秀成里,1452,1499,277,552,829,54,883
公投第１４案,新北市,中和區,秀成里,1453,1689,325,628,953,43,996
公投第１４案,新北市,中和區,秀義里,1454,1323,263,481,744,53,797
公投第１４案,新北市,中和區,秀義里,1455,1079,219,428,647,34,681
公投第１４案,新北市,中和區,秀福里,1456,1545,301,556,857,48,905
公投第１４案,新北市,中和區,秀福里,1457,1326,263,426,689,52,741
公投第１４案,新北市,中和區,秀福里,1458,1443,273,494,767,32,799
公投第１４案,新北市,中和區,秀景里,1459,1712,301,621,922,32,954
公投第１４案,新北市,中和區,秀景里,1460,1916,317,668,985,58,1043
公投第１４案,新北市,中和區,秀景里,1461,863,167,340,507,34,541
公投第１４案,新北市,中和區,秀景里,1462,1203,260,468,728,8,736
公投第１４案,新北市,中和區,秀明里,1463,1483,275,511,786,12,798
公投第１４案,新北市,中和區,秀明里,1464,1575,258,560,818,25,843
公投第１４案,新北市,中和區,秀明里,1465,1432,201,476,677,43,720
公投第１４案,新北市,中和區,秀峰里,1466,1441,264,496,760,48,808
公投第１４案,新北市,中和區,秀峰里,1467,1269,245,468,713,43,756
公投第１４案,新北市,中和區,秀峰里,1468,1363,250,525,775,32,807
公投第１４案,新北市,中和區,秀士里,1469,1089,176,437,613,23,636
公投第１４案,新北市,中和區,秀士里,1470,1171,223,379,602,25,627
公投第１４案,新北市,中和區,秀水里,1471,1150,205,424,629,43,672
公投第１４案,新北市,中和區,秀水里,1472,1154,224,465,689,26,715
公投第１４案,新北市,中和區,秀水里,1473,1067,180,450,630,33,663
公投第１４案,新北市,中和區,秀仁里,1474,1526,333,524,857,40,897
公投第１４案,新北市,中和區,秀仁里,1475,1447,290,523,813,30,843
公投第１４案,新北市,永和區,光復里,1476,1554,318,541,859,60,919
公投第１４案,新北市,永和區,網溪里,1477,1065,178,432,610,20,630
公投第１４案,新北市,永和區,復興里,1478,854,166,353,519,23,542
公投第１４案,新北市,永和區,復興里,1479,1253,239,485,724,35,759
公投第１４案,新北市,永和區,竹林里,1480,1733,362,584,946,31,977
公投第１４案,新北市,永和區,竹林里,1481,1581,304,546,850,46,896
公投第１４案,新北市,永和區,桂林里,1482,1735,296,616,912,40,952
公投第１４案,新北市,永和區,桂林里,1483,1563,267,556,823,26,849
公投第１４案,新北市,永和區,上林里,1484,1650,340,614,954,50,1004
公投第１４案,新北市,永和區,上林里,1485,1454,254,551,805,28,833
公投第１４案,新北市,永和區,福林里,1486,1568,305,484,789,41,830
公投第１４案,新北市,永和區,福林里,1487,1444,264,502,766,35,801
公投第１４案,新北市,永和區,勵行里,1488,1140,219,375,594,43,637
公投第１４案,新北市,永和區,中興里,1489,1188,227,473,700,38,738
公投第１４案,新北市,永和區,中興里,1490,1516,272,521,793,59,852
公投第１４案,新北市,永和區,永興里,1491,1397,254,480,734,43,777
公投第１４案,新北市,永和區,永興里,1492,1438,287,500,787,28,815
公投第１４案,新北市,永和區,正興里,1493,1084,204,428,632,21,653
公投第１４案,新北市,永和區,正興里,1494,941,178,350,528,26,554
公投第１４案,新北市,永和區,豫溪里,1495,1598,312,533,845,28,873
公投第１４案,新北市,永和區,豫溪里,1496,2842,316,522,838,26,864
公投第１４案,新北市,永和區,光明里,1497,1261,267,480,747,43,790
公投第１４案,新北市,永和區,光明里,1498,1449,317,575,892,36,928
公投第１４案,新北市,永和區,福和里,1499,1511,281,564,845,40,885
公投第１４案,新北市,永和區,福和里,1500,1470,300,591,891,37,928
公投第１４案,新北市,永和區,福和里,1501,1580,294,580,874,37,911
公投第１４案,新北市,永和區,得和里,1502,1438,282,594,876,29,905
公投第１４案,新北市,永和區,得和里,1503,1305,259,538,797,30,827
公投第１４案,新北市,永和區,得和里,1504,1046,195,437,632,19,651
公投第１４案,新北市,永和區,永貞里,1505,1566,320,571,891,20,911
公投第１４案,新北市,永和區,永貞里,1506,1468,309,517,826,35,861
公投第１４案,新北市,永和區,永福里,1507,1305,289,523,812,40,852
公投第１４案,新北市,永和區,永福里,1508,1181,225,473,698,34,732
公投第１４案,新北市,永和區,河濱里,1509,1720,346,557,903,41,944
公投第１４案,新北市,永和區,河濱里,1510,1103,264,411,675,22,697
公投第１４案,新北市,永和區,秀和里,1511,1649,335,568,903,68,971
公投第１４案,新北市,永和區,秀和里,1512,1206,269,456,725,29,754
公投第１４案,新北市,永和區,秀和里,1513,1506,337,539,876,35,911
公投第１４案,新北市,永和區,永元里,1514,1488,289,536,825,41,866
公投第１４案,新北市,永和區,永元里,1515,1288,259,498,757,48,805
公投第１４案,新北市,永和區,永元里,1516,1413,269,455,724,37,761
公投第１４案,新北市,永和區,民權里,1517,1329,213,520,733,43,776
公投第１４案,新北市,永和區,民權里,1518,1436,80,779,859,31,890
公投第１４案,新北市,永和區,民權里,1519,1112,206,418,624,41,665
公投第１４案,新北市,永和區,民族里,1520,1100,236,476,712,32,744
公投第１４案,新北市,永和區,民族里,1521,1545,318,605,923,39,962
公投第１４案,新北市,永和區,民族里,1522,1436,243,554,797,23,820
公投第１４案,新北市,永和區,秀朗里,1523,1731,340,678,1018,60,1078
公投第１４案,新北市,永和區,秀朗里,1524,1762,375,658,1033,57,1090
公投第１４案,新北市,永和區,秀成里,1525,1320,247,462,709,39,748
公投第１４案,新北市,永和區,秀成里,1526,1297,222,403,625,19,644
公投第１４案,新北市,永和區,秀林里,1527,1798,354,595,949,49,998
公投第１４案,新北市,永和區,秀林里,1528,1491,310,558,868,44,912
公投第１４案,新北市,永和區,秀得里,1529,1223,229,458,687,20,707
公投第１４案,新北市,永和區,秀得里,1530,1108,204,428,632,36,668
公投第１４案,新北市,永和區,秀元里,1531,1408,287,531,818,42,860
公投第１４案,新北市,永和區,秀元里,1532,1265,240,492,732,39,771
公投第１４案,新北市,永和區,民生里,1533,1115,213,397,610,17,627
公投第１４案,新北市,永和區,民生里,1534,1133,234,450,684,45,729
公投第１４案,新北市,永和區,民生里,1535,1217,224,461,685,53,738
公投第１４案,新北市,永和區,民本里,1536,1713,312,615,927,42,969
公投第１４案,新北市,永和區,民本里,1537,1721,330,582,912,35,947
公投第１４案,新北市,永和區,民富里,1538,1327,239,475,714,39,753
公投第１４案,新北市,永和區,民富里,1539,1257,253,506,759,25,784
公投第１４案,新北市,永和區,民樂里,1540,1348,269,549,818,34,852
公投第１４案,新北市,永和區,民樂里,1541,1461,305,593,898,27,925
公投第１４案,新北市,永和區,民樂里,1542,1368,257,509,766,51,817
公投第１４案,新北市,永和區,民治里,1543,1234,219,451,670,62,732
公投第１４案,新北市,永和區,民治里,1544,1303,266,458,724,43,767
公投第１４案,新北市,永和區,智光里,1545,1516,269,557,826,28,854
公投第１４案,新北市,永和區,智光里,1546,1422,256,559,815,59,874
公投第１４案,新北市,永和區,潭安里,1547,991,199,393,592,20,612
公投第１４案,新北市,永和區,潭安里,1548,1016,206,413,619,22,641
公投第１４案,新北市,永和區,潭安里,1549,1146,205,453,658,36,694
公投第１４案,新北市,永和區,潭安里,1550,1043,158,456,614,21,635
公投第１４案,新北市,永和區,潭墘里,1551,1210,255,469,724,18,742
公投第１４案,新北市,永和區,潭墘里,1552,1630,309,619,928,23,951
公投第１４案,新北市,永和區,潭墘里,1553,1092,216,426,642,20,662
公投第１４案,新北市,永和區,店街里,1554,1872,362,694,1056,53,1109
公投第１４案,新北市,永和區,店街里,1555,1781,338,654,992,27,1019
公投第１４案,新北市,永和區,大新里,1556,1049,213,405,618,32,650
公投第１４案,新北市,永和區,大新里,1557,1285,266,515,781,32,813
公投第１４案,新北市,永和區,永安里,1558,1209,263,463,726,26,752
公投第１４案,新北市,永和區,永安里,1559,1132,249,439,688,25,713
公投第１４案,新北市,永和區,永安里,1560,1287,262,518,780,35,815
公投第１４案,新北市,永和區,永樂里,1561,1068,226,410,636,36,672
公投第１４案,新北市,永和區,永樂里,1562,1098,240,421,661,38,699
公投第１４案,新北市,永和區,水源里,1563,1222,219,518,737,28,765
公投第１４案,新北市,永和區,水源里,1564,1157,218,447,665,48,713
公投第１４案,新北市,永和區,水源里,1565,1168,297,436,733,35,768
公投第１４案,新北市,永和區,協和里,1566,1283,259,455,714,38,752
公投第１４案,新北市,永和區,協和里,1567,1372,248,517,765,39,804
公投第１４案,新北市,永和區,雙和里,1568,1876,373,715,1088,47,1135
公投第１４案,新北市,永和區,雙和里,1569,1576,297,643,940,63,1003
公投第１４案,新北市,永和區,安和里,1570,1661,316,636,952,36,988
公投第１４案,新北市,永和區,安和里,1571,1808,327,675,1002,29,1031
公投第１４案,新北市,永和區,前溪里,1572,1898,374,662,1036,49,1085
公投第１４案,新北市,永和區,和平里,1573,1508,320,580,900,31,931
公投第１４案,新北市,永和區,和平里,1574,1341,251,522,773,54,827
公投第１４案,新北市,永和區,和平里,1575,1422,262,505,767,56,823
公投第１４案,新北市,永和區,保平里,1576,1177,225,429,654,37,691
公投第１４案,新北市,永和區,保平里,1577,1557,299,572,871,52,923
公投第１４案,新北市,永和區,保平里,1578,1491,277,511,788,38,826
公投第１４案,新北市,永和區,中溪里,1579,1586,301,569,870,39,909
公投第１４案,新北市,永和區,中溪里,1580,1313,237,452,689,21,710
公投第１４案,新北市,永和區,中溪里,1581,1636,331,557,888,54,942
公投第１４案,新北市,永和區,保安里,1582,1598,321,558,879,43,922
公投第１４案,新北市,永和區,保安里,1583,1609,351,581,932,41,973
公投第１４案,新北市,永和區,保安里,1584,1375,307,513,820,32,852
公投第１４案,新北市,永和區,保安里,1585,1648,370,632,1002,36,1038
公投第１４案,新北市,永和區,保順里,1586,1077,229,395,624,28,652
公投第１４案,新北市,永和區,保順里,1587,1157,235,449,684,19,703
公投第１４案,新北市,永和區,保順里,1588,1339,308,519,827,26,853
公投第１４案,新北市,永和區,保順里,1589,1306,267,517,784,22,806
公投第１４案,新北市,永和區,保順里,1590,1236,257,509,766,14,780
公投第１４案,新北市,永和區,保順里,1591,1133,236,450,686,18,704
公投第１４案,新北市,永和區,保順里,1592,1425,285,552,837,30,867
公投第１４案,新北市,永和區,下溪里,1593,1938,354,696,1050,68,1118
公投第１４案,新北市,永和區,下溪里,1594,1607,325,588,913,46,959
公投第１４案,新北市,永和區,大同里,1595,853,133,370,503,22,525
公投第１４案,新北市,永和區,新生里,1596,768,114,275,389,40,429
公投第１４案,新北市,永和區,永成里,1597,893,117,300,417,24,441
公投第１４案,新北市,永和區,忠義里,1598,743,123,282,405,31,436
公投第１４案,新北市,永和區,仁愛里,1599,1155,232,457,689,31,720
公投第１４案,新北市,永和區,仁愛里,1600,1263,266,492,758,31,789
公投第１４案,新北市,永和區,文化里,1601,1189,246,467,713,26,739
公投第１４案,新北市,永和區,文化里,1602,1346,218,500,718,43,761
公投第１４案,新北市,永和區,信義里,1603,1368,250,492,742,36,778
公投第１４案,新北市,永和區,信義里,1604,1043,206,395,601,15,616
公投第１４案,新北市,永和區,後溪里,1605,1709,350,644,994,36,1030
公投第１４案,新北市,永和區,上溪里,1606,879,169,300,469,13,482
公投第１４案,新北市,永和區,上溪里,1607,904,197,316,513,28,541
公投第１４案,新北市,永和區,頂溪里,1608,1221,236,494,730,38,768
公投第１４案,新北市,永和區,頂溪里,1609,1018,198,402,600,36,636
公投第１４案,新北市,永和區,河堤里,1610,1551,214,636,850,38,888
公投第１４案,新北市,永和區,河堤里,1611,1428,288,535,823,36,859
公投第１４案,新北市,永和區,新廍里,1612,1044,215,399,614,39,653
公投第１４案,新北市,永和區,新廍里,1613,967,202,368,570,39,609
公投第１４案,新北市,樹林區,三興里,1614,1408,240,451,691,50,741
公投第１４案,新北市,樹林區,三興里,1615,1310,228,451,679,26,705
公投第１４案,新北市,樹林區,三興里,1616,1534,239,471,710,49,759
公投第１４案,新北市,樹林區,三福里,1617,1211,183,445,628,45,673
公投第１４案,新北市,樹林區,三福里,1618,1125,206,414,620,41,661
公投第１４案,新北市,樹林區,三福里,1619,1134,187,462,649,34,683
公投第１４案,新北市,樹林區,三多里,1620,1897,295,521,816,77,893
公投第１４案,新北市,樹林區,三多里,1621,1716,324,536,860,53,913
公投第１４案,新北市,樹林區,三龍里,1622,736,151,272,423,35,458
公投第１４案,新北市,樹林區,三龍里,1623,1137,240,437,677,20,697
公投第１４案,新北市,樹林區,獇寮里,1624,1542,289,483,772,37,809
公投第１４案,新北市,樹林區,獇寮里,1625,1470,271,488,759,54,813
公投第１４案,新北市,樹林區,獇寮里,1626,1456,270,422,692,23,715
公投第１４案,新北市,樹林區,光興里,1627,1124,217,401,618,24,642
公投第１４案,新北市,樹林區,光興里,1628,1235,210,420,630,25,655
公投第１４案,新北市,樹林區,光興里,1629,1212,232,426,658,20,678
公投第１４案,新北市,樹林區,金寮里,1630,1223,186,390,576,41,617
公投第１４案,新北市,樹林區,金寮里,1631,1335,216,459,675,59,734
公投第１４案,新北市,樹林區,金寮里,1632,1206,232,398,630,34,664
公投第１４案,新北市,樹林區,潭底里,1633,1927,229,427,656,54,710
公投第１４案,新北市,樹林區,潭底里,1634,914,161,318,479,44,523
公投第１４案,新北市,樹林區,潭底里,1635,1456,276,512,788,46,834
公投第１４案,新北市,樹林區,文林里,1636,1409,236,429,665,47,712
公投第１４案,新北市,樹林區,文林里,1637,1500,278,557,835,66,901
公投第１４案,新北市,樹林區,文林里,1638,1545,309,501,810,55,865
公投第１４案,新北市,樹林區,保安里,1639,1483,283,493,776,30,806
公投第１４案,新北市,樹林區,保安里,1640,1524,277,523,800,30,830
公投第１４案,新北市,樹林區,保安里,1641,1431,290,473,763,38,801
公投第１４案,新北市,樹林區,保安里,1642,1181,212,404,616,40,656
公投第１４案,新北市,樹林區,圳安里,1643,1116,190,416,606,45,651
公投第１４案,新北市,樹林區,圳安里,1644,1077,186,347,533,32,565
公投第１４案,新北市,樹林區,圳安里,1645,1103,190,356,546,21,567
公投第１４案,新北市,樹林區,圳福里,1646,1385,258,468,726,50,776
公投第１４案,新北市,樹林區,圳福里,1647,1266,117,522,639,32,671
公投第１４案,新北市,樹林區,圳福里,1648,1195,220,395,615,39,654
公投第１４案,新北市,樹林區,圳民里,1649,1254,238,400,638,47,685
公投第１４案,新北市,樹林區,圳民里,1650,1263,274,428,702,29,731
公投第１４案,新北市,樹林區,圳生里,1651,1473,304,529,833,69,902
公投第１４案,新北市,樹林區,樹德里,1652,870,142,333,475,26,501
公投第１４案,新北市,樹林區,樹德里,1653,1338,246,520,766,53,819
公投第１４案,新北市,樹林區,樹德里,1654,1010,174,331,505,41,546
公投第１４案,新北市,樹林區,樹福里,1655,1658,348,559,907,71,978
公投第１４案,新北市,樹林區,樹福里,1656,1538,345,547,892,58,950
公投第１４案,新北市,樹林區,樹西里,1657,1405,304,515,819,62,881
公投第１４案,新北市,樹林區,樹西里,1658,1587,292,540,832,55,887
公投第１４案,新北市,樹林區,樹西里,1659,1566,335,516,851,34,885
公投第１４案,新北市,樹林區,樹興里,1660,997,178,343,521,14,535
公投第１４案,新北市,樹林區,樹興里,1661,1187,233,393,626,55,681
公投第１４案,新北市,樹林區,樹興里,1662,1061,188,346,534,46,580
公投第１４案,新北市,樹林區,樹人里,1663,1701,281,654,935,36,971
公投第１４案,新北市,樹林區,樹人里,1664,1278,217,469,686,39,725
公投第１４案,新北市,樹林區,育英里,1665,1433,492,521,1013,53,1066
公投第１４案,新北市,樹林區,育英里,1666,1306,266,481,747,50,797
公投第１４案,新北市,樹林區,樹南里,1667,1268,262,459,721,58,779
公投第１４案,新北市,樹林區,樹南里,1668,1281,244,470,714,31,745
公投第１４案,新北市,樹林區,樹南里,1669,1200,245,428,673,42,715
公投第１４案,新北市,樹林區,坡內里,1670,1491,238,513,751,41,792
公投第１４案,新北市,樹林區,樹東里,1671,1066,186,376,562,22,584
公投第１４案,新北市,樹林區,樹北里,1672,877,160,335,495,60,555
公投第１４案,新北市,樹林區,彭福里,1673,1616,270,563,833,45,878
公投第１４案,新北市,樹林區,彭福里,1674,1589,246,456,702,57,759
公投第１４案,新北市,樹林區,彭福里,1675,1367,238,511,749,48,797
公投第１４案,新北市,樹林區,和平里,1676,1144,205,452,657,31,688
公投第１４案,新北市,樹林區,和平里,1677,1059,252,288,540,30,570
公投第１４案,新北市,樹林區,和平里,1678,1224,226,393,619,58,677
公投第１４案,新北市,樹林區,彭興里,1679,1141,222,317,539,34,573
公投第１４案,新北市,樹林區,彭興里,1680,1396,216,407,623,18,641
公投第１４案,新北市,樹林區,彭興里,1681,1157,251,350,601,35,636
公投第１４案,新北市,樹林區,彭興里,1682,1498,246,460,706,67,773
公投第１４案,新北市,樹林區,彭厝里,1683,1514,251,532,783,53,836
公投第１４案,新北市,樹林區,彭厝里,1684,1546,249,505,754,27,781
公投第１４案,新北市,樹林區,彭厝里,1685,1392,267,461,728,48,776
公投第１４案,新北市,樹林區,大同里,1686,1566,271,565,836,35,871
公投第１４案,新北市,樹林區,大同里,1687,1566,294,537,831,30,861
公投第１４案,新北市,樹林區,中華里,1688,1517,285,495,780,49,829
公投第１４案,新北市,樹林區,中華里,1689,1481,284,513,797,29,826
公投第１４案,新北市,樹林區,太順里,1690,1261,199,450,649,38,687
公投第１４案,新北市,樹林區,太順里,1691,1163,187,398,585,30,615
公投第１４案,新北市,樹林區,東昇里,1692,1661,320,601,921,71,992
公投第１４案,新北市,樹林區,東昇里,1693,1585,323,542,865,36,901
公投第１４案,新北市,樹林區,東昇里,1694,1018,190,388,578,37,615
公投第１４案,新北市,樹林區,東陽里,1695,1247,215,431,646,55,701
公投第１４案,新北市,樹林區,東陽里,1696,1390,219,475,694,61,755
公投第１４案,新北市,樹林區,東陽里,1697,1293,227,482,709,37,746
公投第１４案,新北市,樹林區,東陽里,1698,1301,217,447,664,26,690
公投第１４案,新北市,樹林區,東山里,1699,1606,299,510,809,46,855
公投第１４案,新北市,樹林區,東山里,1700,1277,206,432,638,68,706
公投第１４案,新北市,樹林區,山佳里,1701,1219,240,403,643,54,697
公投第１４案,新北市,樹林區,山佳里,1702,1454,234,485,719,36,755
公投第１４案,新北市,樹林區,山佳里,1703,1314,196,475,671,31,702
公投第１４案,新北市,樹林區,山佳里,1704,1008,189,428,617,24,641
公投第１４案,新北市,樹林區,中山里,1705,1574,279,516,795,54,849
公投第１４案,新北市,樹林區,中山里,1706,1364,242,516,758,28,786
公投第１４案,新北市,樹林區,中山里,1707,1677,251,544,795,58,853
公投第１４案,新北市,樹林區,樂山里,1708,1683,242,497,739,27,766
公投第１４案,新北市,樹林區,柑園里,1709,1452,245,546,791,46,837
公投第１４案,新北市,樹林區,柑園里,1710,1592,345,558,903,26,929
公投第１４案,新北市,樹林區,柑園里,1711,1619,304,606,910,30,940
公投第１４案,新北市,樹林區,柑園里,1712,1642,341,635,976,23,999
公投第１４案,新北市,樹林區,柑園里,1713,1357,277,476,753,16,769
公投第１４案,新北市,樹林區,西園里,1714,1638,280,572,852,70,922
公投第１４案,新北市,樹林區,南園里,1715,1592,319,528,847,29,876
公投第１４案,新北市,樹林區,南園里,1716,1521,258,598,856,36,892
公投第１４案,新北市,樹林區,南園里,1717,1707,328,671,999,40,1039
公投第１４案,新北市,樹林區,南園里,1718,1741,348,623,971,47,1018
公投第１４案,新北市,樹林區,南園里,1719,1655,356,546,902,26,928
公投第１４案,新北市,樹林區,南園里,1720,1775,301,557,858,54,912
公投第１４案,新北市,樹林區,南園里,1721,1781,240,690,930,43,973
公投第１４案,新北市,樹林區,東園里,1722,1565,256,445,701,39,740
公投第１４案,新北市,樹林區,北園里,1723,936,155,315,470,34,504
公投第１４案,新北市,樹林區,北園里,1724,1030,192,375,567,17,584
公投第１４案,新北市,鶯歌區,建德里,1725,515,80,203,283,15,298
公投第１４案,新北市,鶯歌區,東鶯里,1726,965,191,350,541,41,582
公投第１４案,新北市,鶯歌區,北鶯里,1727,1931,348,643,991,73,1064
公投第１４案,新北市,鶯歌區,北鶯里,1728,1797,310,528,838,51,889
公投第１４案,新北市,鶯歌區,西鶯里,1729,1057,167,393,560,43,603
公投第１４案,新北市,鶯歌區,西鶯里,1730,962,165,320,485,14,499
公投第１４案,新北市,鶯歌區,中鶯里,1731,934,194,361,555,32,587
公投第１４案,新北市,鶯歌區,南鶯里,1732,1742,334,658,992,52,1044
公投第１４案,新北市,鶯歌區,南鶯里,1733,1634,297,541,838,37,875
公投第１４案,新北市,鶯歌區,南鶯里,1734,1676,306,524,830,25,855
公投第１４案,新北市,鶯歌區,建國里,1735,2052,392,682,1074,53,1127
公投第１４案,新北市,鶯歌區,建國里,1736,1977,346,568,914,27,941
公投第１４案,新北市,鶯歌區,建國里,1737,1957,394,640,1034,19,1053
公投第１４案,新北市,鶯歌區,二甲里,1738,850,126,264,390,19,409
公投第１４案,新北市,鶯歌區,二橋里,1739,1782,273,598,871,44,915
公投第１４案,新北市,鶯歌區,二橋里,1740,1496,279,475,754,44,798
公投第１４案,新北市,鶯歌區,二橋里,1741,2071,316,674,990,35,1025
公投第１４案,新北市,鶯歌區,二橋里,1742,1753,282,467,749,44,793
公投第１４案,新北市,鶯歌區,尖山里,1743,1737,277,579,856,34,890
公投第１４案,新北市,鶯歌區,尖山里,1744,1669,269,524,793,52,845
公投第１４案,新北市,鶯歌區,尖山里,1745,1842,295,506,801,36,837
公投第１４案,新北市,鶯歌區,尖山里,1746,1454,232,460,692,49,741
公投第１４案,新北市,鶯歌區,南靖里,1747,942,175,297,472,35,507
公投第１４案,新北市,鶯歌區,南靖里,1748,1317,233,420,653,48,701
公投第１４案,新北市,鶯歌區,南靖里,1749,949,147,314,461,18,479
公投第１４案,新北市,鶯歌區,同慶里,1750,1440,278,522,800,42,842
公投第１４案,新北市,鶯歌區,永昌里,1751,1809,318,620,938,56,994
公投第１４案,新北市,鶯歌區,永昌里,1752,1758,328,609,937,54,991
公投第１４案,新北市,鶯歌區,永昌里,1753,1589,268,564,832,36,868
公投第１４案,新北市,鶯歌區,永昌里,1754,1067,211,399,610,29,639
公投第１４案,新北市,鶯歌區,永昌里,1755,1092,202,410,612,34,646
公投第１４案,新北市,鶯歌區,永吉里,1756,1730,297,627,924,42,966
公投第１４案,新北市,鶯歌區,永吉里,1757,1281,208,478,686,29,715
公投第１４案,新北市,鶯歌區,永吉里,1758,1238,224,501,725,41,766
公投第１４案,新北市,鶯歌區,鳳祥里,1759,1568,253,563,816,53,869
公投第１４案,新北市,鶯歌區,鳳祥里,1760,1271,216,426,642,44,686
公投第１４案,新北市,鶯歌區,鳳祥里,1761,1183,171,319,490,33,523
公投第１４案,新北市,鶯歌區,鳳鳴里,1762,1026,158,327,485,21,506
公投第１４案,新北市,鶯歌區,鳳鳴里,1763,1721,279,536,815,44,859
公投第１４案,新北市,鶯歌區,鳳鳴里,1764,1317,209,415,624,66,690
公投第１４案,新北市,鶯歌區,鳳福里,1765,1046,190,396,586,41,627
公投第１４案,新北市,鶯歌區,鳳福里,1766,1144,231,406,637,53,690
公投第１４案,新北市,鶯歌區,鳳福里,1767,1336,210,430,640,45,685
公投第１４案,新北市,鶯歌區,大湖里,1768,1479,201,465,666,48,714
公投第１４案,新北市,鶯歌區,大湖里,1769,1736,296,553,849,51,900
公投第１４案,新北市,鶯歌區,大湖里,1770,1389,262,497,759,54,813
公投第１４案,新北市,鶯歌區,中湖里,1771,1956,287,766,1053,61,1114
公投第１４案,新北市,鶯歌區,中湖里,1772,1371,241,476,717,39,756
公投第１４案,新北市,鶯歌區,中湖里,1773,1810,227,464,691,27,718
公投第１４案,新北市,鶯歌區,東湖里,1774,227,42,84,126,2,128
公投第１４案,新北市,土城區,祖田里,1775,1505,251,497,748,58,806
公投第１４案,新北市,土城區,頂新里,1776,1242,260,459,719,29,748
公投第１４案,新北市,土城區,頂新里,1777,1206,229,466,695,21,716
公投第１４案,新北市,土城區,頂福里,1778,1474,260,490,750,60,810
公投第１４案,新北市,土城區,頂福里,1779,1489,235,494,729,42,771
公投第１４案,新北市,土城區,頂福里,1780,1675,254,554,808,49,857
公投第１４案,新北市,土城區,頂埔里,1781,1499,269,510,779,44,823
公投第１４案,新北市,土城區,頂埔里,1782,1495,224,514,738,30,768
公投第１４案,新北市,土城區,頂埔里,1783,1411,278,481,759,61,820
公投第１４案,新北市,土城區,沛陂里,1784,1378,257,414,671,39,710
公投第１４案,新北市,土城區,沛陂里,1785,1256,236,401,637,31,668
公投第１４案,新北市,土城區,沛陂里,1786,1379,259,483,742,49,791
公投第１４案,新北市,土城區,永寧里,1787,1424,218,480,698,42,740
公投第１４案,新北市,土城區,永寧里,1788,1455,232,505,737,48,785
公投第１４案,新北市,土城區,永寧里,1789,1419,244,474,718,21,739
公投第１４案,新北市,土城區,永寧里,1790,1357,286,494,780,33,813
公投第１４案,新北市,土城區,永寧里,1791,1501,275,482,757,42,799
公投第１４案,新北市,土城區,大安里,1792,1206,233,410,643,51,694
公投第１４案,新北市,土城區,大安里,1793,1255,268,435,703,27,730
公投第１４案,新北市,土城區,大安里,1794,1869,312,603,915,53,968
公投第１４案,新北市,土城區,員仁里,1795,1292,237,451,688,24,712
公投第１４案,新北市,土城區,員仁里,1796,1324,227,422,649,27,676
公投第１４案,新北市,土城區,員仁里,1797,1155,185,389,574,41,615
公投第１４案,新北市,土城區,員仁里,1798,1183,209,405,614,40,654
公投第１４案,新北市,土城區,埤塘里,1799,2518,183,329,512,33,545
公投第１４案,新北市,土城區,埤塘里,1800,1218,213,420,633,32,665
公投第１４案,新北市,土城區,埤塘里,1801,1133,201,399,600,47,647
公投第１４案,新北市,土城區,土城里,1802,894,167,315,482,26,508
公投第１４案,新北市,土城區,土城里,1803,931,191,313,504,42,546
公投第１４案,新北市,土城區,長風里,1804,1820,337,775,1112,39,1151
公投第１４案,新北市,土城區,員信里,1805,1320,216,466,682,32,714
公投第１４案,新北市,土城區,員信里,1806,1241,232,397,629,31,660
公投第１４案,新北市,土城區,員信里,1807,1414,270,474,744,34,778
公投第１４案,新北市,土城區,員林里,1808,1378,277,465,742,44,786
公投第１４案,新北市,土城區,員林里,1809,1421,286,497,783,48,831
公投第１４案,新北市,土城區,員林里,1810,1340,210,475,685,46,731
公投第１４案,新北市,土城區,員林里,1811,1144,239,408,647,32,679
公投第１４案,新北市,土城區,員福里,1812,1268,235,438,673,50,723
公投第１４案,新北市,土城區,員福里,1813,1196,198,441,639,53,692
公投第１４案,新北市,土城區,員福里,1814,1308,277,477,754,25,779
公投第１４案,新北市,土城區,員福里,1815,1175,216,421,637,38,675
公投第１４案,新北市,土城區,日和里,1816,1230,212,444,656,46,702
公投第１４案,新北市,土城區,日和里,1817,1342,265,456,721,48,769
公投第１４案,新北市,土城區,日和里,1818,1268,243,460,703,42,745
公投第１４案,新北市,土城區,日和里,1819,1227,238,494,732,51,783
公投第１４案,新北市,土城區,日新里,1820,1356,229,481,710,69,779
公投第１４案,新北市,土城區,日新里,1821,1496,262,528,790,47,837
公投第１４案,新北市,土城區,日新里,1822,1309,231,458,689,56,745
公投第１４案,新北市,土城區,裕生里,1823,1175,246,409,655,49,704
公投第１４案,新北市,土城區,裕生里,1824,1237,227,432,659,45,704
公投第１４案,新北市,土城區,裕生里,1825,1256,217,460,677,44,721
公投第１４案,新北市,土城區,裕生里,1826,1228,235,416,651,19,670
公投第１４案,新北市,土城區,貨饒里,1827,1182,230,379,609,60,669
公投第１４案,新北市,土城區,貨饒里,1828,1558,299,522,821,37,858
公投第１４案,新北市,土城區,貨饒里,1829,1160,236,395,631,33,664
公投第１４案,新北市,土城區,瑞興里,1830,1357,272,441,713,47,760
公投第１４案,新北市,土城區,瑞興里,1831,1464,287,447,734,69,803
公投第１４案,新北市,土城區,復興里,1832,1335,228,432,660,42,702
公投第１４案,新北市,土城區,復興里,1833,1346,248,449,697,57,754
公投第１４案,新北市,土城區,復興里,1834,1435,321,511,832,37,869
公投第１４案,新北市,土城區,廣福里,1835,1639,314,548,862,40,902
公投第１４案,新北市,土城區,廣福里,1836,1728,378,568,946,42,988
公投第１４案,新北市,土城區,廣福里,1837,1665,279,455,734,27,761
公投第１４案,新北市,土城區,學成里,1838,1333,269,485,754,61,815
公投第１４案,新北市,土城區,學成里,1839,1567,309,561,870,37,907
公投第１４案,新北市,土城區,埤林里,1840,1576,292,523,815,54,869
公投第１４案,新北市,土城區,埤林里,1841,1458,282,502,784,49,833
公投第１４案,新北市,土城區,埤林里,1842,1517,275,527,802,67,869
公投第１４案,新北市,土城區,埤林里,1843,1489,281,570,851,26,877
公投第１４案,新北市,土城區,埤林里,1844,1463,349,496,845,23,868
公投第１４案,新北市,土城區,廣興里,1845,1584,307,563,870,20,890
公投第１４案,新北市,土城區,廣興里,1846,1464,280,479,759,44,803
公投第１４案,新北市,土城區,樂利里,1847,1598,322,523,845,53,898
公投第１４案,新北市,土城區,樂利里,1848,1500,309,432,741,64,805
公投第１４案,新北市,土城區,樂利里,1849,1542,289,514,803,38,841
公投第１４案,新北市,土城區,學府里,1850,1619,346,577,923,43,966
公投第１４案,新北市,土城區,學府里,1851,1521,269,500,769,24,793
公投第１４案,新北市,土城區,明德里,1852,1691,373,527,900,21,921
公投第１４案,新北市,土城區,明德里,1853,1657,323,519,842,41,883
公投第１４案,新北市,土城區,明德里,1854,1772,408,591,999,33,1032
公投第１４案,新北市,土城區,學士里,1855,1423,276,521,797,14,811
公投第１４案,新北市,土城區,學士里,1856,1321,288,488,776,44,820
公投第１４案,新北市,土城區,學士里,1857,1429,313,517,830,43,873
公投第１４案,新北市,土城區,柑林里,1858,1445,247,497,744,34,778
公投第１４案,新北市,土城區,柑林里,1859,1520,279,562,841,43,884
公投第１４案,新北市,土城區,中正里,1860,1484,242,448,690,12,702
公投第１４案,新北市,土城區,中正里,1861,1362,262,441,703,24,727
公投第１４案,新北市,土城區,青雲里,1862,1262,218,440,658,31,689
公投第１４案,新北市,土城區,青雲里,1863,1343,271,458,729,42,771
公投第１４案,新北市,土城區,清和里,1864,1337,238,388,626,29,655
公投第１４案,新北市,土城區,清和里,1865,1325,194,360,554,36,590
公投第１４案,新北市,土城區,清和里,1866,1390,247,422,669,39,708
公投第１４案,新北市,土城區,清和里,1867,1534,288,501,789,42,831
公投第１４案,新北市,土城區,清化里,1868,1484,252,470,722,66,788
公投第１４案,新北市,土城區,清溪里,1869,1532,255,494,749,46,795
公投第１４案,新北市,土城區,清溪里,1870,1507,272,532,804,45,849
公投第１４案,新北市,土城區,清溪里,1871,1550,294,537,831,42,873
公投第１４案,新北市,土城區,清溪里,1872,1567,262,551,813,44,857
公投第１４案,新北市,土城區,青山里,1873,1367,260,487,747,41,788
公投第１４案,新北市,土城區,青山里,1874,1293,215,434,649,45,694
公投第１４案,新北市,土城區,清水里,1875,1402,248,490,738,51,789
公投第１４案,新北市,土城區,清水里,1876,1379,268,459,727,37,764
公投第１４案,新北市,土城區,清水里,1877,1471,257,473,730,42,772
公投第１４案,新北市,土城區,清水里,1878,1410,248,475,723,34,757
公投第１４案,新北市,土城區,清水里,1879,1542,279,523,802,33,835
公投第１４案,新北市,土城區,永豐里,1880,1238,219,422,641,42,683
公投第１４案,新北市,土城區,永豐里,1881,1301,227,427,654,36,690
公投第１４案,新北市,土城區,永豐里,1882,1311,287,532,819,22,841
公投第１４案,新北市,土城區,永富里,1883,1511,223,484,707,32,739
公投第１４案,新北市,土城區,永富里,1884,1531,248,519,767,47,814
公投第１４案,新北市,土城區,永富里,1885,1638,311,490,801,55,856
公投第１４案,新北市,土城區,廷寮里,1886,1335,240,516,756,34,790
公投第１４案,新北市,土城區,廷寮里,1887,1459,253,512,765,41,806
公投第１４案,新北市,土城區,廷寮里,1888,1489,294,483,777,23,800
公投第１４案,新北市,土城區,金城里,1889,1774,407,523,930,71,1001
公投第１４案,新北市,土城區,金城里,1890,1792,321,627,948,34,982
公投第１４案,新北市,土城區,金城里,1891,1798,284,658,942,12,954
公投第１４案,新北市,土城區,峯廷里,1892,1312,223,428,651,57,708
公投第１４案,新北市,土城區,峯廷里,1893,1301,217,419,636,44,680
公投第１４案,新北市,土城區,峯廷里,1894,1254,222,403,625,40,665
公投第１４案,新北市,土城區,峯廷里,1895,1215,235,394,629,34,663
公投第１４案,新北市,土城區,峯廷里,1896,1448,212,508,720,32,752
公投第１４案,新北市,土城區,延吉里,1897,1321,209,444,653,54,707
公投第１４案,新北市,土城區,延吉里,1898,1150,206,332,538,62,600
公投第１４案,新北市,土城區,延吉里,1899,1425,270,396,666,40,706
公投第１４案,新北市,土城區,延壽里,1900,1366,238,518,756,57,813
公投第１４案,新北市,土城區,延壽里,1901,1292,251,465,716,42,758
公投第１４案,新北市,土城區,延壽里,1902,1317,205,470,675,45,720
公投第１４案,新北市,土城區,延祿里,1903,1324,246,468,714,39,753
公投第１４案,新北市,土城區,延祿里,1904,1189,215,396,611,37,648
公投第１４案,新北市,土城區,延祿里,1905,1223,240,427,667,46,713
公投第１４案,新北市,土城區,平和里,1906,1550,270,511,781,53,834
公投第１４案,新北市,土城區,平和里,1907,1606,326,529,855,66,921
公投第１４案,新北市,土城區,平和里,1908,1509,280,514,794,39,833
公投第１４案,新北市,土城區,平和里,1909,1529,272,510,782,46,828
公投第１４案,新北市,土城區,安和里,1910,1458,222,492,714,55,769
公投第１４案,新北市,土城區,安和里,1911,1468,294,488,782,53,835
公投第１４案,新北市,土城區,安和里,1912,1495,291,471,762,43,805
公投第１４案,新北市,土城區,延和里,1913,1303,225,443,668,75,743
公投第１４案,新北市,土城區,延和里,1914,1365,266,472,738,32,770
公投第１４案,新北市,土城區,延和里,1915,1476,267,489,756,64,820
公投第１４案,新北市,土城區,延和里,1916,1519,292,521,813,30,843
公投第１４案,新北市,三峽區,三峽里,1917,274,57,108,165,22,187
公投第１４案,新北市,三峽區,秀川里,1918,583,105,192,297,25,322
公投第１４案,新北市,三峽區,八張里,1919,1765,289,501,790,22,812
公投第１４案,新北市,三峽區,八張里,1920,1714,305,555,860,48,908
公投第１４案,新北市,三峽區,中埔里,1921,1355,219,457,676,23,699
公投第１４案,新北市,三峽區,中埔里,1922,1329,261,462,723,32,755
公投第１４案,新北市,三峽區,弘道里,1923,1059,180,347,527,40,567
公投第１４案,新北市,三峽區,永舘里,1924,1364,261,475,736,50,786
公投第１４案,新北市,三峽區,永舘里,1925,1098,229,370,599,47,646
公投第１４案,新北市,三峽區,永舘里,1926,1296,227,442,669,45,714
公投第１４案,新北市,三峽區,永舘里,1927,1240,231,405,636,34,670
公投第１４案,新北市,三峽區,永舘里,1928,1531,301,472,773,41,814
公投第１４案,新北市,三峽區,鳶山里,1929,1444,221,466,687,25,712
公投第１４案,新北市,三峽區,鳶山里,1930,1347,253,411,664,69,733
公投第１４案,新北市,三峽區,鳶山里,1931,1455,240,503,743,45,788
公投第１４案,新北市,三峽區,鳶山里,1932,1556,239,467,706,31,737
公投第１４案,新北市,三峽區,鳶山里,1933,1390,213,380,593,27,620
公投第１４案,新北市,三峽區,鳶山里,1934,1532,267,514,781,39,820
公投第１４案,新北市,三峽區,龍埔里,1935,1377,187,438,625,48,673
公投第１４案,新北市,三峽區,龍埔里,1936,1731,279,576,855,43,898
公投第１４案,新北市,三峽區,龍埔里,1937,1705,285,544,829,34,863
公投第１４案,新北市,三峽區,龍埔里,1938,1590,318,536,854,23,877
公投第１４案,新北市,三峽區,龍埔里,1939,1650,290,630,920,22,942
公投第１４案,新北市,三峽區,龍恩里,1940,1441,272,495,767,30,797
公投第１４案,新北市,三峽區,龍恩里,1941,1404,265,527,792,25,817
公投第１４案,新北市,三峽區,龍恩里,1942,1295,279,467,746,23,769
公投第１４案,新北市,三峽區,龍恩里,1943,1348,213,428,641,27,668
公投第１４案,新北市,三峽區,龍學里,1944,1579,291,578,869,10,879
公投第１４案,新北市,三峽區,龍學里,1945,1435,257,495,752,19,771
公投第１４案,新北市,三峽區,龍學里,1946,1659,294,652,946,28,974
公投第１４案,新北市,三峽區,龍學里,1947,1512,335,554,889,27,916
公投第１４案,新北市,三峽區,龍學里,1948,1463,262,560,822,31,853
公投第１４案,新北市,三峽區,龍學里,1949,1465,286,557,843,20,863
公投第１４案,新北市,三峽區,龍學里,1950,1463,280,553,833,18,851
公投第１４案,新北市,三峽區,龍學里,1951,1443,266,543,809,26,835
公投第１４案,新北市,三峽區,礁溪里,1952,1634,270,525,795,38,833
公投第１４案,新北市,三峽區,礁溪里,1953,1716,298,595,893,39,932
公投第１４案,新北市,三峽區,礁溪里,1954,1675,272,554,826,46,872
公投第１４案,新北市,三峽區,安溪里,1955,1649,241,468,709,37,746
公投第１４案,新北市,三峽區,安溪里,1956,1489,257,487,744,45,789
公投第１４案,新北市,三峽區,安溪里,1957,1771,302,500,802,39,841
公投第１４案,新北市,三峽區,安溪里,1958,1726,367,559,926,25,951
公投第１４案,新北市,三峽區,介壽里,1959,1363,229,456,685,47,732
公投第１４案,新北市,三峽區,介壽里,1960,1624,298,543,841,35,876
公投第１４案,新北市,三峽區,介壽里,1961,1352,269,454,723,35,758
公投第１４案,新北市,三峽區,介壽里,1962,1608,220,413,633,17,650
公投第１４案,新北市,三峽區,中正里,1963,1458,248,490,738,45,783
公投第１４案,新北市,三峽區,中正里,1964,1641,275,491,766,34,800
公投第１４案,新北市,三峽區,中正里,1965,1530,258,478,736,76,812
公投第１４案,新北市,三峽區,大埔里,1966,1389,187,401,588,45,633
公投第１４案,新北市,三峽區,大埔里,1967,1315,203,406,609,58,667
公投第１４案,新北市,三峽區,大埔里,1968,934,138,402,540,29,569
公投第１４案,新北市,三峽區,嘉添里,1969,1270,189,394,583,32,615
公投第１４案,新北市,三峽區,嘉添里,1970,929,122,300,422,36,458
公投第１４案,新北市,三峽區,添福里,1971,1035,168,353,521,15,536
公投第１４案,新北市,三峽區,金圳里,1972,502,78,157,235,8,243
公投第１４案,新北市,三峽區,五寮里,1973,836,97,270,367,46,413
公投第１４案,新北市,三峽區,插角里,1974,669,81,200,281,48,329
公投第１４案,新北市,三峽區,有木里,1975,733,112,276,388,53,441
公投第１４案,新北市,三峽區,二鬮里,1976,1560,256,635,891,43,934
公投第１４案,新北市,三峽區,二鬮里,1977,1638,158,645,803,42,845
公投第１４案,新北市,三峽區,溪南里,1978,1394,186,507,693,28,721
公投第１４案,新北市,三峽區,溪北里,1979,771,140,272,412,34,446
公投第１４案,新北市,三峽區,溪北里,1980,1367,215,460,675,24,699
公投第１４案,新北市,三峽區,溪東里,1981,1241,180,423,603,44,647
公投第１４案,新北市,三峽區,溪東里,1982,1520,227,482,709,30,739
公投第１４案,新北市,三峽區,成福里,1983,873,134,389,523,34,557
公投第１４案,新北市,三峽區,竹崙里,1984,768,104,216,320,53,373
公投第１４案,新北市,三峽區,竹崙里,1985,1097,139,351,490,30,520
公投第１４案,新北市,三峽區,安坑里,1986,1322,164,367,531,55,586
公投第１４案,新北市,新店區,新店里,1987,1603,307,553,860,40,900
公投第１４案,新北市,新店區,張南里,1988,1921,366,675,1041,45,1086
公投第１４案,新北市,新店區,國校里,1989,1082,191,386,577,19,596
公投第１４案,新北市,新店區,國校里,1990,1235,227,456,683,36,719
公投第１４案,新北市,新店區,文中里,1991,1568,269,626,895,23,918
公投第１４案,新北市,新店區,廣明里,1992,771,166,271,437,29,466
公投第１４案,新北市,新店區,文明里,1993,1256,271,417,688,30,718
公投第１４案,新北市,新店區,文明里,1994,1008,192,372,564,40,604
公投第１４案,新北市,新店區,中興里,1995,1515,271,584,855,42,897
公投第１４案,新北市,新店區,中興里,1996,1637,288,689,977,39,1016
公投第１４案,新北市,新店區,中興里,1997,1549,302,565,867,37,904
公投第１４案,新北市,新店區,新生里,1998,2011,399,805,1204,49,1253
公投第１４案,新北市,新店區,新生里,1999,1554,270,588,858,50,908
公投第１４案,新北市,新店區,新生里,2000,1770,342,598,940,50,990
公投第１４案,新北市,新店區,新德里,2001,1316,248,492,740,42,782
公投第１４案,新北市,新店區,新德里,2002,1126,182,419,601,45,646
公投第１４案,新北市,新店區,張北里,2003,1460,257,497,754,47,801
公投第１４案,新北市,新店區,張北里,2004,1584,309,587,896,52,948
公投第１４案,新北市,新店區,張北里,2005,1449,277,512,789,44,833
公投第１４案,新北市,新店區,張北里,2006,1520,292,645,937,33,970
公投第１４案,新北市,新店區,張北里,2007,1821,345,692,1037,35,1072
公投第１４案,新北市,新店區,五峯里,2008,1956,414,681,1095,29,1124
公投第１４案,新北市,新店區,五峯里,2009,1665,312,627,939,41,980
公投第１４案,新北市,新店區,五峯里,2010,1588,320,616,936,33,969
公投第１４案,新北市,新店區,五峯里,2011,1519,297,533,830,22,852
公投第１４案,新北市,新店區,長春里,2012,1185,289,426,715,31,746
公投第１４案,新北市,新店區,長春里,2013,1095,263,418,681,21,702
公投第１４案,新北市,新店區,新安里,2014,1106,200,443,643,46,689
公投第１４案,新北市,新店區,新安里,2015,2700,147,246,393,17,410
公投第１４案,新北市,新店區,新安里,2016,995,186,404,590,18,608
公投第１４案,新北市,新店區,新安里,2017,1168,227,413,640,37,677
公投第１４案,新北市,新店區,忠誠里,2018,1123,232,491,723,40,763
公投第１４案,新北市,新店區,忠誠里,2019,1085,232,454,686,21,707
公投第１４案,新北市,新店區,中正里,2020,1412,290,557,847,40,887
公投第１４案,新北市,新店區,中正里,2021,1659,80,853,933,44,977
公投第１４案,新北市,新店區,中正里,2022,1198,232,492,724,39,763
公投第１４案,新北市,新店區,中正里,2023,1376,207,510,717,28,745
公投第１４案,新北市,新店區,中華里,2024,1300,211,487,698,22,720
公投第１４案,新北市,新店區,中華里,2025,1238,200,493,693,32,725
公投第１４案,新北市,新店區,中華里,2026,1388,238,497,735,23,758
公投第１４案,新北市,新店區,仁愛里,2027,933,194,364,558,34,592
公投第１４案,新北市,新店區,仁愛里,2028,908,170,384,554,26,580
公投第１４案,新北市,新店區,建國里,2029,1582,266,600,866,47,913
公投第１４案,新北市,新店區,建國里,2030,1247,244,500,744,36,780
公投第１４案,新北市,新店區,百忍里,2031,971,185,379,564,39,603
公投第１４案,新北市,新店區,百忍里,2032,1145,217,458,675,37,712
公投第１４案,新北市,新店區,百忍里,2033,1392,266,532,798,40,838
公投第１４案,新北市,新店區,百和里,2034,1452,247,618,865,53,918
公投第１４案,新北市,新店區,百和里,2035,1440,253,548,801,36,837
公投第１４案,新北市,新店區,福德里,2036,1786,330,628,958,63,1021
公投第１４案,新北市,新店區,福德里,2037,1825,332,695,1027,44,1071
公投第１４案,新北市,新店區,百福里,2038,1477,280,587,867,27,894
公投第１４案,新北市,新店區,百福里,2039,1750,347,639,986,45,1031
公投第１４案,新北市,新店區,福民里,2040,1792,284,694,978,41,1019
公投第１４案,新北市,新店區,福民里,2041,1979,332,757,1089,36,1125
公投第１４案,新北市,新店區,中山里,2042,826,165,325,490,16,506
公投第１４案,新北市,新店區,中山里,2043,1924,332,771,1103,35,1138
公投第１４案,新北市,新店區,中山里,2044,1383,287,566,853,19,872
公投第１４案,新北市,新店區,和平里,2045,830,137,262,399,32,431
公投第１４案,新北市,新店區,中央里,2046,1759,335,703,1038,32,1070
公投第１４案,新北市,新店區,中央里,2047,1957,351,774,1125,40,1165
公投第１４案,新北市,新店區,中央里,2048,1481,311,569,880,22,902
公投第１４案,新北市,新店區,國豐里,2049,1552,307,553,860,56,916
公投第１４案,新北市,新店區,國豐里,2050,1467,246,532,778,70,848
公投第１４案,新北市,新店區,明德里,2051,1371,252,515,767,35,802
公投第１４案,新北市,新店區,明德里,2052,991,183,391,574,26,600
公投第１４案,新北市,新店區,明德里,2053,1231,471,254,725,31,756
公投第１４案,新北市,新店區,大豐里,2054,1701,331,632,963,32,995
公投第１４案,新北市,新店區,大豐里,2055,1707,324,624,948,45,993
公投第１４案,新北市,新店區,大同里,2056,1773,335,634,969,36,1005
公投第１４案,新北市,新店區,大同里,2057,1866,424,525,949,37,986
公投第１４案,新北市,新店區,江陵里,2058,1735,355,652,1007,27,1034
公投第１４案,新北市,新店區,江陵里,2059,1632,350,651,1001,41,1042
公投第１４案,新北市,新店區,江陵里,2060,1591,300,595,895,50,945
公投第１４案,新北市,新店區,復興里,2061,1495,242,517,759,59,818
公投第１４案,新北市,新店區,復興里,2062,1511,235,536,771,19,790
公投第１４案,新北市,新店區,寶興里,2063,1260,230,457,687,49,736
公投第１４案,新北市,新店區,寶興里,2064,1948,364,763,1127,38,1165
公投第１４案,新北市,新店區,寶興里,2065,1582,321,624,945,41,986
公投第１４案,新北市,新店區,寶福里,2066,1315,241,489,730,35,765
公投第１４案,新北市,新店區,寶福里,2067,1562,307,515,822,48,870
公投第１４案,新北市,新店區,寶福里,2068,1982,379,781,1160,24,1184
公投第１４案,新北市,新店區,寶福里,2069,1518,293,560,853,50,903
公投第１４案,新北市,新店區,寶安里,2070,1735,320,640,960,24,984
公投第１４案,新北市,新店區,寶安里,2071,1716,305,632,937,33,970
公投第１４案,新北市,新店區,寶安里,2072,1580,315,570,885,41,926
公投第１４案,新北市,新店區,信義里,2073,1358,305,516,821,28,849
公投第１４案,新北市,新店區,信義里,2074,1610,332,616,948,54,1002
公投第１４案,新北市,新店區,信義里,2075,1383,262,486,748,29,777
公投第１４案,新北市,新店區,信義里,2076,1596,312,603,915,34,949
公投第１４案,新北市,新店區,忠孝里,2077,1360,219,471,690,39,729
公投第１４案,新北市,新店區,忠孝里,2078,1160,160,442,602,14,616
公投第１４案,新北市,新店區,大鵬里,2079,1236,200,584,784,34,818
公投第１４案,新北市,新店區,大鵬里,2080,1234,243,535,778,19,797
公投第１４案,新北市,新店區,太平里,2081,1579,291,546,837,78,915
公投第１４案,新北市,新店區,太平里,2082,1241,203,462,665,46,711
公投第１４案,新北市,新店區,美城里,2083,1275,220,482,702,21,723
公投第１４案,新北市,新店區,美城里,2084,1214,177,441,618,28,646
公投第１４案,新北市,新店區,頂城里,2085,1578,222,501,723,70,793
公投第１４案,新北市,新店區,下城里,2086,1442,296,458,754,42,796
公投第１４案,新北市,新店區,下城里,2087,1475,224,485,709,62,771
公投第１４案,新北市,新店區,柴埕里,2088,1580,295,587,882,48,930
公投第１４案,新北市,新店區,柴埕里,2089,1585,268,590,858,25,883
公投第１４案,新北市,新店區,柴埕里,2090,1586,287,550,837,57,894
公投第１４案,新北市,新店區,柴埕里,2091,1931,361,663,1024,53,1077
公投第１４案,新北市,新店區,柴埕里,2092,1239,211,449,660,23,683
公投第１４案,新北市,新店區,安和里,2093,1892,328,684,1012,36,1048
公投第１４案,新北市,新店區,安和里,2094,1529,226,538,764,45,809
公投第１４案,新北市,新店區,安和里,2095,1358,221,533,754,35,789
公投第１４案,新北市,新店區,安和里,2096,1905,341,615,956,36,992
公投第１４案,新北市,新店區,永安里,2097,1885,324,654,978,36,1014
公投第１４案,新北市,新店區,永安里,2098,1345,202,484,686,48,734
公投第１４案,新北市,新店區,永安里,2099,1387,227,531,758,42,800
公投第１４案,新北市,新店區,新和里,2100,1960,361,687,1048,33,1081
公投第１４案,新北市,新店區,新和里,2101,1837,339,618,957,74,1031
公投第１４案,新北市,新店區,永平里,2102,1662,321,598,919,33,952
公投第１４案,新北市,新店區,永平里,2103,1617,330,618,948,48,996
公投第１４案,新北市,新店區,永平里,2104,1704,300,644,944,34,978
公投第１４案,新北市,新店區,公崙里,2105,1835,310,620,930,62,992
公投第１４案,新北市,新店區,公崙里,2106,2009,353,673,1026,58,1084
公投第１４案,新北市,新店區,公崙里,2107,1450,224,541,765,47,812
公投第１４案,新北市,新店區,公崙里,2108,1726,315,609,924,37,961
公投第１４案,新北市,新店區,公崙里,2109,1797,309,619,928,47,975
公投第１４案,新北市,新店區,公崙里,2110,1739,293,651,944,31,975
公投第１４案,新北市,新店區,安昌里,2111,1523,245,586,831,26,857
公投第１４案,新北市,新店區,安昌里,2112,1642,280,587,867,25,892
公投第１４案,新北市,新店區,安昌里,2113,1644,329,590,919,19,938
公投第１４案,新北市,新店區,德安里,2114,1662,274,563,837,22,859
公投第１４案,新北市,新店區,德安里,2115,2067,396,741,1137,46,1183
公投第１４案,新北市,新店區,德安里,2116,1870,293,541,834,39,873
公投第１４案,新北市,新店區,達觀里,2117,1982,371,671,1042,37,1079
公投第１４案,新北市,新店區,達觀里,2118,1546,280,565,845,41,886
公投第１４案,新北市,新店區,明城里,2119,1712,305,697,1002,32,1034
公投第１４案,新北市,新店區,明城里,2120,1423,292,566,858,27,885
公投第１４案,新北市,新店區,小城里,2121,1666,319,628,947,59,1006
公投第１４案,新北市,新店區,小城里,2122,1769,332,723,1055,43,1098
公投第１４案,新北市,新店區,雙城里,2123,1079,158,347,505,39,544
公投第１４案,新北市,新店區,雙城里,2124,1140,187,411,598,22,620
公投第１４案,新北市,新店區,雙城里,2125,1825,335,648,983,20,1003
公投第１４案,新北市,新店區,雙城里,2126,1178,254,428,682,34,716
公投第１４案,新北市,新店區,香坡里,2127,1463,271,496,767,33,800
公投第１４案,新北市,新店區,香坡里,2128,1152,209,431,640,23,663
公投第１４案,新北市,新店區,香坡里,2129,2008,189,714,903,34,937
公投第１４案,新北市,新店區,香坡里,2130,2120,318,614,932,33,965
公投第１４案,新北市,新店區,香坡里,2131,1153,230,447,677,16,693
公投第１４案,新北市,新店區,香坡里,2132,1573,258,548,806,23,829
公投第１４案,新北市,新店區,日興里,2133,1992,274,627,901,63,964
公投第１４案,新北市,新店區,日興里,2134,1668,264,511,775,51,826
公投第１４案,新北市,新店區,日興里,2135,1617,177,597,774,39,813
公投第１４案,新北市,新店區,玫瑰里,2136,2013,320,639,959,119,1078
公投第１４案,新北市,新店區,玫瑰里,2137,1791,345,656,1001,40,1041
公投第１４案,新北市,新店區,玫瑰里,2138,1624,298,592,890,38,928
公投第１４案,新北市,新店區,吉祥里,2139,1178,201,481,682,34,716
公投第１４案,新北市,新店區,吉祥里,2140,1277,226,505,731,24,755
公投第１４案,新北市,新店區,吉祥里,2141,1879,370,663,1033,30,1063
公投第１４案,新北市,新店區,塗潭里,2142,939,114,310,424,31,455
公投第１４案,新北市,新店區,華城里,2143,960,196,331,527,20,547
公投第１４案,新北市,新店區,華城里,2144,1434,248,545,793,90,883
公投第１４案,新北市,新店區,青潭里,2145,1838,320,597,917,41,958
公投第１４案,新北市,新店區,青潭里,2146,1453,262,515,777,39,816
公投第１４案,新北市,新店區,青潭里,2147,1549,245,542,787,44,831
公投第１４案,新北市,新店區,美潭里,2148,1860,360,677,1037,42,1079
公投第１４案,新北市,新店區,美潭里,2149,1743,279,589,868,42,910
公投第１４案,新北市,新店區,美潭里,2150,1122,224,479,703,35,738
公投第１４案,新北市,新店區,員潭里,2151,1468,199,574,773,43,816
公投第１４案,新北市,新店區,員潭里,2152,1763,327,615,942,32,974
公投第１４案,新北市,新店區,員潭里,2153,1344,243,463,706,26,732
公投第１４案,新北市,新店區,雙坑里,2154,753,93,282,375,32,407
公投第１４案,新北市,新店區,粗坑里,2155,602,130,196,326,11,337
公投第１４案,新北市,新店區,粗坑里,2156,2237,462,665,1127,48,1175
公投第１４案,新北市,新店區,屈尺里,2157,1096,192,383,575,34,609
公投第１４案,新北市,新店區,屈尺里,2158,1143,181,322,503,35,538
公投第１４案,新北市,新店區,龜山里,2159,1569,263,593,856,71,927
公投第１４案,新北市,新店區,廣興里,2160,1284,176,467,643,62,705
公投第１４案,新北市,新店區,直潭里,2161,439,55,88,143,13,156
公投第１４案,新北市,新店區,直潭里,2162,750,155,251,406,31,437
公投第１４案,新北市,深坑區,萬順里,2163,1142,209,364,573,29,602
公投第１４案,新北市,深坑區,萬順里,2164,1139,196,432,628,42,670
公投第１４案,新北市,深坑區,萬福里,2165,1065,180,351,531,45,576
公投第１４案,新北市,深坑區,萬福里,2166,1400,231,444,675,40,715
公投第１４案,新北市,深坑區,土庫里,2167,1330,232,415,647,44,691
公投第１４案,新北市,深坑區,土庫里,2168,1380,236,435,671,26,697
公投第１４案,新北市,深坑區,深坑里,2169,1496,261,426,687,15,702
公投第１４案,新北市,深坑區,深坑里,2170,1508,288,529,817,50,867
公投第１４案,新北市,深坑區,埔新里,2171,1624,322,564,886,43,929
公投第１４案,新北市,深坑區,埔新里,2172,2165,382,742,1124,44,1168
公投第１４案,新北市,深坑區,埔新里,2173,1790,355,651,1006,53,1059
公投第１４案,新北市,深坑區,昇高里,2174,782,137,243,380,23,403
公投第１４案,新北市,深坑區,昇高里,2175,1164,241,412,653,29,682
公投第１４案,新北市,深坑區,賴仲里,2176,1344,260,488,748,53,801
公投第１４案,新北市,深坑區,賴仲里,2177,739,148,279,427,28,455
公投第１４案,新北市,深坑區,阿柔里,2178,556,101,216,317,23,340
公投第１４案,新北市,石碇區,石碇里,2179,391,79,145,224,20,244
公投第１４案,新北市,石碇區,潭邊里,2180,789,106,258,364,40,404
公投第１４案,新北市,石碇區,烏塗里,2181,662,76,176,252,26,278
公投第１４案,新北市,石碇區,彭山里,2182,310,39,110,149,12,161
公投第１４案,新北市,石碇區,豐田里,2183,280,33,100,133,15,148
公投第１４案,新北市,石碇區,豐田里,2184,93,10,23,33,5,38
公投第１４案,新北市,石碇區,隆盛里,2185,683,94,174,268,35,303
公投第１４案,新北市,石碇區,豐林里,2186,323,63,127,190,17,207
公投第１４案,新北市,石碇區,中民里,2187,726,92,178,270,16,286
公投第１４案,新北市,石碇區,永定里,2188,591,82,217,299,17,316
公投第１４案,新北市,石碇區,光明里,2189,282,55,109,164,26,190
公投第１４案,新北市,石碇區,永安里,2190,788,104,218,322,17,339
公投第１４案,新北市,石碇區,格頭里,2191,943,182,320,502,54,556
公投第１４案,新北市,坪林區,坪林里,2192,1248,201,432,633,44,677
公投第１４案,新北市,坪林區,水德里,2193,612,81,171,252,40,292
公投第１４案,新北市,坪林區,大林里,2194,1141,146,438,584,71,655
公投第１４案,新北市,坪林區,石𥕢里,2195,417,66,100,166,9,175
公投第１４案,新北市,坪林區,粗窟里,2196,595,95,204,299,33,332
公投第１４案,新北市,坪林區,粗窟里,2197,248,38,92,130,25,155
公投第１４案,新北市,坪林區,上德里,2198,338,51,101,152,16,168
公投第１４案,新北市,坪林區,上德里,2199,478,58,126,184,24,208
公投第１４案,新北市,坪林區,漁光里,2200,390,50,101,151,9,160
公投第１４案,新北市,坪林區,漁光里,2201,424,42,139,181,22,203
公投第１４案,新北市,烏來區,忠治里,2202,1568,283,634,917,40,957
公投第１４案,新北市,烏來區,烏來里,2203,1198,171,411,582,15,597
公投第１４案,新北市,烏來區,烏來里,2204,1169,169,408,577,18,595
公投第１４案,新北市,烏來區,孝義里,2205,228,41,82,123,1,124
公投第１４案,新北市,烏來區,信賢里,2206,486,61,191,252,19,271
公投第１４案,新北市,烏來區,福山里,2207,615,85,212,297,19,316
公投第１４案,新北市,平溪區,薯榔里,2208,384,43,130,173,23,196
公投第１４案,新北市,平溪區,菁桐里,2209,232,29,69,98,3,101
公投第１４案,新北市,平溪區,白石里,2210,249,43,88,131,9,140
公投第１４案,新北市,平溪區,石底里,2211,458,66,151,217,35,252
公投第１４案,新北市,平溪區,平溪里,2212,232,25,81,106,21,127
公投第１４案,新北市,平溪區,嶺腳里,2213,635,88,157,245,18,263
公投第１４案,新北市,平溪區,東勢里,2214,427,54,162,216,31,247
公投第１４案,新北市,平溪區,十分里,2215,862,105,227,332,36,368
公投第１４案,新北市,平溪區,望古里,2216,147,21,50,71,2,73
公投第１４案,新北市,平溪區,南山里,2217,365,20,106,126,12,138
公投第１４案,新北市,平溪區,新寮里,2218,153,13,44,57,7,64
公投第１４案,新北市,平溪區,平湖里,2219,177,16,83,99,10,109
公投第１４案,新北市,瑞芳區,龍潭里,2220,725,107,280,387,35,422
公投第１４案,新北市,瑞芳區,龍興里,2221,1074,182,384,566,43,609
公投第１４案,新北市,瑞芳區,龍興里,2222,825,115,289,404,24,428
公投第１４案,新北市,瑞芳區,龍鎮里,2223,1242,216,407,623,75,698
公投第１４案,新北市,瑞芳區,龍安里,2224,598,85,216,301,26,327
公投第１４案,新北市,瑞芳區,龍川里,2225,872,161,280,441,28,469
公投第１４案,新北市,瑞芳區,龍川里,2226,760,110,225,335,31,366
公投第１４案,新北市,瑞芳區,龍山里,2227,1330,205,373,578,46,624
公投第１４案,新北市,瑞芳區,爪峯里,2228,1683,245,497,742,45,787
公投第１４案,新北市,瑞芳區,爪峯里,2229,980,147,316,463,54,517
公投第１４案,新北市,瑞芳區,爪峯里,2230,946,144,319,463,38,501
公投第１４案,新北市,瑞芳區,新峰里,2231,1375,174,418,592,31,623
公投第１４案,新北市,瑞芳區,新峰里,2232,1671,237,547,784,42,826
公投第１４案,新北市,瑞芳區,東和里,2233,978,131,280,411,26,437
公投第１４案,新北市,瑞芳區,東和里,2234,645,86,201,287,27,314
公投第１４案,新北市,瑞芳區,柑坪里,2235,1089,162,337,499,58,557
公投第１４案,新北市,瑞芳區,弓橋里,2236,286,42,65,107,17,124
公投第１４案,新北市,瑞芳區,猴硐里,2237,461,64,157,221,25,246
公投第１４案,新北市,瑞芳區,光復里,2238,274,37,81,118,19,137
公投第１４案,新北市,瑞芳區,碩仁里,2239,155,30,56,86,9,95
公投第１４案,新北市,瑞芳區,吉慶里,2240,817,153,272,425,28,453
公投第１４案,新北市,瑞芳區,吉慶里,2241,884,152,262,414,57,471
公投第１４案,新北市,瑞芳區,吉安里,2242,1333,195,370,565,56,621
公投第１４案,新北市,瑞芳區,吉安里,2243,607,92,161,253,6,259
公投第１４案,新北市,瑞芳區,吉安里,2244,1045,167,346,513,38,551
公投第１４案,新北市,瑞芳區,上天里,2245,673,118,217,335,33,368
公投第１４案,新北市,瑞芳區,上天里,2246,618,72,157,229,10,239
公投第１４案,新北市,瑞芳區,傑魚里,2247,1063,154,313,467,29,496
公投第１４案,新北市,瑞芳區,傑魚里,2248,860,133,288,421,46,467
公投第１４案,新北市,瑞芳區,基山里,2249,432,43,89,132,4,136
公投第１４案,新北市,瑞芳區,永慶里,2250,445,36,123,159,13,172
公投第１４案,新北市,瑞芳區,崇文里,2251,318,32,94,126,12,138
公投第１４案,新北市,瑞芳區,福住里,2252,159,13,57,70,7,77
公投第１４案,新北市,瑞芳區,頌德里,2253,337,41,96,137,10,147
公投第１４案,新北市,瑞芳區,瓜山里,2254,180,31,58,89,10,99
公投第１４案,新北市,瑞芳區,銅山里,2255,187,20,51,71,10,81
公投第１４案,新北市,瑞芳區,新山里,2256,369,48,129,177,13,190
公投第１４案,新北市,瑞芳區,石山里,2257,335,47,118,165,21,186
公投第１４案,新北市,瑞芳區,濓洞里,2258,470,63,128,191,13,204
公投第１４案,新北市,瑞芳區,濓新里,2259,297,38,71,109,8,117
公投第１４案,新北市,瑞芳區,南雅里,2260,267,48,124,172,5,177
公投第１４案,新北市,瑞芳區,鼻頭里,2261,876,53,176,229,13,242
公投第１４案,新北市,瑞芳區,海濱里,2262,1241,121,321,442,30,472
公投第１４案,新北市,瑞芳區,瑞濱里,2263,998,134,339,473,60,533
公投第１４案,新北市,瑞芳區,瑞濱里,2264,948,122,327,449,53,502
公投第１４案,新北市,瑞芳區,深澳里,2265,1308,131,346,477,33,510
公投第１４案,新北市,雙溪區,雙溪里,2266,455,52,145,197,17,214
公投第１４案,新北市,雙溪區,新基里,2267,286,99,37,136,12,148
公投第１４案,新北市,雙溪區,新基里,2268,496,68,174,242,32,274
公投第１４案,新北市,雙溪區,三港里,2269,383,46,103,149,16,165
公投第１４案,新北市,雙溪區,牡丹里,2270,887,94,245,339,39,378
公投第１４案,新北市,雙溪區,牡丹里,2271,652,79,167,246,30,276
公投第１４案,新北市,雙溪區,三貂里,2272,333,40,116,156,13,169
公投第１４案,新北市,雙溪區,平林里,2273,642,80,210,290,32,322
公投第１４案,新北市,雙溪區,平林里,2274,282,44,81,125,12,137
公投第１４案,新北市,雙溪區,上林里,2275,621,72,172,244,27,271
公投第１４案,新北市,雙溪區,外柑里,2276,422,52,107,159,13,172
公投第１４案,新北市,雙溪區,長源里,2277,369,31,85,116,21,137
公投第１４案,新北市,雙溪區,共和里,2278,120,20,36,56,9,65
公投第１４案,新北市,雙溪區,共和里,2279,271,31,89,120,14,134
公投第１４案,新北市,雙溪區,魚行里,2280,362,57,135,192,21,213
公投第１４案,新北市,雙溪區,魚行里,2281,371,51,120,171,22,193
公投第１４案,新北市,雙溪區,泰平里,2282,1047,135,434,569,46,615
公投第１４案,新北市,貢寮區,貢寮里,2283,876,110,278,388,49,437
公投第１４案,新北市,貢寮區,龍崗里,2284,433,70,126,196,21,217
公投第１４案,新北市,貢寮區,吉林里,2285,516,70,144,214,11,225
公投第１４案,新北市,貢寮區,雙玉里,2286,373,46,84,130,23,153
公投第１４案,新北市,貢寮區,雙玉里,2287,313,38,85,123,26,149
公投第１４案,新北市,貢寮區,福連里,2288,485,52,174,226,15,241
公投第１４案,新北市,貢寮區,福連里,2289,415,62,125,187,24,211
公投第１４案,新北市,貢寮區,福隆里,2290,812,86,232,318,23,341
公投第１４案,新北市,貢寮區,福隆里,2291,861,123,251,374,42,416
公投第１４案,新北市,貢寮區,龍門里,2292,676,80,156,236,29,265
公投第１４案,新北市,貢寮區,真理里,2293,1091,123,254,377,30,407
公投第１４案,新北市,貢寮區,真理里,2294,955,112,221,333,60,393
公投第１４案,新北市,貢寮區,仁里里,2295,769,88,201,289,16,305
公投第１４案,新北市,貢寮區,仁里里,2296,962,142,285,427,36,463
公投第１４案,新北市,貢寮區,美豐里,2297,390,43,166,209,13,222
公投第１４案,新北市,貢寮區,美豐里,2298,349,32,117,149,5,154
公投第１４案,新北市,貢寮區,和美里,2299,508,51,131,182,22,204
公投第１４案,新北市,貢寮區,和美里,2300,495,51,103,154,10,164
公投第１４案,新北市,金山區,和平里,2301,481,54,183,237,25,262
公投第１４案,新北市,金山區,大同里,2302,715,108,240,348,33,381
公投第１４案,新北市,金山區,豐漁里,2303,481,57,138,195,20,215
公投第１４案,新北市,金山區,磺港里,2304,1792,206,364,570,266,836
公投第１４案,新北市,金山區,美田里,2305,1781,264,578,842,71,913
公投第１４案,新北市,金山區,美田里,2306,2010,327,682,1009,74,1083
公投第１４案,新北市,金山區,金美里,2307,1572,214,489,703,71,774
公投第１４案,新北市,金山區,金美里,2308,1777,267,566,833,80,913
公投第１４案,新北市,金山區,金美里,2309,1631,224,487,711,68,779
公投第１４案,新北市,金山區,五湖里,2310,828,141,267,408,28,436
公投第１４案,新北市,金山區,五湖里,2311,888,140,301,441,27,468
公投第１４案,新北市,金山區,重和里,2312,1211,169,389,558,54,612
公投第１４案,新北市,金山區,兩湖里,2313,416,53,169,222,17,239
公投第１４案,新北市,金山區,六股里,2314,682,117,229,346,52,398
公投第１４案,新北市,金山區,三界里,2315,644,86,209,295,54,349
公投第１４案,新北市,金山區,清泉里,2316,830,89,280,369,40,409
公投第１４案,新北市,金山區,西湖里,2317,188,23,66,89,11,100
公投第１４案,新北市,金山區,萬壽里,2318,469,62,172,234,26,260
公投第１４案,新北市,金山區,永興里,2319,582,53,135,188,29,217
公投第１４案,新北市,萬里區,萬里里,2320,1286,183,463,646,50,696
公投第１４案,新北市,萬里區,萬里里,2321,1576,274,529,803,55,858
公投第１４案,新北市,萬里區,萬里里,2322,1447,190,466,656,44,700
公投第１４案,新北市,萬里區,北基里,2323,1466,154,452,606,66,672
公投第１４案,新北市,萬里區,北基里,2324,1369,147,406,553,41,594
公投第１４案,新北市,萬里區,龜吼里,2325,1215,125,305,430,46,476
公投第１４案,新北市,萬里區,龜吼里,2326,1317,165,475,640,52,692
公投第１４案,新北市,萬里區,野柳里,2327,1676,183,491,674,54,728
公投第１４案,新北市,萬里區,野柳里,2328,1550,182,477,659,80,739
公投第１４案,新北市,萬里區,大鵬里,2329,945,166,376,542,50,592
公投第１４案,新北市,萬里區,大鵬里,2330,1760,252,621,873,89,962
公投第１４案,新北市,萬里區,磺潭里,2331,570,50,215,265,22,287
公投第１４案,新北市,萬里區,雙興里,2332,952,122,319,441,25,466
公投第１４案,新北市,萬里區,溪底里,2333,674,91,254,345,50,395
公投第１４案,新北市,萬里區,崁脚里,2334,405,59,137,196,16,212
公投第１４案,新北市,萬里區,中幅里,2335,1089,128,366,494,55,549
公投第１４案,新北市,汐止區,仁德里,2336,1595,275,528,803,58,861
公投第１４案,新北市,汐止區,義民里,2337,1262,225,440,665,41,706
公投第１４案,新北市,汐止區,禮門里,2338,917,192,302,494,47,541
公投第１４案,新北市,汐止區,智慧里,2339,1929,378,658,1036,37,1073
公投第１４案,新北市,汐止區,智慧里,2340,2227,433,699,1132,51,1183
公投第１４案,新北市,汐止區,大同里,2341,1143,233,365,598,41,639
公投第１４案,新北市,汐止區,大同里,2342,1367,240,482,722,31,753
公投第１４案,新北市,汐止區,信望里,2343,322,61,100,161,15,176
公投第１４案,新北市,汐止區,新昌里,2344,1460,293,486,779,14,793
公投第１４案,新北市,汐止區,新昌里,2345,1719,335,515,850,34,884
公投第１４案,新北市,汐止區,新昌里,2346,1661,278,532,810,54,864
公投第１４案,新北市,汐止區,福安里,2347,1590,319,535,854,48,902
公投第１４案,新北市,汐止區,福安里,2348,1599,305,536,841,43,884
公投第１４案,新北市,汐止區,福安里,2349,1749,314,614,928,41,969
公投第１４案,新北市,汐止區,秀峰里,2350,1809,138,192,330,26,356
公投第１４案,新北市,汐止區,秀峰里,2351,1601,279,464,743,22,765
公投第１４案,新北市,汐止區,秀峰里,2352,1387,236,445,681,57,738
公投第１４案,新北市,汐止區,秀山里,2353,1779,378,562,940,56,996
公投第１４案,新北市,汐止區,秀山里,2354,2074,354,755,1109,47,1156
公投第１４案,新北市,汐止區,復興里,2355,2072,373,699,1072,46,1118
公投第１４案,新北市,汐止區,復興里,2356,2120,753,441,1194,50,1244
公投第１４案,新北市,汐止區,復興里,2357,1952,396,631,1027,37,1064
公投第１４案,新北市,汐止區,自強里,2358,1654,296,538,834,46,880
公投第１４案,新北市,汐止區,自強里,2359,1444,250,455,705,56,761
公投第１４案,新北市,汐止區,自強里,2360,1627,369,559,928,36,964
公投第１４案,新北市,汐止區,文化里,2361,1751,322,521,843,61,904
公投第１４案,新北市,汐止區,文化里,2362,2066,423,619,1042,43,1085
公投第１４案,新北市,汐止區,白雲里,2363,1941,269,554,823,52,875
公投第１４案,新北市,汐止區,白雲里,2364,1906,324,540,864,44,908
公投第１４案,新北市,汐止區,茄苳里,2365,1363,233,423,656,62,718
公投第１４案,新北市,汐止區,茄苳里,2366,1368,232,449,681,30,711
公投第１４案,新北市,汐止區,茄苳里,2367,1233,210,363,573,40,613
公投第１４案,新北市,汐止區,崇德里,2368,1554,298,485,783,24,807
公投第１４案,新北市,汐止區,崇德里,2369,1700,295,539,834,37,871
公投第１４案,新北市,汐止區,崇德里,2370,1124,244,371,615,18,633
公投第１４案,新北市,汐止區,城中里,2371,1900,376,663,1039,48,1087
公投第１４案,新北市,汐止區,城中里,2372,2050,388,654,1042,57,1099
公投第１４案,新北市,汐止區,橋東里,2373,1244,264,355,619,51,670
公投第１４案,新北市,汐止區,橋東里,2374,1320,221,420,641,27,668
公投第１４案,新北市,汐止區,建成里,2375,1473,306,495,801,33,834
公投第１４案,新北市,汐止區,建成里,2376,1802,293,645,938,55,993
公投第１４案,新北市,汐止區,建成里,2377,1266,224,483,707,36,743
公投第１４案,新北市,汐止區,長安里,2378,1481,240,441,681,54,735
公投第１４案,新北市,汐止區,保安里,2379,1497,293,424,717,54,771
公投第１４案,新北市,汐止區,東山里,2380,556,86,214,300,16,316
公投第１４案,新北市,汐止區,保長里,2381,1913,333,574,907,48,955
公投第１４案,新北市,汐止區,保長里,2382,2027,372,611,983,35,1018
公投第１４案,新北市,汐止區,保新里,2383,1927,347,561,908,39,947
公投第１４案,新北市,汐止區,保新里,2384,696,111,238,349,40,389
公投第１４案,新北市,汐止區,鄉長里,2385,2127,365,635,1000,56,1056
公投第１４案,新北市,汐止區,江北里,2386,1642,277,452,729,48,777
公投第１４案,新北市,汐止區,江北里,2387,1912,321,617,938,67,1005
公投第１４案,新北市,汐止區,江北里,2388,1893,300,527,827,55,882
公投第１４案,新北市,汐止區,拱北里,2389,1466,244,414,658,57,715
公投第１４案,新北市,汐止區,拱北里,2390,1538,260,471,731,61,792
公投第１４案,新北市,汐止區,拱北里,2391,1550,275,470,745,45,790
公投第１４案,新北市,汐止區,烘內里,2392,1456,218,477,695,55,750
公投第１４案,新北市,汐止區,八連里,2393,947,154,377,531,37,568
公投第１４案,新北市,汐止區,長青里,2394,923,195,300,495,29,524
公投第１４案,新北市,汐止區,北峰里,2395,2043,306,627,933,96,1029
公投第１４案,新北市,汐止區,北峰里,2396,2012,339,558,897,65,962
公投第１４案,新北市,汐止區,金龍里,2397,1471,233,427,660,27,687
公投第１４案,新北市,汐止區,金龍里,2398,1603,272,504,776,40,816
公投第１４案,新北市,汐止區,金龍里,2399,1530,244,526,770,53,823
公投第１４案,新北市,汐止區,樟樹里,2400,1988,281,573,854,32,886
公投第１４案,新北市,汐止區,忠孝里,2401,2198,405,640,1045,45,1090
公投第１４案,新北市,汐止區,忠孝里,2402,1712,277,548,825,44,869
公投第１４案,新北市,汐止區,忠孝里,2403,1806,365,597,962,44,1006
公投第１４案,新北市,汐止區,忠孝里,2404,1576,269,518,787,54,841
公投第１４案,新北市,汐止區,厚德里,2405,1511,246,516,762,29,791
公投第１４案,新北市,汐止區,厚德里,2406,1691,277,520,797,37,834
公投第１４案,新北市,汐止區,厚德里,2407,1636,280,559,839,32,871
公投第１４案,新北市,汐止區,厚德里,2408,1676,276,548,824,46,870
公投第１４案,新北市,汐止區,山光里,2409,1264,218,413,631,29,660
公投第１４案,新北市,汐止區,山光里,2410,1165,185,405,590,20,610
公投第１４案,新北市,汐止區,中興里,2411,1765,279,577,856,41,897
公投第１４案,新北市,汐止區,中興里,2412,1815,248,535,783,24,807
公投第１４案,新北市,汐止區,中興里,2413,1778,297,522,819,67,886
公投第１４案,新北市,汐止區,中興里,2414,1580,292,525,817,56,873
公投第１４案,新北市,汐止區,福德里,2415,1516,290,469,759,50,809
公投第１４案,新北市,汐止區,福德里,2416,1425,227,440,667,40,707
公投第１４案,新北市,汐止區,興福里,2417,1388,246,476,722,39,761
公投第１４案,新北市,汐止區,興福里,2418,1436,238,491,729,54,783
公投第１４案,新北市,汐止區,康福里,2419,1591,320,482,802,36,838
公投第１４案,新北市,汐止區,康福里,2420,1639,280,503,783,32,815
公投第１４案,新北市,汐止區,康福里,2421,1394,265,421,686,19,705
公投第１４案,新北市,汐止區,湖光里,2422,2035,383,580,963,32,995
公投第１４案,新北市,汐止區,湖光里,2423,1895,323,618,941,46,987
公投第１４案,新北市,汐止區,湖光里,2424,1374,290,469,759,26,785
公投第１４案,新北市,汐止區,湖蓮里,2425,1061,258,350,608,18,626
公投第１４案,新北市,汐止區,湖蓮里,2426,1312,308,494,802,25,827
公投第１４案,新北市,汐止區,湖興里,2427,1548,294,531,825,29,854
公投第１４案,新北市,汐止區,湖興里,2428,1350,260,485,745,28,773
公投第１４案,新北市,汐止區,湖興里,2429,1499,287,497,784,31,815
公投第１４案,新北市,汐止區,湖興里,2430,1366,247,505,752,39,791
公投第１４案,新北市,汐止區,北山里,2431,1335,258,457,715,50,765
公投第１４案,新北市,汐止區,北山里,2432,1324,254,517,771,37,808
公投第１４案,新北市,汐止區,北山里,2433,1286,275,458,733,52,785
公投第１４案,新北市,汐止區,北山里,2434,1155,237,363,600,38,638
公投第１４案,新北市,汐止區,忠山里,2435,1682,423,600,1023,30,1053
公投第１４案,新北市,汐止區,忠山里,2436,1494,285,588,873,51,924
公投第１４案,新北市,汐止區,環河里,2437,1166,208,441,649,55,704
公投第１４案,新北市,汐止區,橫科里,2438,2184,409,706,1115,96,1211
公投第１４案,新北市,汐止區,橫科里,2439,2031,346,697,1043,66,1109
公投第１４案,新北市,汐止區,福山里,2440,1759,320,603,923,54,977
公投第１４案,新北市,汐止區,福山里,2441,1577,334,525,859,42,901
公投第１４案,新北市,汐止區,宜興里,2442,1364,257,458,715,24,739
公投第１４案,新北市,汐止區,宜興里,2443,1401,270,510,780,40,820
公投第１４案,新北市,汐止區,東勢里,2444,1173,249,396,645,52,697
公投第１４案,新北市,汐止區,東勢里,2445,993,164,365,529,21,550
公投第１４案,新北市,汐止區,東勢里,2446,1587,267,550,817,26,843
公投第１４案,臺中市,大甲區,朝陽里,1,1356,228,518,746,67,813
公投第１４案,臺中市,大甲區,大甲里,2,1059,217,411,628,37,665
公投第１４案,臺中市,大甲區,順天里,3,694,132,278,410,32,442
公投第１４案,臺中市,大甲區,順天里,4,874,147,359,506,25,531
公投第１４案,臺中市,大甲區,孔門里,5,763,116,296,412,18,430
公投第１４案,臺中市,大甲區,平安里,6,856,151,369,520,29,549
公投第１４案,臺中市,大甲區,平安里,7,1249,218,492,710,34,744
公投第１４案,臺中市,大甲區,庄美里,8,922,157,333,490,32,522
公投第１４案,臺中市,大甲區,庄美里,9,1189,221,456,677,35,712
公投第１４案,臺中市,大甲區,新美里,10,1065,195,435,630,50,680
公投第１４案,臺中市,大甲區,新美里,11,1252,201,535,736,74,810
公投第１４案,臺中市,大甲區,新美里,12,1057,156,425,581,38,619
公投第１４案,臺中市,大甲區,岷山里,13,1031,151,420,571,36,607
公投第１４案,臺中市,大甲區,岷山里,14,1060,187,442,629,40,669
公投第１４案,臺中市,大甲區,中山里,15,1311,216,504,720,50,770
公投第１４案,臺中市,大甲區,中山里,16,1424,209,571,780,38,818
公投第１４案,臺中市,大甲區,中山里,17,1670,205,639,844,57,901
公投第１４案,臺中市,大甲區,南陽里,18,812,143,306,449,34,483
公投第１４案,臺中市,大甲區,薰風里,19,863,118,387,505,29,534
公投第１４案,臺中市,大甲區,義和里,20,1598,262,636,898,51,949
公投第１４案,臺中市,大甲區,義和里,21,1588,233,626,859,44,903
公投第１４案,臺中市,大甲區,武陵里,22,1197,200,448,648,50,698
公投第１４案,臺中市,大甲區,文曲里,23,1106,167,380,547,70,617
公投第１４案,臺中市,大甲區,武曲里,24,903,167,367,534,35,569
公投第１４案,臺中市,大甲區,武曲里,25,869,144,360,504,37,541
公投第１４案,臺中市,大甲區,文武里,26,1350,247,511,758,29,787
公投第１４案,臺中市,大甲區,文武里,27,1144,167,434,601,89,690
公投第１４案,臺中市,大甲區,文武里,28,1208,286,424,710,40,750
公投第１４案,臺中市,大甲區,文武里,29,1567,298,595,893,42,935
公投第１４案,臺中市,大甲區,奉化里,30,1246,261,506,767,33,800
公投第１４案,臺中市,大甲區,奉化里,31,767,125,303,428,39,467
公投第１４案,臺中市,大甲區,德化里,32,790,126,325,451,31,482
公投第１４案,臺中市,大甲區,德化里,33,972,149,399,548,47,595
公投第１４案,臺中市,大甲區,江南里,34,1388,188,519,707,61,768
公投第１４案,臺中市,大甲區,頂店里,35,1331,197,479,676,38,714
公投第１４案,臺中市,大甲區,頂店里,36,1167,196,485,681,47,728
公投第１４案,臺中市,大甲區,頂店里,37,1934,324,762,1086,45,1131
公投第１４案,臺中市,大甲區,太白里,38,1263,185,416,601,61,662
公投第１４案,臺中市,大甲區,孟春里,39,1390,212,541,753,43,796
公投第１４案,臺中市,大甲區,孟春里,40,1186,149,408,557,35,592
公投第１４案,臺中市,大甲區,孟春里,41,1397,232,521,753,42,795
公投第１４案,臺中市,大甲區,幸福里,42,1173,157,364,521,20,541
公投第１４案,臺中市,大甲區,幸福里,43,1398,225,483,708,66,774
公投第１４案,臺中市,大甲區,日南里,44,1228,199,387,586,53,639
公投第１４案,臺中市,大甲區,日南里,45,1258,197,444,641,40,681
公投第１４案,臺中市,大甲區,日南里,46,1435,207,545,752,36,788
公投第１４案,臺中市,大甲區,日南里,47,1532,248,541,789,55,844
公投第１４案,臺中市,大甲區,龍泉里,48,652,93,259,352,30,382
公投第１４案,臺中市,大甲區,龍泉里,49,870,135,279,414,27,441
公投第１４案,臺中市,大甲區,西岐里,50,891,118,340,458,21,479
公投第１４案,臺中市,大甲區,西岐里,51,784,119,313,432,34,466
公投第１４案,臺中市,大甲區,銅安里,52,1368,166,508,674,77,751
公投第１４案,臺中市,大甲區,福德里,53,1126,159,394,553,53,606
公投第１４案,臺中市,大甲區,建興里,54,1486,205,465,670,70,740
公投第１４案,臺中市,大安區,南埔里,55,1068,132,371,503,67,570
公投第１４案,臺中市,大安區,南庄里,56,1050,157,397,554,60,614
公投第１４案,臺中市,大安區,中庄里,57,1246,213,486,699,59,758
公投第１４案,臺中市,大安區,中庄里,58,1397,197,537,734,50,784
公投第１４案,臺中市,大安區,東安里,59,1227,188,507,695,63,758
公投第１４案,臺中市,大安區,福興里,60,1170,160,475,635,58,693
公投第１４案,臺中市,大安區,龜壳里,61,914,159,389,548,47,595
公投第１４案,臺中市,大安區,龜壳里,62,667,85,230,315,30,345
公投第１４案,臺中市,大安區,頂安里,63,890,127,315,442,44,486
公投第１４案,臺中市,大安區,永安里,64,1289,178,485,663,71,734
公投第１４案,臺中市,大安區,永安里,65,455,66,162,228,17,245
公投第１４案,臺中市,大安區,福住里,66,1028,141,407,548,45,593
公投第１４案,臺中市,大安區,海墘里,67,1446,230,559,789,77,866
公投第１４案,臺中市,大安區,西安里,68,688,113,302,415,30,445
公投第１４案,臺中市,大安區,西安里,69,1062,156,437,593,55,648
公投第１４案,臺中市,大安區,松雅里,70,923,176,387,563,37,600
公投第１４案,臺中市,外埔區,永豐里,71,1059,144,407,551,51,602
公投第１４案,臺中市,外埔區,六分里,72,1013,145,439,584,24,608
公投第１４案,臺中市,外埔區,六分里,73,1150,179,501,680,39,719
公投第１４案,臺中市,外埔區,大同里,74,1855,288,843,1131,53,1184
公投第１４案,臺中市,外埔區,大同里,75,1327,192,568,760,40,800
公投第１４案,臺中市,外埔區,大同里,76,1453,214,623,837,49,886
公投第１４案,臺中市,外埔區,大東里,77,1653,216,636,852,72,924
公投第１４案,臺中市,外埔區,大東里,78,1615,214,615,829,46,875
公投第１４案,臺中市,外埔區,大東里,79,1470,214,562,776,34,810
公投第１４案,臺中市,外埔區,大東里,80,1559,246,636,882,54,936
公投第１４案,臺中市,外埔區,三崁里,81,1902,273,724,997,74,1071
公投第１４案,臺中市,外埔區,水美里,82,1138,193,493,686,45,731
公投第１４案,臺中市,外埔區,水美里,83,1065,153,466,619,62,681
公投第１４案,臺中市,外埔區,水美里,84,1243,204,536,740,40,780
公投第１４案,臺中市,外埔區,鐵山里,85,962,156,324,480,48,528
公投第１４案,臺中市,外埔區,鐵山里,86,1169,179,425,604,52,656
公投第１４案,臺中市,外埔區,中山里,87,1216,191,553,744,47,791
公投第１４案,臺中市,外埔區,馬鳴里,88,1391,182,554,736,47,783
公投第１４案,臺中市,外埔區,土城里,89,1616,209,622,831,83,914
公投第１４案,臺中市,外埔區,廍子里,90,1203,173,379,552,39,591
公投第１４案,臺中市,清水區,鰲峰里,91,1076,189,375,564,23,587
公投第１４案,臺中市,清水區,靈泉里,92,953,205,379,584,41,625
公投第１４案,臺中市,清水區,清水里,93,914,179,348,527,47,574
公投第１４案,臺中市,清水區,清水里,94,1143,217,469,686,46,732
公投第１４案,臺中市,清水區,文昌里,95,680,149,255,404,27,431
公投第１４案,臺中市,清水區,南寧里,96,904,144,376,520,43,563
公投第１４案,臺中市,清水區,南寧里,97,893,165,380,545,35,580
公投第１４案,臺中市,清水區,西寧里,98,1577,293,579,872,46,918
公投第１４案,臺中市,清水區,北寧里,99,690,116,263,379,29,408
公投第１４案,臺中市,清水區,中興里,100,403,65,164,229,18,247
公投第１４案,臺中市,清水區,西社里,101,1413,244,537,781,59,840
公投第１４案,臺中市,清水區,西社里,102,777,121,305,426,36,462
公投第１４案,臺中市,清水區,南社里,103,1313,210,552,762,33,795
公投第１４案,臺中市,清水區,南社里,104,1439,242,601,843,48,891
公投第１４案,臺中市,清水區,南社里,105,1265,210,443,653,37,690
公投第１４案,臺中市,清水區,南社里,106,1277,247,523,770,34,804
公投第１４案,臺中市,清水區,南社里,107,1276,223,508,731,44,775
公投第１４案,臺中市,清水區,南社里,108,1376,281,553,834,28,862
公投第１４案,臺中市,清水區,南社里,109,1291,234,550,784,35,819
公投第１４案,臺中市,清水區,裕嘉里,110,1510,291,554,845,76,921
公投第１４案,臺中市,清水區,臨江里,111,1524,235,573,808,8,816
公投第１４案,臺中市,清水區,秀水里,112,1474,240,511,751,44,795
公投第１４案,臺中市,清水區,秀水里,113,1507,240,564,804,51,855
公投第１４案,臺中市,清水區,秀水里,114,1321,240,562,802,60,862
公投第１４案,臺中市,清水區,武鹿里,115,1157,178,395,573,39,612
公投第１４案,臺中市,清水區,武鹿里,116,1255,225,494,719,39,758
公投第１４案,臺中市,清水區,武鹿里,117,881,135,350,485,28,513
公投第１４案,臺中市,清水區,海濱里,118,1083,192,427,619,50,669
公投第１４案,臺中市,清水區,海濱里,119,951,156,407,563,28,591
公投第１４案,臺中市,清水區,槺榔里,120,1424,224,513,737,46,783
公投第１４案,臺中市,清水區,槺榔里,121,1233,198,418,616,59,675
公投第１４案,臺中市,清水區,槺榔里,122,1288,184,404,588,45,633
公投第１４案,臺中市,清水區,槺榔里,123,1200,198,477,675,44,719
公投第１４案,臺中市,清水區,中社里,124,1609,201,732,933,32,965
公投第１４案,臺中市,清水區,中社里,125,1136,236,469,705,20,725
公投第１４案,臺中市,清水區,高西里,126,1302,169,502,671,69,740
公投第１４案,臺中市,清水區,高南里,127,1373,214,483,697,85,782
公投第１４案,臺中市,清水區,高東里,128,1257,184,396,580,76,656
公投第１４案,臺中市,清水區,高北里,129,1184,177,391,568,51,619
公投第１４案,臺中市,清水區,高美里,130,1322,171,512,683,66,749
公投第１４案,臺中市,清水區,國姓里,131,1193,182,396,578,56,634
公投第１４案,臺中市,清水區,國姓里,132,927,151,316,467,76,543
公投第１４案,臺中市,清水區,菁埔里,133,1073,203,416,619,51,670
公投第１４案,臺中市,清水區,菁埔里,134,1163,219,434,653,71,724
公投第１４案,臺中市,清水區,頂湳里,135,855,124,319,443,35,478
公投第１４案,臺中市,清水區,頂湳里,136,902,121,320,441,60,501
公投第１４案,臺中市,清水區,田寮里,137,1415,151,620,771,48,819
公投第１４案,臺中市,清水區,田寮里,138,1066,155,390,545,44,589
公投第１４案,臺中市,清水區,橋頭里,139,1391,199,516,715,68,783
公投第１４案,臺中市,清水區,橋頭里,140,1449,190,528,718,48,766
公投第１４案,臺中市,清水區,橋頭里,141,1377,226,556,782,52,834
公投第１４案,臺中市,清水區,橋頭里,142,1423,252,552,804,44,848
公投第１４案,臺中市,清水區,橋頭里,143,1624,635,279,914,33,947
公投第１４案,臺中市,清水區,下湳里,144,1358,198,488,686,67,753
公投第１４案,臺中市,清水區,下湳里,145,1464,221,556,777,78,855
公投第１４案,臺中市,清水區,東山里,146,1211,219,462,681,59,740
公投第１４案,臺中市,清水區,吳厝里,147,1456,202,584,786,23,809
公投第１４案,臺中市,清水區,楊厝里,148,1162,167,506,673,54,727
公投第１４案,臺中市,清水區,海風里,149,1368,193,624,817,60,877
公投第１４案,臺中市,梧棲區,頂寮里,150,1541,260,554,814,57,871
公投第１４案,臺中市,梧棲區,頂寮里,151,1581,253,577,830,56,886
公投第１４案,臺中市,梧棲區,下寮里,152,1083,201,398,599,43,642
公投第１４案,臺中市,梧棲區,下寮里,153,876,153,360,513,17,530
公投第１４案,臺中市,梧棲區,中正里,154,1043,193,374,567,57,624
公投第１４案,臺中市,梧棲區,中正里,155,1502,230,516,746,35,781
公投第１４案,臺中市,梧棲區,中正里,156,1384,210,540,750,50,800
公投第１４案,臺中市,梧棲區,中和里,157,517,90,233,323,29,352
公投第１４案,臺中市,梧棲區,文化里,158,1169,197,509,706,49,755
公投第１４案,臺中市,梧棲區,安仁里,159,863,165,324,489,35,524
公投第１４案,臺中市,梧棲區,草湳里,160,1277,191,404,595,45,640
公投第１４案,臺中市,梧棲區,草湳里,161,1742,294,607,901,45,946
公投第１４案,臺中市,梧棲區,草湳里,162,1342,224,508,732,62,794
公投第１４案,臺中市,梧棲區,草湳里,163,1767,301,646,947,76,1023
公投第１４案,臺中市,梧棲區,南簡里,164,1542,240,481,721,59,780
公投第１４案,臺中市,梧棲區,南簡里,165,1636,242,611,853,44,897
公投第１４案,臺中市,梧棲區,南簡里,166,1796,269,637,906,48,954
公投第１４案,臺中市,梧棲區,福德里,167,1450,219,545,764,37,801
公投第１４案,臺中市,梧棲區,福德里,168,1548,231,537,768,89,857
公投第１４案,臺中市,梧棲區,福德里,169,1366,245,531,776,31,807
公投第１４案,臺中市,梧棲區,大庄里,170,955,181,417,598,21,619
公投第１４案,臺中市,梧棲區,大庄里,171,1305,178,501,679,39,718
公投第１４案,臺中市,梧棲區,大庄里,172,1239,202,491,693,39,732
公投第１４案,臺中市,梧棲區,大庄里,173,1079,182,432,614,55,669
公投第１４案,臺中市,梧棲區,大庄里,174,1220,176,477,653,40,693
公投第１４案,臺中市,梧棲區,大庄里,175,1544,247,624,871,58,929
公投第１４案,臺中市,梧棲區,大村里,176,1460,284,554,838,46,884
公投第１４案,臺中市,梧棲區,大村里,177,1292,219,517,736,51,787
公投第１４案,臺中市,梧棲區,大村里,178,1300,209,492,701,38,739
公投第１４案,臺中市,梧棲區,大村里,179,1555,238,557,795,44,839
公投第１４案,臺中市,梧棲區,興農里,180,1031,157,376,533,43,576
公投第１４案,臺中市,梧棲區,興農里,181,1277,213,500,713,57,770
公投第１４案,臺中市,梧棲區,永寧里,182,1037,169,372,541,41,582
公投第１４案,臺中市,梧棲區,永寧里,183,1187,188,465,653,58,711
公投第１４案,臺中市,梧棲區,永安里,184,1399,195,510,705,53,758
公投第１４案,臺中市,梧棲區,永安里,185,1135,157,445,602,38,640
公投第１４案,臺中市,沙鹿區,居仁里,186,1380,251,453,704,37,741
公投第１４案,臺中市,沙鹿區,洛泉里,187,852,138,351,489,32,521
公投第１４案,臺中市,沙鹿區,洛泉里,188,1176,295,399,694,33,727
公投第１４案,臺中市,沙鹿區,沙鹿里,189,958,202,385,587,59,646
公投第１４案,臺中市,沙鹿區,美仁里,190,488,93,222,315,24,339
公投第１４案,臺中市,沙鹿區,興仁里,191,1177,223,427,650,40,690
公投第１４案,臺中市,沙鹿區,興仁里,192,1285,218,470,688,51,739
公投第１４案,臺中市,沙鹿區,興安里,193,1736,262,620,882,62,944
公投第１４案,臺中市,沙鹿區,興安里,194,1628,295,614,909,68,977
公投第１４案,臺中市,沙鹿區,斗抵里,195,1469,218,558,776,23,799
公投第１４案,臺中市,沙鹿區,斗抵里,196,1423,225,598,823,48,871
公投第１４案,臺中市,沙鹿區,斗抵里,197,1444,207,588,795,67,862
公投第１４案,臺中市,沙鹿區,鹿峰里,198,1469,238,564,802,62,864
公投第１４案,臺中市,沙鹿區,鹿峰里,199,1902,355,684,1039,56,1095
公投第１４案,臺中市,沙鹿區,鹿峰里,200,1675,293,649,942,47,989
公投第１４案,臺中市,沙鹿區,鹿寮里,201,1098,225,362,587,48,635
公投第１４案,臺中市,沙鹿區,鹿寮里,202,1539,291,598,889,49,938
公投第１４案,臺中市,沙鹿區,鹿寮里,203,1329,241,543,784,26,810
公投第１４案,臺中市,沙鹿區,鹿寮里,204,1255,205,472,677,32,709
公投第１４案,臺中市,沙鹿區,鹿寮里,205,1507,303,554,857,46,903
公投第１４案,臺中市,沙鹿區,竹林里,206,1463,246,559,805,56,861
公投第１４案,臺中市,沙鹿區,竹林里,207,1279,205,452,657,50,707
公投第１４案,臺中市,沙鹿區,竹林里,208,1024,146,358,504,42,546
公投第１４案,臺中市,沙鹿區,竹林里,209,1388,194,513,707,53,760
公投第１４案,臺中市,沙鹿區,竹林里,210,1074,196,432,628,26,654
公投第１４案,臺中市,沙鹿區,竹林里,211,1072,183,444,627,31,658
公投第１４案,臺中市,沙鹿區,犁分里,212,1107,164,481,645,45,690
公投第１４案,臺中市,沙鹿區,福興里,213,1947,281,662,943,48,991
公投第１４案,臺中市,沙鹿區,福興里,214,1682,236,618,854,53,907
公投第１４案,臺中市,沙鹿區,北勢里,215,1633,284,634,918,34,952
公投第１４案,臺中市,沙鹿區,北勢里,216,1533,222,562,784,44,828
公投第１４案,臺中市,沙鹿區,北勢里,217,1605,225,423,648,130,778
公投第１４案,臺中市,沙鹿區,晉江里,218,1694,242,624,866,35,901
公投第１４案,臺中市,沙鹿區,六路里,219,1628,271,561,832,45,877
公投第１４案,臺中市,沙鹿區,六路里,220,1665,296,657,953,26,979
公投第１４案,臺中市,沙鹿區,六路里,221,1651,265,608,873,39,912
公投第１４案,臺中市,沙鹿區,南勢里,222,1108,170,480,650,32,682
公投第１４案,臺中市,沙鹿區,南勢里,223,1142,178,483,661,39,700
公投第１４案,臺中市,沙鹿區,南勢里,224,1039,178,393,571,32,603
公投第１４案,臺中市,沙鹿區,埔子里,225,1840,310,644,954,58,1012
公投第１４案,臺中市,沙鹿區,埔子里,226,1872,319,679,998,42,1040
公投第１４案,臺中市,沙鹿區,埔子里,227,1558,253,538,791,45,836
公投第１４案,臺中市,沙鹿區,三鹿里,228,1739,219,646,865,40,905
公投第１４案,臺中市,沙鹿區,三鹿里,229,1672,238,552,790,53,843
公投第１４案,臺中市,沙鹿區,三鹿里,230,1634,269,613,882,26,908
公投第１４案,臺中市,沙鹿區,三鹿里,231,1616,257,525,782,48,830
公投第１４案,臺中市,沙鹿區,公明里,232,1593,251,598,849,38,887
公投第１４案,臺中市,沙鹿區,公明里,233,981,130,395,525,16,541
公投第１４案,臺中市,沙鹿區,公明里,234,1740,280,713,993,52,1045
公投第１４案,臺中市,沙鹿區,清泉里,235,1247,222,490,712,53,765
公投第１４案,臺中市,沙鹿區,清泉里,236,1047,147,462,609,16,625
公投第１４案,臺中市,沙鹿區,西勢里,237,1119,173,438,611,51,662
公投第１４案,臺中市,沙鹿區,西勢里,238,1025,137,425,562,22,584
公投第１４案,臺中市,龍井區,竹坑里,239,1758,296,708,1004,53,1057
公投第１４案,臺中市,龍井區,竹坑里,240,1275,188,529,717,15,732
公投第１４案,臺中市,龍井區,龍東里,241,1379,178,472,650,32,682
公投第１４案,臺中市,龍井區,龍東里,242,1403,183,521,704,43,747
公投第１４案,臺中市,龍井區,龍西里,243,974,158,371,529,41,570
公投第１４案,臺中市,龍井區,龍西里,244,901,132,391,523,42,565
公投第１４案,臺中市,龍井區,田中里,245,1779,299,624,923,68,991
公投第１４案,臺中市,龍井區,田中里,246,1609,301,597,898,62,960
公投第１４案,臺中市,龍井區,福田里,247,1038,388,135,523,24,547
公投第１４案,臺中市,龍井區,麗水里,248,1328,222,520,742,59,801
公投第１４案,臺中市,龍井區,麗水里,249,921,146,393,539,37,576
公投第１４案,臺中市,龍井區,龍津里,250,1609,231,545,776,70,846
公投第１４案,臺中市,龍井區,龍津里,251,1227,165,424,589,33,622
公投第１４案,臺中市,龍井區,龍津里,252,1278,166,502,668,56,724
公投第１４案,臺中市,龍井區,龍津里,253,914,124,292,416,13,429
公投第１４案,臺中市,龍井區,三德里,254,1678,252,551,803,31,834
公投第１４案,臺中市,龍井區,三德里,255,1233,189,422,611,32,643
公投第１４案,臺中市,龍井區,忠和里,256,1520,243,571,814,47,861
公投第１４案,臺中市,龍井區,忠和里,257,1905,261,687,948,43,991
公投第１４案,臺中市,龍井區,忠和里,258,1520,260,599,859,54,913
公投第１４案,臺中市,龍井區,山腳里,259,1385,206,492,698,56,754
公投第１４案,臺中市,龍井區,山腳里,260,1212,210,431,641,37,678
公投第１４案,臺中市,龍井區,山腳里,261,1432,227,572,799,24,823
公投第１４案,臺中市,龍井區,山腳里,262,1663,247,587,834,39,873
公投第１４案,臺中市,龍井區,龍泉里,263,1422,540,248,788,33,821
公投第１４案,臺中市,龍井區,龍泉里,264,1616,237,519,756,59,815
公投第１４案,臺中市,龍井區,龍泉里,265,1422,210,585,795,45,840
公投第１４案,臺中市,龍井區,龍泉里,266,1165,214,456,670,23,693
公投第１４案,臺中市,龍井區,龍泉里,267,1624,302,585,887,13,900
公投第１４案,臺中市,龍井區,龍崗里,268,1613,233,622,855,52,907
公投第１４案,臺中市,龍井區,龍崗里,269,943,152,395,547,45,592
公投第１４案,臺中市,龍井區,新庄里,270,1595,225,586,811,56,867
公投第１４案,臺中市,龍井區,新庄里,271,1508,253,550,803,86,889
公投第１４案,臺中市,龍井區,新庄里,272,1479,227,541,768,35,803
公投第１４案,臺中市,龍井區,新庄里,273,1509,243,583,826,46,872
公投第１４案,臺中市,龍井區,南寮里,274,1582,249,656,905,63,968
公投第１４案,臺中市,龍井區,東海里,275,1725,308,612,920,55,975
公投第１４案,臺中市,龍井區,東海里,276,1616,263,642,905,28,933
公投第１４案,臺中市,龍井區,東海里,277,1657,301,633,934,45,979
公投第１４案,臺中市,龍井區,東海里,278,1774,381,606,987,46,1033
公投第１４案,臺中市,龍井區,東海里,279,1701,381,606,987,49,1036
公投第１４案,臺中市,龍井區,新東里,280,1121,203,427,630,33,663
公投第１４案,臺中市,龍井區,新東里,281,987,187,392,579,44,623
公投第１４案,臺中市,龍井區,新東里,282,1206,219,450,669,43,712
公投第１４案,臺中市,龍井區,新東里,283,1378,245,564,809,36,845
公投第１４案,臺中市,大肚區,王田里,284,1415,214,545,759,47,806
公投第１４案,臺中市,大肚區,王田里,285,1392,195,498,693,54,747
公投第１４案,臺中市,大肚區,王田里,286,1520,235,631,866,56,922
公投第１４案,臺中市,大肚區,中和里,287,862,365,151,516,67,583
公投第１４案,臺中市,大肚區,福山里,288,1256,205,536,741,41,782
公投第１４案,臺中市,大肚區,福山里,289,1292,196,509,705,44,749
公投第１４案,臺中市,大肚區,福山里,290,1010,154,423,577,40,617
公投第１４案,臺中市,大肚區,營埔里,291,1485,259,581,840,78,918
公投第１４案,臺中市,大肚區,社腳里,292,1190,198,504,702,67,769
公投第１４案,臺中市,大肚區,社腳里,293,1250,206,472,678,64,742
公投第１４案,臺中市,大肚區,新興里,294,1310,220,518,738,42,780
公投第１４案,臺中市,大肚區,新興里,295,1294,212,483,695,39,734
公投第１４案,臺中市,大肚區,大東里,296,1734,273,756,1029,62,1091
公投第１４案,臺中市,大肚區,大東里,297,1316,186,525,711,53,764
公投第１４案,臺中市,大肚區,大肚里,298,854,149,329,478,32,510
公投第１４案,臺中市,大肚區,大肚里,299,1273,241,544,785,35,820
公投第１４案,臺中市,大肚區,永和里,300,851,152,370,522,24,546
公投第１４案,臺中市,大肚區,磺溪里,301,1629,241,645,886,36,922
公投第１４案,臺中市,大肚區,永順里,302,1709,242,636,878,77,955
公投第１４案,臺中市,大肚區,成功里,303,953,148,350,498,32,530
公投第１４案,臺中市,大肚區,山陽里,304,1336,206,555,761,53,814
公投第１４案,臺中市,大肚區,頂街里,305,2113,312,764,1076,70,1146
公投第１４案,臺中市,大肚區,頂街里,306,1730,271,666,937,81,1018
公投第１４案,臺中市,大肚區,頂街里,307,1692,289,641,930,29,959
公投第１４案,臺中市,大肚區,頂街里,308,1747,277,693,970,35,1005
公投第１４案,臺中市,大肚區,瑞井里,309,1672,268,626,894,66,960
公投第１４案,臺中市,大肚區,瑞井里,310,1675,251,613,864,43,907
公投第１４案,臺中市,大肚區,瑞井里,311,1673,236,663,899,63,962
公投第１４案,臺中市,大肚區,蔗廍里,312,1636,276,641,917,50,967
公投第１４案,臺中市,大肚區,蔗廍里,313,1753,265,629,894,59,953
公投第１４案,臺中市,大肚區,蔗廍里,314,1343,202,481,683,30,713
公投第１４案,臺中市,大肚區,自強里,315,1822,304,669,973,50,1023
公投第１４案,臺中市,大肚區,自強里,316,1670,263,675,938,92,1030
公投第１４案,臺中市,烏日區,烏日里,317,1480,266,620,886,48,934
公投第１４案,臺中市,烏日區,烏日里,318,1841,352,717,1069,67,1136
公投第１４案,臺中市,烏日區,烏日里,319,1751,294,649,943,62,1005
公投第１４案,臺中市,烏日區,烏日里,320,1547,273,623,896,64,960
公投第１４案,臺中市,烏日區,烏日里,321,1836,332,691,1023,46,1069
公投第１４案,臺中市,烏日區,湖日里,322,1239,281,456,737,93,830
公投第１４案,臺中市,烏日區,湖日里,323,1295,227,459,686,60,746
公投第１４案,臺中市,烏日區,三和里,324,1263,230,445,675,42,717
公投第１４案,臺中市,烏日區,三和里,325,1622,315,557,872,33,905
公投第１４案,臺中市,烏日區,三和里,326,1822,260,692,952,84,1036
公投第１４案,臺中市,烏日區,榮泉里,327,1966,320,719,1039,52,1091
公投第１４案,臺中市,烏日區,榮泉里,328,1615,271,623,894,58,952
公投第１４案,臺中市,烏日區,榮泉里,329,1232,244,499,743,30,773
公投第１４案,臺中市,烏日區,學田里,330,1347,200,526,726,28,754
公投第１４案,臺中市,烏日區,學田里,331,1165,195,399,594,32,626
公投第１４案,臺中市,烏日區,九德里,332,1664,298,666,964,41,1005
公投第１４案,臺中市,烏日區,九德里,333,1230,204,531,735,44,779
公投第１４案,臺中市,烏日區,九德里,334,1574,268,646,914,78,992
公投第１４案,臺中市,烏日區,九德里,335,1452,278,612,890,35,925
公投第１４案,臺中市,烏日區,九德里,336,1879,250,697,947,60,1007
公投第１４案,臺中市,烏日區,九德里,337,1601,294,597,891,37,928
公投第１４案,臺中市,烏日區,九德里,338,1546,288,616,904,43,947
公投第１４案,臺中市,烏日區,九德里,339,1866,292,617,909,39,948
公投第１４案,臺中市,烏日區,仁德里,340,1938,319,780,1099,68,1167
公投第１４案,臺中市,烏日區,仁德里,341,1759,310,650,960,63,1023
公投第１４案,臺中市,烏日區,仁德里,342,2061,347,748,1095,59,1154
公投第１４案,臺中市,烏日區,仁德里,343,1691,282,683,965,39,1004
公投第１４案,臺中市,烏日區,前竹里,344,1039,193,449,642,37,679
公投第１４案,臺中市,烏日區,前竹里,345,1221,197,515,712,38,750
公投第１４案,臺中市,烏日區,五光里,346,1650,288,648,936,66,1002
公投第１４案,臺中市,烏日區,光明里,347,937,170,374,544,36,580
公投第１４案,臺中市,烏日區,光明里,348,1220,219,465,684,44,728
公投第１４案,臺中市,烏日區,東園里,349,2139,313,744,1057,95,1152
公投第１４案,臺中市,烏日區,溪埧里,350,1371,230,602,832,56,888
公投第１４案,臺中市,烏日區,溪埧里,351,1277,179,519,698,53,751
公投第１４案,臺中市,烏日區,溪埧里,352,1708,272,627,899,53,952
公投第１４案,臺中市,烏日區,螺潭里,353,2048,290,772,1062,84,1146
公投第１４案,臺中市,烏日區,北里里,354,1632,250,589,839,66,905
公投第１４案,臺中市,烏日區,南里里,355,1327,223,519,742,63,805
公投第１４案,臺中市,烏日區,溪尾里,356,854,115,330,445,55,500
公投第１４案,臺中市,后里區,廣福里,357,852,134,361,495,51,546
公投第１４案,臺中市,后里區,廣福里,358,1135,161,431,592,58,650
公投第１４案,臺中市,后里區,仁里里,359,1079,158,377,535,53,588
公投第１４案,臺中市,后里區,義里里,360,1539,247,604,851,58,909
公投第１４案,臺中市,后里區,義里里,361,1591,270,599,869,59,928
公投第１４案,臺中市,后里區,義德里,362,1376,211,477,688,27,715
公投第１４案,臺中市,后里區,義德里,363,1298,206,509,715,24,739
公投第１４案,臺中市,后里區,后里里,364,1428,246,532,778,79,857
公投第１４案,臺中市,后里區,后里里,365,1178,218,520,738,45,783
公投第１４案,臺中市,后里區,后里里,366,1095,170,457,627,29,656
公投第１４案,臺中市,后里區,厚里里,367,963,159,366,525,25,550
公投第１４案,臺中市,后里區,厚里里,368,1163,193,439,632,40,672
公投第１４案,臺中市,后里區,墩東里,369,1018,166,417,583,36,619
公投第１４案,臺中市,后里區,墩東里,370,854,147,372,519,35,554
公投第１４案,臺中市,后里區,墩東里,371,1485,208,549,757,59,816
公投第１４案,臺中市,后里區,墩東里,372,1355,220,578,798,60,858
公投第１４案,臺中市,后里區,墩西里,373,840,129,288,417,50,467
公投第１４案,臺中市,后里區,墩西里,374,1146,179,460,639,48,687
公投第１４案,臺中市,后里區,墩南里,375,1669,263,691,954,72,1026
公投第１４案,臺中市,后里區,墩南里,376,1673,344,600,944,99,1043
公投第１４案,臺中市,后里區,墩北里,377,1493,241,583,824,47,871
公投第１４案,臺中市,后里區,墩北里,378,1052,193,401,594,61,655
公投第１４案,臺中市,后里區,墩北里,379,909,143,336,479,19,498
公投第１４案,臺中市,后里區,中和里,380,1091,181,423,604,65,669
公投第１４案,臺中市,后里區,中和里,381,1342,212,548,760,73,833
公投第１４案,臺中市,后里區,舊社里,382,1138,181,396,577,68,645
公投第１４案,臺中市,后里區,舊社里,383,977,144,404,548,42,590
公投第１４案,臺中市,后里區,聯合里,384,1584,203,544,747,38,785
公投第１４案,臺中市,后里區,太平里,385,915,129,368,497,43,540
公投第１４案,臺中市,后里區,太平里,386,1225,190,476,666,72,738
公投第１４案,臺中市,后里區,眉山里,387,1552,248,591,839,40,879
公投第１４案,臺中市,后里區,眉山里,388,1600,231,644,875,33,908
公投第１４案,臺中市,后里區,月眉里,389,942,148,356,504,30,534
公投第１４案,臺中市,后里區,月眉里,390,943,145,354,499,29,528
公投第１４案,臺中市,后里區,公館里,391,1055,169,347,516,46,562
公投第１４案,臺中市,后里區,公館里,392,1067,188,385,573,58,631
公投第１４案,臺中市,后里區,泰安里,393,1340,180,484,664,48,712
公投第１４案,臺中市,豐原區,豐原里,394,983,157,366,523,43,566
公投第１４案,臺中市,豐原區,豐原里,395,1309,226,541,767,34,801
公投第１４案,臺中市,豐原區,豐榮里,396,1116,225,411,636,48,684
公投第１４案,臺中市,豐原區,頂街里,397,945,169,382,551,57,608
公投第１４案,臺中市,豐原區,中山里,398,850,168,328,496,56,552
公投第１４案,臺中市,豐原區,下街里,399,760,141,316,457,39,496
公投第１４案,臺中市,豐原區,中陽里,400,1617,283,625,908,11,919
公投第１４案,臺中市,豐原區,中陽里,401,1677,236,615,851,44,895
公投第１４案,臺中市,豐原區,中陽里,402,1771,324,771,1095,39,1134
公投第１４案,臺中市,豐原區,大湳里,403,1145,165,461,626,42,668
公投第１４案,臺中市,豐原區,大湳里,404,1362,261,501,762,33,795
公投第１４案,臺中市,豐原區,北湳里,405,1389,234,566,800,45,845
公投第１４案,臺中市,豐原區,北湳里,406,1530,268,631,899,41,940
公投第１４案,臺中市,豐原區,東湳里,407,1471,231,587,818,64,882
公投第１４案,臺中市,豐原區,東湳里,408,1410,229,565,794,69,863
公投第１４案,臺中市,豐原區,東湳里,409,1162,179,459,638,44,682
公投第１４案,臺中市,豐原區,西湳里,410,1656,261,658,919,35,954
公投第１４案,臺中市,豐原區,西湳里,411,1838,259,744,1003,42,1045
公投第１４案,臺中市,豐原區,西湳里,412,1666,263,636,899,54,953
公投第１４案,臺中市,豐原區,西湳里,413,1821,370,650,1020,77,1097
公投第１４案,臺中市,豐原區,西湳里,414,1821,341,796,1137,76,1213
公投第１４案,臺中市,豐原區,豐西里,415,1647,311,596,907,36,943
公投第１４案,臺中市,豐原區,圳寮里,416,1256,268,498,766,77,843
公投第１４案,臺中市,豐原區,豐圳里,417,1552,265,680,945,45,990
公投第１４案,臺中市,豐原區,豐圳里,418,1793,307,709,1016,39,1055
公投第１４案,臺中市,豐原區,富春里,419,759,161,338,499,35,534
公投第１４案,臺中市,豐原區,葫蘆里,420,642,142,257,399,25,424
公投第１４案,臺中市,豐原區,西安里,421,1528,297,610,907,33,940
公投第１４案,臺中市,豐原區,西安里,422,1788,319,767,1086,53,1139
公投第１４案,臺中市,豐原區,西安里,423,1663,349,668,1017,67,1084
公投第１４案,臺中市,豐原區,西勢里,424,1260,251,567,818,57,875
公投第１４案,臺中市,豐原區,西勢里,425,902,150,345,495,40,535
公投第１４案,臺中市,豐原區,中興里,426,1357,213,518,731,31,762
公投第１４案,臺中市,豐原區,中興里,427,1592,664,272,936,46,982
公投第１４案,臺中市,豐原區,社皮里,428,1873,291,742,1033,70,1103
公投第１４案,臺中市,豐原區,社皮里,429,1867,296,734,1030,61,1091
公投第１４案,臺中市,豐原區,社皮里,430,1823,297,697,994,66,1060
公投第１４案,臺中市,豐原區,社皮里,431,1962,325,669,994,50,1044
公投第１４案,臺中市,豐原區,社皮里,432,2313,447,904,1351,62,1413
公投第１４案,臺中市,豐原區,三村里,433,1510,272,603,875,63,938
公投第１４案,臺中市,豐原區,三村里,434,1824,317,711,1028,68,1096
公投第１４案,臺中市,豐原區,三村里,435,1363,241,548,789,39,828
公投第１４案,臺中市,豐原區,三村里,436,1535,268,650,918,49,967
公投第１４案,臺中市,豐原區,東勢里,437,1457,301,557,858,46,904
公投第１４案,臺中市,豐原區,民生里,438,1184,225,474,699,35,734
公投第１４案,臺中市,豐原區,田心里,439,2299,375,700,1075,47,1122
公投第１４案,臺中市,豐原區,田心里,440,1940,317,756,1073,83,1156
公投第１４案,臺中市,豐原區,田心里,441,2067,354,777,1131,48,1179
公投第１４案,臺中市,豐原區,豐田里,442,2038,344,740,1084,68,1152
公投第１４案,臺中市,豐原區,豐田里,443,1835,329,685,1014,53,1067
公投第１４案,臺中市,豐原區,豐田里,444,1979,308,761,1069,78,1147
公投第１４案,臺中市,豐原區,豐田里,445,2014,327,749,1076,67,1143
公投第１４案,臺中市,豐原區,豐田里,446,2257,346,887,1233,89,1322
公投第１４案,臺中市,豐原區,鎌村里,447,1406,230,612,842,51,893
公投第１４案,臺中市,豐原區,鎌村里,448,1418,270,558,828,42,870
公投第１４案,臺中市,豐原區,鎌村里,449,1772,279,776,1055,67,1122
公投第１４案,臺中市,豐原區,陽明里,450,1202,236,514,750,30,780
公投第１４案,臺中市,豐原區,陽明里,451,1447,255,611,866,33,899
公投第１４案,臺中市,豐原區,南陽里,452,1758,276,731,1007,80,1087
公投第１４案,臺中市,豐原區,南陽里,453,1546,279,669,948,42,990
公投第１４案,臺中市,豐原區,南陽里,454,1815,298,775,1073,56,1129
公投第１４案,臺中市,豐原區,南陽里,455,1932,373,730,1103,65,1168
公投第１４案,臺中市,豐原區,南陽里,456,1770,322,769,1091,49,1140
公投第１４案,臺中市,豐原區,南陽里,457,1560,236,608,844,28,872
公投第１４案,臺中市,豐原區,北陽里,458,1810,323,695,1018,49,1067
公投第１４案,臺中市,豐原區,北陽里,459,1653,344,666,1010,41,1051
公投第１４案,臺中市,豐原區,北陽里,460,1444,200,614,814,54,868
公投第１４案,臺中市,豐原區,北陽里,461,1318,251,562,813,27,840
公投第１４案,臺中市,豐原區,北陽里,462,1566,309,583,892,69,961
公投第１４案,臺中市,豐原區,北陽里,463,1748,290,688,978,45,1023
公投第１４案,臺中市,豐原區,北陽里,464,1772,272,624,896,70,966
公投第１４案,臺中市,豐原區,北陽里,465,1721,259,695,954,58,1012
公投第１４案,臺中市,豐原區,東陽里,466,1578,258,648,906,49,955
公投第１４案,臺中市,豐原區,南村里,467,1859,351,656,1007,87,1094
公投第１４案,臺中市,豐原區,南村里,468,1479,285,548,833,45,878
公投第１４案,臺中市,豐原區,南村里,469,1889,305,765,1070,57,1127
公投第１４案,臺中市,豐原區,南田里,470,1803,280,692,972,63,1035
公投第１４案,臺中市,豐原區,南田里,471,1421,250,478,728,57,785
公投第１４案,臺中市,豐原區,南嵩里,472,1585,194,758,952,55,1007
公投第１４案,臺中市,豐原區,南嵩里,473,1774,312,731,1043,73,1116
公投第１４案,臺中市,豐原區,翁明里,474,2132,201,991,1192,68,1260
公投第１４案,臺中市,豐原區,翁子里,475,1515,228,617,845,62,907
公投第１４案,臺中市,豐原區,翁子里,476,1359,212,501,713,32,745
公投第１４案,臺中市,豐原區,翁社里,477,948,182,381,563,40,603
公投第１４案,臺中市,豐原區,翁社里,478,1134,203,471,674,40,714
公投第１４案,臺中市,豐原區,朴子里,479,1114,198,493,691,58,749
公投第１４案,臺中市,豐原區,朴子里,480,1050,172,414,586,53,639
公投第１４案,臺中市,豐原區,朴子里,481,1182,253,471,724,52,776
公投第１４案,臺中市,神岡區,神岡里,482,1684,284,688,972,56,1028
公投第１４案,臺中市,神岡區,神岡里,483,1559,221,654,875,47,922
公投第１４案,臺中市,神岡區,庄前里,484,1095,179,420,599,42,641
公投第１４案,臺中市,神岡區,庄前里,485,1044,205,468,673,38,711
公投第１４案,臺中市,神岡區,北庄里,486,1310,224,572,796,58,854
公投第１４案,臺中市,神岡區,北庄里,487,1294,231,516,747,79,826
公投第１４案,臺中市,神岡區,庄後里,488,1143,199,441,640,55,695
公投第１４案,臺中市,神岡區,庄後里,489,1022,165,417,582,56,638
公投第１４案,臺中市,神岡區,圳前里,490,1269,166,511,677,42,719
公投第１４案,臺中市,神岡區,圳前里,491,1085,129,383,512,28,540
公投第１４案,臺中市,神岡區,圳堵里,492,942,182,388,570,31,601
公投第１４案,臺中市,神岡區,圳堵里,493,1154,191,447,638,39,677
公投第１４案,臺中市,神岡區,新庄里,494,1390,228,511,739,48,787
公投第１４案,臺中市,神岡區,新庄里,495,1372,218,569,787,82,869
公投第１４案,臺中市,神岡區,新庄里,496,1328,194,501,695,40,735
公投第１４案,臺中市,神岡區,山皮里,497,1038,183,379,562,32,594
公投第１４案,臺中市,神岡區,社口里,498,1452,211,568,779,42,821
公投第１４案,臺中市,神岡區,社口里,499,1551,259,643,902,153,1055
公投第１４案,臺中市,神岡區,社口里,500,1567,244,572,816,52,868
公投第１４案,臺中市,神岡區,社口里,501,1449,239,571,810,32,842
公投第１４案,臺中市,神岡區,社口里,502,1246,174,468,642,29,671
公投第１４案,臺中市,神岡區,社南里,503,1431,228,574,802,43,845
公投第１４案,臺中市,神岡區,社南里,504,1163,220,455,675,59,734
公投第１４案,臺中市,神岡區,社南里,505,1402,286,559,845,64,909
公投第１４案,臺中市,神岡區,社南里,506,1271,211,521,732,34,766
公投第１４案,臺中市,神岡區,三角里,507,1198,274,416,690,54,744
公投第１４案,臺中市,神岡區,三角里,508,1312,199,549,748,57,805
公投第１４案,臺中市,神岡區,大社里,509,1590,242,607,849,57,906
公投第１４案,臺中市,神岡區,大社里,510,1324,198,520,718,26,744
公投第１４案,臺中市,神岡區,大社里,511,1415,257,498,755,33,788
公投第１４案,臺中市,神岡區,岸裡里,512,1483,244,663,907,50,957
公投第１４案,臺中市,神岡區,岸裡里,513,1402,208,522,730,35,765
公投第１４案,臺中市,神岡區,豐洲里,514,1275,199,474,673,41,714
公投第１４案,臺中市,神岡區,豐洲里,515,1288,192,469,661,44,705
公投第１４案,臺中市,神岡區,豐洲里,516,1080,147,411,558,53,611
公投第１４案,臺中市,神岡區,豐洲里,517,1344,221,507,728,31,759
公投第１４案,臺中市,神岡區,豐洲里,518,1061,178,446,624,43,667
公投第１４案,臺中市,神岡區,豐洲里,519,1176,214,480,694,54,748
公投第１４案,臺中市,神岡區,神洲里,520,1244,218,509,727,53,780
公投第１４案,臺中市,神岡區,神洲里,521,1318,225,565,790,60,850
公投第１４案,臺中市,神岡區,溪洲里,522,1471,225,573,798,33,831
公投第１４案,臺中市,神岡區,溪洲里,523,1323,208,596,804,75,879
公投第１４案,臺中市,大雅區,上雅里,524,2027,315,802,1117,51,1168
公投第１４案,臺中市,大雅區,上雅里,525,1967,309,686,995,28,1023
公投第１４案,臺中市,大雅區,上雅里,526,1912,326,685,1011,38,1049
公投第１４案,臺中市,大雅區,大雅里,527,1537,288,620,908,32,940
公投第１４案,臺中市,大雅區,大雅里,528,1439,254,610,864,33,897
公投第１４案,臺中市,大雅區,大雅里,529,1402,249,536,785,52,837
公投第１４案,臺中市,大雅區,文雅里,530,2013,352,710,1062,44,1106
公投第１４案,臺中市,大雅區,文雅里,531,1917,333,736,1069,63,1132
公投第１４案,臺中市,大雅區,文雅里,532,2011,346,727,1073,48,1121
公投第１４案,臺中市,大雅區,三和里,533,1887,286,775,1061,48,1109
公投第１４案,臺中市,大雅區,三和里,534,1480,293,568,861,46,907
公投第１４案,臺中市,大雅區,三和里,535,1816,321,681,1002,40,1042
公投第１４案,臺中市,大雅區,二和里,536,1898,300,621,921,62,983
公投第１４案,臺中市,大雅區,二和里,537,2008,285,807,1092,60,1152
公投第１４案,臺中市,大雅區,二和里,538,1976,336,761,1097,52,1149
公投第１４案,臺中市,大雅區,四德里,539,1673,291,645,936,49,985
公投第１４案,臺中市,大雅區,四德里,540,1409,243,601,844,36,880
公投第１４案,臺中市,大雅區,四德里,541,1382,242,566,808,15,823
公投第１４案,臺中市,大雅區,西寶里,542,1635,228,633,861,72,933
公投第１４案,臺中市,大雅區,西寶里,543,1565,263,618,881,54,935
公投第１４案,臺中市,大雅區,西寶里,544,1528,247,566,813,34,847
公投第１４案,臺中市,大雅區,上楓里,545,1963,280,752,1032,37,1069
公投第１４案,臺中市,大雅區,上楓里,546,2073,320,735,1055,43,1098
公投第１４案,臺中市,大雅區,上楓里,547,1984,314,718,1032,68,1100
公投第１４案,臺中市,大雅區,大楓里,548,1688,271,635,906,43,949
公投第１４案,臺中市,大雅區,大楓里,549,1387,237,546,783,26,809
公投第１４案,臺中市,大雅區,大楓里,550,1701,279,679,958,80,1038
公投第１４案,臺中市,大雅區,雅楓里,551,1721,62,865,927,47,974
公投第１４案,臺中市,大雅區,雅楓里,552,1879,253,610,863,40,903
公投第１４案,臺中市,大雅區,員林里,553,1568,274,681,955,44,999
公投第１４案,臺中市,大雅區,員林里,554,1761,315,649,964,69,1033
公投第１４案,臺中市,大雅區,員林里,555,1752,289,721,1010,63,1073
公投第１４案,臺中市,大雅區,員林里,556,1264,212,512,724,34,758
公投第１４案,臺中市,大雅區,員林里,557,1302,207,559,766,43,809
公投第１４案,臺中市,大雅區,員林里,558,1449,238,538,776,58,834
公投第１４案,臺中市,大雅區,六寶里,559,1621,285,645,930,65,995
公投第１４案,臺中市,大雅區,六寶里,560,1647,231,631,862,60,922
公投第１４案,臺中市,大雅區,六寶里,561,1441,252,542,794,28,822
公投第１４案,臺中市,大雅區,六寶里,562,1460,240,557,797,30,827
公投第１４案,臺中市,大雅區,秀山里,563,1832,296,754,1050,77,1127
公投第１４案,臺中市,大雅區,秀山里,564,1371,232,579,811,60,871
公投第１４案,臺中市,大雅區,橫山里,565,1418,202,539,741,11,752
公投第１４案,臺中市,大雅區,橫山里,566,1473,246,623,869,30,899
公投第１４案,臺中市,大雅區,橫山里,567,1335,234,494,728,56,784
公投第１４案,臺中市,大雅區,忠義里,568,1733,211,717,928,61,989
公投第１４案,臺中市,大雅區,忠義里,569,1884,221,644,865,99,964
公投第１４案,臺中市,潭子區,潭秀里,570,1306,227,537,764,40,804
公投第１４案,臺中市,潭子區,潭北里,571,1128,201,454,655,44,699
公投第１４案,臺中市,潭子區,潭北里,572,1159,198,490,688,55,743
公投第１４案,臺中市,潭子區,潭陽里,573,1630,287,648,935,71,1006
公投第１４案,臺中市,潭子區,潭陽里,574,1532,238,613,851,41,892
公投第１４案,臺中市,潭子區,潭陽里,575,1677,256,592,848,40,888
公投第１４案,臺中市,潭子區,潭陽里,576,1744,263,608,871,57,928
公投第１４案,臺中市,潭子區,潭陽里,577,1795,302,644,946,90,1036
公投第１４案,臺中市,潭子區,潭陽里,578,1171,199,437,636,46,682
公投第１４案,臺中市,潭子區,潭陽里,579,1427,246,552,798,23,821
公投第１４案,臺中市,潭子區,福仁里,580,1709,257,675,932,53,985
公投第１４案,臺中市,潭子區,福仁里,581,1723,287,645,932,40,972
公投第１４案,臺中市,潭子區,福仁里,582,1782,267,680,947,46,993
公投第１４案,臺中市,潭子區,福仁里,583,1407,205,538,743,27,770
公投第１４案,臺中市,潭子區,福仁里,584,1771,361,653,1014,39,1053
公投第１４案,臺中市,潭子區,福仁里,585,1795,282,723,1005,82,1087
公投第１４案,臺中市,潭子區,頭家里,586,1612,293,664,957,54,1011
公投第１４案,臺中市,潭子區,頭家里,587,1894,336,708,1044,30,1074
公投第１４案,臺中市,潭子區,頭家里,588,1689,289,646,935,41,976
公投第１４案,臺中市,潭子區,頭家東里,589,1525,243,537,780,42,822
公投第１４案,臺中市,潭子區,頭家東里,590,1622,280,606,886,36,922
公投第１４案,臺中市,潭子區,頭家東里,591,1200,200,503,703,48,751
公投第１４案,臺中市,潭子區,家興里,592,1355,214,505,719,19,738
公投第１４案,臺中市,潭子區,家興里,593,1777,301,642,943,32,975
公投第１４案,臺中市,潭子區,家興里,594,1923,294,755,1049,49,1098
公投第１４案,臺中市,潭子區,家興里,595,1674,247,612,859,64,923
公投第１４案,臺中市,潭子區,家福里,596,1451,273,592,865,46,911
公投第１４案,臺中市,潭子區,家福里,597,1486,247,578,825,59,884
公投第１４案,臺中市,潭子區,家福里,598,1511,262,615,877,42,919
公投第１４案,臺中市,潭子區,甘蔗里,599,1666,282,672,954,46,1000
公投第１４案,臺中市,潭子區,甘蔗里,600,1750,290,653,943,46,989
公投第１４案,臺中市,潭子區,甘蔗里,601,1437,221,560,781,36,817
公投第１４案,臺中市,潭子區,甘蔗里,602,1735,291,661,952,31,983
公投第１４案,臺中市,潭子區,甘蔗里,603,1612,284,579,863,34,897
公投第１４案,臺中市,潭子區,甘蔗里,604,1143,223,458,681,25,706
公投第１４案,臺中市,潭子區,東寶里,605,2096,305,804,1109,44,1153
公投第１４案,臺中市,潭子區,東寶里,606,1549,267,623,890,53,943
公投第１４案,臺中市,潭子區,東寶里,607,1573,256,634,890,36,926
公投第１４案,臺中市,潭子區,東寶里,608,1585,213,628,841,40,881
公投第１４案,臺中市,潭子區,東寶里,609,1572,288,568,856,24,880
公投第１４案,臺中市,潭子區,東寶里,610,1738,291,722,1013,33,1046
公投第１４案,臺中市,潭子區,東寶里,611,1883,298,689,987,65,1052
公投第１４案,臺中市,潭子區,大富里,612,1401,596,234,830,36,866
公投第１４案,臺中市,潭子區,大富里,613,1352,237,560,797,35,832
公投第１４案,臺中市,潭子區,大豐里,614,2085,320,841,1161,76,1237
公投第１４案,臺中市,潭子區,大豐里,615,2047,340,836,1176,66,1242
公投第１４案,臺中市,潭子區,大豐里,616,1673,275,621,896,26,922
公投第１４案,臺中市,潭子區,栗林里,617,1874,331,698,1029,84,1113
公投第１４案,臺中市,潭子區,栗林里,618,1051,183,411,594,37,631
公投第１４案,臺中市,潭子區,栗林里,619,1674,782,93,875,30,905
公投第１４案,臺中市,潭子區,嘉仁里,620,1831,292,726,1018,60,1078
公投第１４案,臺中市,潭子區,嘉仁里,621,2003,311,734,1045,57,1102
公投第１４案,臺中市,潭子區,新田里,622,1535,243,605,848,33,881
公投第１４案,臺中市,潭子區,聚興里,623,2286,298,779,1077,89,1166
公投第１４案,臺中市,潭子區,聚興里,624,1861,245,699,944,58,1002
公投第１４案,臺中市,西屯區,西安里,625,1638,349,621,970,52,1022
公投第１４案,臺中市,西屯區,西安里,626,1335,294,457,751,35,786
公投第１４案,臺中市,西屯區,西安里,627,1776,340,657,997,36,1033
公投第１４案,臺中市,西屯區,至善里,628,1351,263,486,749,34,783
公投第１４案,臺中市,西屯區,至善里,629,1338,276,500,776,43,819
公投第１４案,臺中市,西屯區,至善里,630,1582,301,585,886,33,919
公投第１４案,臺中市,西屯區,西平里,631,1710,264,618,882,35,917
公投第１４案,臺中市,西屯區,西平里,632,1595,283,527,810,45,855
公投第１４案,臺中市,西屯區,西平里,633,1585,244,648,892,44,936
公投第１４案,臺中市,西屯區,西墩里,634,1749,283,635,918,62,980
公投第１４案,臺中市,西屯區,西墩里,635,1877,313,718,1031,46,1077
公投第１４案,臺中市,西屯區,西墩里,636,1697,321,559,880,43,923
公投第１４案,臺中市,西屯區,潮洋里,637,1480,272,590,862,45,907
公投第１４案,臺中市,西屯區,潮洋里,638,1483,336,580,916,59,975
公投第１４案,臺中市,西屯區,潮洋里,639,2484,308,561,869,37,906
公投第１４案,臺中市,西屯區,龍潭里,640,781,138,358,496,31,527
公投第１４案,臺中市,西屯區,惠來里,641,1477,252,597,849,47,896
公投第１４案,臺中市,西屯區,惠來里,642,1784,345,624,969,30,999
公投第１４案,臺中市,西屯區,惠來里,643,1686,303,624,927,34,961
公投第１４案,臺中市,西屯區,惠來里,644,1692,337,600,937,29,966
公投第１４案,臺中市,西屯區,惠來里,645,1659,283,591,874,31,905
公投第１４案,臺中市,西屯區,惠來里,646,1648,327,508,835,17,852
公投第１４案,臺中市,西屯區,惠來里,647,1536,336,578,914,26,940
公投第１４案,臺中市,西屯區,惠來里,648,1666,299,652,951,47,998
公投第１４案,臺中市,西屯區,上石里,649,1428,284,530,814,37,851
公投第１４案,臺中市,西屯區,上石里,650,1810,315,628,943,46,989
公投第１４案,臺中市,西屯區,上石里,651,1574,313,547,860,33,893
公投第１４案,臺中市,西屯區,上安里,652,1650,321,604,925,14,939
公投第１４案,臺中市,西屯區,上安里,653,1681,323,592,915,56,971
公投第１４案,臺中市,西屯區,上安里,654,1656,335,569,904,40,944
公投第１４案,臺中市,西屯區,上德里,655,1243,210,504,714,50,764
公投第１４案,臺中市,西屯區,上德里,656,1471,313,586,899,40,939
公投第１４案,臺中市,西屯區,上德里,657,1431,309,553,862,35,897
公投第１４案,臺中市,西屯區,逢甲里,658,1714,329,617,946,34,980
公投第１４案,臺中市,西屯區,逢甲里,659,1424,223,567,790,51,841
公投第１４案,臺中市,西屯區,逢甲里,660,1176,200,471,671,29,700
公投第１４案,臺中市,西屯區,逢福里,661,1456,289,554,843,35,878
公投第１４案,臺中市,西屯區,逢福里,662,1451,292,590,882,25,907
公投第１４案,臺中市,西屯區,逢福里,663,1063,227,443,670,25,695
公投第１４案,臺中市,西屯區,逢福里,664,1357,211,550,761,31,792
公投第１４案,臺中市,西屯區,鵬程里,665,1355,202,580,782,59,841
公投第１４案,臺中市,西屯區,鵬程里,666,1384,233,586,819,24,843
公投第１４案,臺中市,西屯區,何厝里,667,1613,317,605,922,42,964
公投第１４案,臺中市,西屯區,何厝里,668,1562,283,568,851,58,909
公投第１４案,臺中市,西屯區,何明里,669,1219,245,523,768,36,804
公投第１４案,臺中市,西屯區,何明里,670,1235,253,439,692,40,732
公投第１４案,臺中市,西屯區,何明里,671,1131,215,413,628,52,680
公投第１４案,臺中市,西屯區,何南里,672,1494,315,597,912,23,935
公投第１４案,臺中市,西屯區,何南里,673,1325,305,458,763,28,791
公投第１４案,臺中市,西屯區,何南里,674,1386,283,504,787,44,831
公投第１４案,臺中市,西屯區,何成里,675,1816,379,638,1017,60,1077
公投第１４案,臺中市,西屯區,何成里,676,1734,324,600,924,26,950
公投第１４案,臺中市,西屯區,何成里,677,1777,376,626,1002,58,1060
公投第１４案,臺中市,西屯區,何成里,678,1818,350,597,947,48,995
公投第１４案,臺中市,西屯區,何安里,679,1699,312,591,903,62,965
公投第１４案,臺中市,西屯區,何安里,680,1715,289,583,872,36,908
公投第１４案,臺中市,西屯區,何安里,681,1654,310,551,861,43,904
公投第１４案,臺中市,西屯區,何仁里,682,1636,310,578,888,25,913
公投第１４案,臺中市,西屯區,何仁里,683,1298,240,471,711,27,738
公投第１４案,臺中市,西屯區,何仁里,684,1391,245,549,794,46,840
公投第１４案,臺中市,西屯區,何仁里,685,1853,350,700,1050,48,1098
公投第１４案,臺中市,西屯區,何德里,686,1820,309,662,971,45,1016
公投第１４案,臺中市,西屯區,何德里,687,1809,344,666,1010,52,1062
公投第１４案,臺中市,西屯區,何福里,688,1352,258,546,804,46,850
公投第１４案,臺中市,西屯區,何福里,689,1521,259,586,845,48,893
公投第１４案,臺中市,西屯區,何福里,690,1486,291,587,878,35,913
公投第１４案,臺中市,西屯區,何源里,691,1674,302,649,951,40,991
公投第１４案,臺中市,西屯區,何源里,692,1610,334,624,958,51,1009
公投第１４案,臺中市,西屯區,何源里,693,1695,340,600,940,52,992
公投第１４案,臺中市,西屯區,何源里,694,1684,327,575,902,44,946
公投第１４案,臺中市,西屯區,大河里,695,1221,249,473,722,31,753
公投第１４案,臺中市,西屯區,大河里,696,1252,240,549,789,63,852
公投第１４案,臺中市,西屯區,大河里,697,1301,267,505,772,44,816
公投第１４案,臺中市,西屯區,大石里,698,1049,133,510,643,28,671
公投第１４案,臺中市,西屯區,大石里,699,1113,152,495,647,34,681
公投第１４案,臺中市,西屯區,大福里,700,1557,216,602,818,39,857
公投第１４案,臺中市,西屯區,大福里,701,1640,256,617,873,38,911
公投第１４案,臺中市,西屯區,大鵬里,702,1402,262,587,849,86,935
公投第１４案,臺中市,西屯區,大鵬里,703,1717,259,587,846,61,907
公投第１４案,臺中市,西屯區,大鵬里,704,1688,289,617,906,54,960
公投第１４案,臺中市,西屯區,港尾里,705,1168,176,452,628,93,721
公投第１４案,臺中市,西屯區,港尾里,706,1729,271,620,891,56,947
公投第１４案,臺中市,西屯區,港尾里,707,2007,336,689,1025,49,1074
公投第１４案,臺中市,西屯區,廣福里,708,1296,225,496,721,81,802
公投第１４案,臺中市,西屯區,廣福里,709,1068,173,374,547,26,573
公投第１４案,臺中市,西屯區,林厝里,710,1707,239,594,833,79,912
公投第１４案,臺中市,西屯區,林厝里,711,1636,313,618,931,35,966
公投第１４案,臺中市,西屯區,永安里,712,1761,230,559,789,37,826
公投第１４案,臺中市,西屯區,永安里,713,1314,245,509,754,35,789
公投第１４案,臺中市,西屯區,永安里,714,1233,251,503,754,37,791
公投第１４案,臺中市,西屯區,永安里,715,1549,266,552,818,40,858
公投第１４案,臺中市,西屯區,永安里,716,1639,285,592,877,24,901
公投第１４案,臺中市,西屯區,永安里,717,1486,210,560,770,38,808
公投第１４案,臺中市,西屯區,永安里,718,1806,381,576,957,27,984
公投第１４案,臺中市,西屯區,永安里,719,1451,306,466,772,20,792
公投第１４案,臺中市,西屯區,福安里,720,1302,217,536,753,22,775
公投第１４案,臺中市,西屯區,福安里,721,1353,288,516,804,46,850
公投第１４案,臺中市,西屯區,福雅里,722,2162,406,798,1204,53,1257
公投第１４案,臺中市,西屯區,福雅里,723,1520,272,558,830,32,862
公投第１４案,臺中市,西屯區,福雅里,724,1935,347,686,1033,42,1075
公投第１４案,臺中市,西屯區,福林里,725,1847,353,658,1011,42,1053
公投第１４案,臺中市,西屯區,福林里,726,1738,357,614,971,37,1008
公投第１４案,臺中市,西屯區,福林里,727,1640,320,646,966,40,1006
公投第１４案,臺中市,西屯區,福林里,728,1908,378,688,1066,39,1105
公投第１４案,臺中市,西屯區,福瑞里,729,1402,296,493,789,30,819
公投第１４案,臺中市,西屯區,福瑞里,730,1515,290,494,784,37,821
公投第１４案,臺中市,西屯區,福聯里,731,1541,235,481,716,40,756
公投第１４案,臺中市,西屯區,福聯里,732,1502,302,503,805,29,834
公投第１４案,臺中市,西屯區,福和里,733,1526,304,544,848,55,903
公投第１４案,臺中市,西屯區,福和里,734,1425,284,545,829,47,876
公投第１４案,臺中市,西屯區,福和里,735,1334,283,502,785,49,834
公投第１４案,臺中市,西屯區,福中里,736,1649,336,628,964,45,1009
公投第１４案,臺中市,西屯區,福中里,737,1566,308,547,855,27,882
公投第１４案,臺中市,西屯區,福恩里,738,1629,361,598,959,36,995
公投第１４案,臺中市,西屯區,福恩里,739,1628,328,575,903,56,959
公投第１４案,臺中市,西屯區,福恩里,740,1442,318,551,869,24,893
公投第１４案,臺中市,西屯區,協和里,741,1206,216,402,618,50,668
公投第１４案,臺中市,西屯區,協和里,742,1086,182,446,628,61,689
公投第１４案,臺中市,西屯區,協和里,743,1088,178,464,642,43,685
公投第１４案,臺中市,西屯區,協和里,744,1140,221,439,660,29,689
公投第１４案,臺中市,南屯區,南屯里,745,1321,234,519,753,54,807
公投第１４案,臺中市,南屯區,南屯里,746,1346,297,501,798,46,844
公投第１４案,臺中市,南屯區,南屯里,747,1428,251,576,827,45,872
公投第１４案,臺中市,南屯區,南屯里,748,1442,274,533,807,29,836
公投第１４案,臺中市,南屯區,南屯里,749,1408,301,575,876,29,905
公投第１４案,臺中市,南屯區,南屯里,750,1404,281,563,844,20,864
公投第１４案,臺中市,南屯區,豐樂里,751,1354,268,550,818,46,864
公投第１４案,臺中市,南屯區,豐樂里,752,1332,269,533,802,37,839
公投第１４案,臺中市,南屯區,豐樂里,753,1463,315,575,890,34,924
公投第１４案,臺中市,南屯區,豐樂里,754,1413,290,528,818,39,857
公投第１４案,臺中市,南屯區,豐樂里,755,1218,277,479,756,28,784
公投第１４案,臺中市,南屯區,豐樂里,756,1308,258,504,762,35,797
公投第１４案,臺中市,南屯區,豐樂里,757,1527,300,632,932,36,968
公投第１４案,臺中市,南屯區,豐樂里,758,1294,271,512,783,35,818
公投第１４案,臺中市,南屯區,楓樹里,759,1516,239,535,774,43,817
公投第１４案,臺中市,南屯區,楓樹里,760,1529,294,587,881,71,952
公投第１４案,臺中市,南屯區,楓樹里,761,1397,249,558,807,56,863
公投第１４案,臺中市,南屯區,楓樹里,762,1406,224,534,758,41,799
公投第１４案,臺中市,南屯區,中和里,763,1497,225,559,784,41,825
公投第１４案,臺中市,南屯區,中和里,764,1424,249,511,760,56,816
公投第１４案,臺中市,南屯區,中和里,765,1488,271,446,717,44,761
公投第１４案,臺中市,南屯區,鎮平里,766,608,126,243,369,38,407
公投第１４案,臺中市,南屯區,鎮平里,767,813,144,330,474,62,536
公投第１４案,臺中市,南屯區,春社里,768,1190,213,470,683,53,736
公投第１４案,臺中市,南屯區,春社里,769,1174,180,466,646,31,677
公投第１４案,臺中市,南屯區,春社里,770,1224,205,504,709,15,724
公投第１４案,臺中市,南屯區,春社里,771,1466,212,481,693,48,741
公投第１４案,臺中市,南屯區,春社里,772,1333,143,402,545,28,573
公投第１４案,臺中市,南屯區,春安里,773,814,162,320,482,40,522
公投第１４案,臺中市,南屯區,文山里,774,1436,199,549,748,52,800
公投第１４案,臺中市,南屯區,文山里,775,1515,294,563,857,49,906
公投第１４案,臺中市,南屯區,文山里,776,1545,246,516,762,36,798
公投第１４案,臺中市,南屯區,文山里,777,1383,258,519,777,38,815
公投第１４案,臺中市,南屯區,文山里,778,1433,243,574,817,38,855
公投第１４案,臺中市,南屯區,文山里,779,1134,228,377,605,22,627
公投第１４案,臺中市,南屯區,文山里,780,1216,226,505,731,31,762
公投第１４案,臺中市,南屯區,寶山里,781,1271,213,450,663,75,738
公投第１４案,臺中市,南屯區,寶山里,782,1203,221,426,647,21,668
公投第１４案,臺中市,南屯區,寶山里,783,1268,227,500,727,20,747
公投第１４案,臺中市,南屯區,寶山里,784,1390,242,551,793,41,834
公投第１４案,臺中市,南屯區,新生里,785,1397,245,517,762,45,807
公投第１４案,臺中市,南屯區,永定里,786,1607,278,585,863,60,923
公投第１４案,臺中市,南屯區,永定里,787,1582,290,624,914,38,952
公投第１４案,臺中市,南屯區,永定里,788,1611,278,629,907,49,956
公投第１４案,臺中市,南屯區,三厝里,789,1322,275,535,810,33,843
公投第１４案,臺中市,南屯區,三厝里,790,1321,283,545,828,35,863
公投第１４案,臺中市,南屯區,三厝里,791,1360,251,541,792,40,832
公投第１４案,臺中市,南屯區,三厝里,792,1361,279,548,827,12,839
公投第１４案,臺中市,南屯區,三厝里,793,1257,288,479,767,30,797
公投第１４案,臺中市,南屯區,三義里,794,1207,256,504,760,23,783
公投第１４案,臺中市,南屯區,三義里,795,1282,399,395,794,28,822
公投第１４案,臺中市,南屯區,三義里,796,1248,272,523,795,27,822
公投第１４案,臺中市,南屯區,三義里,797,1304,292,521,813,38,851
公投第１４案,臺中市,南屯區,三義里,798,1214,279,424,703,42,745
公投第１４案,臺中市,南屯區,三和里,799,1102,245,432,677,37,714
公投第１４案,臺中市,南屯區,三和里,800,1630,330,684,1014,38,1052
公投第１４案,臺中市,南屯區,三和里,801,1333,302,495,797,34,831
公投第１４案,臺中市,南屯區,三和里,802,1292,289,491,780,26,806
公投第１４案,臺中市,南屯區,三和里,803,1272,260,495,755,35,790
公投第１４案,臺中市,南屯區,三和里,804,1345,283,512,795,26,821
公投第１４案,臺中市,南屯區,黎明里,805,981,216,448,664,25,689
公投第１４案,臺中市,南屯區,黎明里,806,1097,195,459,654,48,702
公投第１４案,臺中市,南屯區,黎明里,807,991,177,452,629,20,649
公投第１４案,臺中市,南屯區,黎明里,808,1170,220,481,701,23,724
公投第１４案,臺中市,南屯區,溝墘里,809,1171,244,473,717,33,750
公投第１４案,臺中市,南屯區,溝墘里,810,1349,284,477,761,46,807
公投第１４案,臺中市,南屯區,溝墘里,811,1368,287,556,843,29,872
公投第１４案,臺中市,南屯區,溝墘里,812,1263,282,507,789,31,820
公投第１４案,臺中市,南屯區,大業里,813,1547,334,587,921,37,958
公投第１４案,臺中市,南屯區,大業里,814,1649,335,606,941,49,990
公投第１４案,臺中市,南屯區,大業里,815,1629,306,600,906,31,937
公投第１４案,臺中市,南屯區,大業里,816,1580,295,519,814,35,849
公投第１４案,臺中市,南屯區,惠中里,817,1444,309,600,909,39,948
公投第１４案,臺中市,南屯區,惠中里,818,1413,267,544,811,26,837
公投第１４案,臺中市,南屯區,惠中里,819,1377,238,541,779,31,810
公投第１４案,臺中市,南屯區,惠中里,820,1527,365,546,911,24,935
公投第１４案,臺中市,南屯區,惠中里,821,1335,290,519,809,29,838
公投第１４案,臺中市,南屯區,田心里,822,1544,355,647,1002,29,1031
公投第１４案,臺中市,南屯區,田心里,823,1482,323,608,931,33,964
公投第１４案,臺中市,南屯區,田心里,824,1488,275,599,874,59,933
公投第１４案,臺中市,南屯區,田心里,825,1538,270,507,777,38,815
公投第１４案,臺中市,南屯區,向心里,826,1674,325,684,1009,51,1060
公投第１４案,臺中市,南屯區,向心里,827,1996,288,533,821,46,867
公投第１４案,臺中市,南屯區,向心里,828,1514,286,582,868,54,922
公投第１４案,臺中市,南屯區,文心里,829,1217,221,513,734,51,785
公投第１４案,臺中市,南屯區,文心里,830,1347,279,493,772,33,805
公投第１４案,臺中市,南屯區,文心里,831,1109,199,468,667,32,699
公投第１４案,臺中市,南屯區,同心里,832,1546,311,562,873,30,903
公投第１４案,臺中市,南屯區,同心里,833,1408,286,580,866,41,907
公投第１４案,臺中市,南屯區,同心里,834,1057,134,448,582,24,606
公投第１４案,臺中市,南屯區,同心里,835,1133,224,422,646,47,693
公投第１４案,臺中市,南屯區,大同里,836,1278,270,481,751,26,777
公投第１４案,臺中市,南屯區,大同里,837,1144,245,474,719,37,756
公投第１４案,臺中市,南屯區,大同里,838,1140,243,418,661,41,702
公投第１４案,臺中市,南屯區,大同里,839,1171,235,480,715,29,744
公投第１４案,臺中市,南屯區,大興里,840,1303,252,559,811,34,845
公投第１４案,臺中市,南屯區,大興里,841,1402,262,501,763,35,798
公投第１４案,臺中市,南屯區,大興里,842,1571,273,584,857,56,913
公投第１４案,臺中市,南屯區,大誠里,843,1139,268,443,711,25,736
公投第１４案,臺中市,南屯區,大誠里,844,1216,242,519,761,25,786
公投第１４案,臺中市,南屯區,大誠里,845,1162,217,487,704,38,742
公投第１４案,臺中市,北屯區,北屯里,846,1670,314,673,987,45,1032
公投第１４案,臺中市,北屯區,北屯里,847,1706,272,617,889,43,932
公投第１４案,臺中市,北屯區,北京里,848,1507,276,531,807,60,867
公投第１４案,臺中市,北屯區,北京里,849,1652,318,626,944,44,988
公投第１４案,臺中市,北屯區,北興里,850,1107,188,407,595,21,616
公投第１４案,臺中市,北屯區,北興里,851,2151,301,797,1098,64,1162
公投第１４案,臺中市,北屯區,三光里,852,1612,299,650,949,31,980
公投第１４案,臺中市,北屯區,三光里,853,1743,295,661,956,37,993
公投第１４案,臺中市,北屯區,三光里,854,2099,368,698,1066,37,1103
公投第１４案,臺中市,北屯區,三光里,855,1595,287,615,902,25,927
公投第１４案,臺中市,北屯區,三和里,856,1923,300,673,973,49,1022
公投第１４案,臺中市,北屯區,三和里,857,1641,234,616,850,50,900
公投第１４案,臺中市,北屯區,三和里,858,1157,241,476,717,34,751
公投第１４案,臺中市,北屯區,三和里,859,1041,202,430,632,32,664
公投第１４案,臺中市,北屯區,東光里,860,1563,261,542,803,42,845
公投第１４案,臺中市,北屯區,東光里,861,1559,209,588,797,46,843
公投第１４案,臺中市,北屯區,東光里,862,1411,192,517,709,19,728
公投第１４案,臺中市,北屯區,水景里,863,1761,360,659,1019,30,1049
公投第１４案,臺中市,北屯區,水景里,864,1361,255,553,808,56,864
公投第１４案,臺中市,北屯區,水景里,865,1852,297,699,996,58,1054
公投第１４案,臺中市,北屯區,水景里,866,1928,329,760,1089,38,1127
公投第１４案,臺中市,北屯區,水景里,867,1492,294,630,924,39,963
公投第１４案,臺中市,北屯區,水景里,868,1998,319,729,1048,53,1101
公投第１４案,臺中市,北屯區,水景里,869,1272,246,540,786,41,827
公投第１４案,臺中市,北屯區,水景里,870,1317,248,532,780,41,821
公投第１４案,臺中市,北屯區,軍功里,871,1327,203,463,666,53,719
公投第１４案,臺中市,北屯區,軍功里,872,1280,200,479,679,26,705
公投第１４案,臺中市,北屯區,軍功里,873,1865,289,659,948,44,992
公投第１４案,臺中市,北屯區,軍功里,874,1230,228,531,759,36,795
公投第１４案,臺中市,北屯區,軍功里,875,1356,271,447,718,27,745
公投第１４案,臺中市,北屯區,軍功里,876,1732,314,640,954,34,988
公投第１４案,臺中市,北屯區,軍功里,877,1586,286,620,906,37,943
公投第１４案,臺中市,北屯區,軍功里,878,1441,278,503,781,28,809
公投第１４案,臺中市,北屯區,和平里,879,2045,338,709,1047,62,1109
公投第１４案,臺中市,北屯區,和平里,880,1914,305,660,965,40,1005
公投第１４案,臺中市,北屯區,和平里,881,1918,332,736,1068,38,1106
公投第１４案,臺中市,北屯區,和平里,882,2079,326,728,1054,30,1084
公投第１４案,臺中市,北屯區,和平里,883,2040,359,658,1017,42,1059
公投第１４案,臺中市,北屯區,廍子里,884,2027,337,632,969,40,1009
公投第１４案,臺中市,北屯區,廍子里,885,1402,204,544,748,40,788
公投第１４案,臺中市,北屯區,廍子里,886,1826,317,718,1035,39,1074
公投第１４案,臺中市,北屯區,廍子里,887,2162,355,708,1063,24,1087
公投第１４案,臺中市,北屯區,廍子里,888,2332,398,698,1096,16,1112
公投第１４案,臺中市,北屯區,民政里,889,985,116,428,544,38,582
公投第１４案,臺中市,北屯區,東山里,890,2037,309,717,1026,38,1064
公投第１４案,臺中市,北屯區,大坑里,891,1032,166,430,596,36,632
公投第１４案,臺中市,北屯區,大坑里,892,1062,184,403,587,32,619
公投第１４案,臺中市,北屯區,民德里,893,909,132,365,497,31,528
公投第１４案,臺中市,北屯區,舊社里,894,1445,269,569,838,46,884
公投第１４案,臺中市,北屯區,舊社里,895,1842,290,662,952,44,996
公投第１４案,臺中市,北屯區,舊社里,896,1187,230,460,690,30,720
公投第１４案,臺中市,北屯區,舊社里,897,1456,247,577,824,38,862
公投第１４案,臺中市,北屯區,松茂里,898,1866,339,685,1024,56,1080
公投第１４案,臺中市,北屯區,松茂里,899,1667,264,586,850,54,904
公投第１４案,臺中市,北屯區,松茂里,900,1683,299,669,968,24,992
公投第１４案,臺中市,北屯區,松強里,901,1642,324,583,907,20,927
公投第１４案,臺中市,北屯區,松強里,902,1475,278,565,843,29,872
公投第１４案,臺中市,北屯區,松強里,903,1644,259,625,884,25,909
公投第１４案,臺中市,北屯區,松強里,904,1603,296,640,936,26,962
公投第１４案,臺中市,北屯區,松勇里,905,1949,329,783,1112,60,1172
公投第１４案,臺中市,北屯區,松勇里,906,1790,326,755,1081,38,1119
公投第１４案,臺中市,北屯區,松勇里,907,1440,293,538,831,24,855
公投第１４案,臺中市,北屯區,松安里,908,1601,302,636,938,44,982
公投第１４案,臺中市,北屯區,松安里,909,1527,253,557,810,48,858
公投第１４案,臺中市,北屯區,松安里,910,1675,278,568,846,40,886
公投第１４案,臺中市,北屯區,松和里,911,1579,249,529,778,34,812
公投第１４案,臺中市,北屯區,松和里,912,1524,249,602,851,57,908
公投第１４案,臺中市,北屯區,松和里,913,1677,286,591,877,43,920
公投第１４案,臺中市,北屯區,松和里,914,1599,295,570,865,42,907
公投第１４案,臺中市,北屯區,松竹里,915,1458,310,534,844,43,887
公投第１４案,臺中市,北屯區,松竹里,916,1571,304,607,911,42,953
公投第１４案,臺中市,北屯區,松竹里,917,1579,310,602,912,36,948
公投第１４案,臺中市,北屯區,松竹里,918,1849,364,686,1050,42,1092
公投第１４案,臺中市,北屯區,松竹里,919,1682,334,601,935,28,963
公投第１４案,臺中市,北屯區,平興里,920,1760,301,648,949,22,971
公投第１４案,臺中市,北屯區,平興里,921,1699,315,617,932,58,990
公投第１４案,臺中市,北屯區,平興里,922,1626,332,650,982,47,1029
公投第１４案,臺中市,北屯區,平興里,923,1491,326,558,884,8,892
公投第１４案,臺中市,北屯區,平田里,924,1640,303,594,897,35,932
公投第１４案,臺中市,北屯區,平田里,925,2052,341,733,1074,58,1132
公投第１４案,臺中市,北屯區,平田里,926,1875,353,686,1039,42,1081
公投第１４案,臺中市,北屯區,平昌里,927,1559,297,562,859,26,885
公投第１４案,臺中市,北屯區,平昌里,928,1480,276,552,828,58,886
公投第１４案,臺中市,北屯區,平昌里,929,1397,263,539,802,41,843
公投第１４案,臺中市,北屯區,平安里,930,1889,353,692,1045,48,1093
公投第１４案,臺中市,北屯區,平安里,931,1728,321,597,918,57,975
公投第１４案,臺中市,北屯區,平安里,932,1592,281,572,853,47,900
公投第１４案,臺中市,北屯區,平順里,933,1656,319,557,876,44,920
公投第１４案,臺中市,北屯區,平順里,934,1524,268,515,783,42,825
公投第１４案,臺中市,北屯區,平心里,935,1502,309,559,868,31,899
公投第１４案,臺中市,北屯區,平心里,936,1772,287,668,955,37,992
公投第１４案,臺中市,北屯區,平心里,937,1461,282,558,840,33,873
公投第１４案,臺中市,北屯區,平福里,938,1769,282,621,903,18,921
公投第１４案,臺中市,北屯區,平福里,939,1894,408,672,1080,50,1130
公投第１４案,臺中市,北屯區,平德里,940,2033,342,693,1035,44,1079
公投第１４案,臺中市,北屯區,平德里,941,1947,354,669,1023,45,1068
公投第１４案,臺中市,北屯區,平德里,942,2188,418,786,1204,52,1256
公投第１４案,臺中市,北屯區,平和里,943,1661,331,622,953,55,1008
公投第１４案,臺中市,北屯區,平和里,944,1667,301,648,949,28,977
公投第１４案,臺中市,北屯區,平和里,945,1728,319,621,940,42,982
公投第１４案,臺中市,北屯區,平陽里,946,1688,305,609,914,37,951
公投第１４案,臺中市,北屯區,平陽里,947,1475,273,545,818,23,841
公投第１４案,臺中市,北屯區,平陽里,948,1681,368,663,1031,18,1049
公投第１４案,臺中市,北屯區,仁和里,949,2078,368,822,1190,43,1233
公投第１４案,臺中市,北屯區,仁和里,950,2059,337,791,1128,39,1167
公投第１４案,臺中市,北屯區,仁和里,951,1792,334,675,1009,45,1054
公投第１４案,臺中市,北屯區,仁和里,952,2974,366,671,1037,36,1073
公投第１４案,臺中市,北屯區,仁愛里,953,1072,187,404,591,42,633
公投第１４案,臺中市,北屯區,仁美里,954,2099,383,865,1248,34,1282
公投第１４案,臺中市,北屯區,仁美里,955,1823,373,753,1126,45,1171
公投第１４案,臺中市,北屯區,仁美里,956,2022,389,773,1162,76,1238
公投第１４案,臺中市,北屯區,仁美里,957,1992,353,765,1118,36,1154
公投第１４案,臺中市,北屯區,四民里,958,1585,292,632,924,54,978
公投第１４案,臺中市,北屯區,同榮里,959,1565,282,633,915,47,962
公投第１４案,臺中市,北屯區,同榮里,960,1780,271,644,915,37,952
公投第１４案,臺中市,北屯區,同榮里,961,1874,349,759,1108,47,1155
公投第１４案,臺中市,北屯區,后庄里,962,1755,286,743,1029,34,1063
公投第１４案,臺中市,北屯區,后庄里,963,1497,337,680,1017,28,1045
公投第１４案,臺中市,北屯區,后庄里,964,1567,289,640,929,50,979
公投第１４案,臺中市,北屯區,后庄里,965,1624,263,621,884,39,923
公投第１４案,臺中市,北屯區,后庄里,966,1614,265,682,947,45,992
公投第１４案,臺中市,北屯區,后庄里,967,1595,293,594,887,30,917
公投第１４案,臺中市,北屯區,新平里,968,1782,271,632,903,55,958
公投第１４案,臺中市,北屯區,新平里,969,1357,200,490,690,34,724
公投第１４案,臺中市,北屯區,新平里,970,1071,174,402,576,50,626
公投第１４案,臺中市,北屯區,陳平里,971,1372,220,495,715,47,762
公投第１４案,臺中市,北屯區,陳平里,972,1415,244,567,811,50,861
公投第１４案,臺中市,北屯區,陳平里,973,1789,337,716,1053,47,1100
公投第１４案,臺中市,北屯區,忠平里,974,1907,309,807,1116,72,1188
公投第１４案,臺中市,北屯區,忠平里,975,2008,339,801,1140,48,1188
公投第１４案,臺中市,北屯區,大德里,976,1541,252,577,829,51,880
公投第１４案,臺中市,北屯區,大德里,977,1669,290,666,956,44,1000
公投第１４案,臺中市,北屯區,大德里,978,1685,290,660,950,31,981
公投第１４案,臺中市,北屯區,水湳里,979,1785,306,701,1007,100,1107
公投第１４案,臺中市,北屯區,水湳里,980,1596,270,663,933,52,985
公投第１４案,臺中市,北屯區,水湳里,981,1731,336,647,983,63,1046
公投第１４案,臺中市,北屯區,水湳里,982,1496,233,558,791,60,851
公投第１４案,臺中市,北區,中正里,983,1437,252,499,751,39,790
公投第１４案,臺中市,北區,六合里,984,1708,283,567,850,62,912
公投第１４案,臺中市,北區,光大里,985,1051,172,352,524,34,558
公投第１４案,臺中市,北區,光大里,986,996,188,362,550,34,584
公投第１４案,臺中市,北區,文莊里,987,1504,221,619,840,26,866
公投第１４案,臺中市,北區,文莊里,988,975,179,379,558,51,609
公投第１４案,臺中市,北區,文莊里,989,886,161,336,497,27,524
公投第１４案,臺中市,北區,大湖里,990,1276,210,366,576,31,607
公投第１４案,臺中市,北區,大湖里,991,938,166,308,474,37,511
公投第１４案,臺中市,北區,五常里,992,1404,240,486,726,52,778
公投第１４案,臺中市,北區,錦平里,993,996,193,349,542,19,561
公投第１４案,臺中市,北區,錦平里,994,869,169,286,455,44,499
公投第１４案,臺中市,北區,新北里,995,704,128,296,424,22,446
公投第１４案,臺中市,北區,新北里,996,979,156,364,520,26,546
公投第１４案,臺中市,北區,新興里,997,773,127,268,395,17,412
公投第１４案,臺中市,北區,新興里,998,759,144,297,441,21,462
公投第１４案,臺中市,北區,樂英里,999,1438,189,605,794,48,842
公投第１４案,臺中市,北區,樂英里,1000,1212,169,453,622,23,645
公投第１４案,臺中市,北區,錦村里,1001,1731,353,599,952,42,994
公投第１４案,臺中市,北區,錦村里,1002,1445,254,616,870,35,905
公投第１４案,臺中市,北區,建成里,1003,1855,347,657,1004,40,1044
公投第１４案,臺中市,北區,建成里,1004,1728,268,561,829,51,880
公投第１４案,臺中市,北區,建成里,1005,1878,303,627,930,44,974
公投第１４案,臺中市,北區,建德里,1006,1793,255,613,868,74,942
公投第１４案,臺中市,北區,建德里,1007,1555,259,587,846,62,908
公投第１４案,臺中市,北區,錦洲里,1008,1761,309,566,875,27,902
公投第１４案,臺中市,北區,錦洲里,1009,1579,251,578,829,47,876
公投第１４案,臺中市,北區,錦祥里,1010,2192,357,742,1099,75,1174
公投第１４案,臺中市,北區,錦祥里,1011,1560,307,602,909,41,950
公投第１４案,臺中市,北區,金華里,1012,1476,256,569,825,36,861
公投第１４案,臺中市,北區,金華里,1013,1006,191,405,596,25,621
公投第１４案,臺中市,北區,金龍里,1014,1403,222,554,776,39,815
公投第１４案,臺中市,北區,金龍里,1015,1446,236,520,756,28,784
公投第１４案,臺中市,北區,金龍里,1016,1460,275,516,791,38,829
公投第１４案,臺中市,北區,邱厝里,1017,1233,252,454,706,20,726
公投第１４案,臺中市,北區,邱厝里,1018,1027,236,416,652,24,676
公投第１４案,臺中市,北區,建興里,1019,1207,243,453,696,18,714
公投第１４案,臺中市,北區,建興里,1020,1167,239,456,695,31,726
公投第１４案,臺中市,北區,建興里,1021,1150,227,408,635,25,660
公投第１４案,臺中市,北區,建興里,1022,1061,204,383,587,38,625
公投第１４案,臺中市,北區,建興里,1023,1005,220,374,594,24,618
公投第１４案,臺中市,北區,頂厝里,1024,1250,256,436,692,22,714
公投第１４案,臺中市,北區,頂厝里,1025,1448,281,547,828,47,875
公投第１４案,臺中市,北區,頂厝里,1026,1379,266,514,780,47,827
公投第１４案,臺中市,北區,崇德里,1027,1652,313,597,910,50,960
公投第１４案,臺中市,北區,崇德里,1028,1867,260,715,975,40,1015
公投第１４案,臺中市,北區,賴厝里,1029,2078,190,379,569,21,590
公投第１４案,臺中市,北區,賴厝里,1030,1562,272,651,923,41,964
公投第１４案,臺中市,北區,賴厝里,1031,1430,280,519,799,28,827
公投第１４案,臺中市,北區,賴福里,1032,2018,377,757,1134,39,1173
公投第１４案,臺中市,北區,賴福里,1033,1710,266,570,836,27,863
公投第１４案,臺中市,北區,賴興里,1034,1432,243,527,770,25,795
公投第１４案,臺中市,北區,賴興里,1035,1157,214,456,670,33,703
公投第１４案,臺中市,北區,賴興里,1036,1188,250,450,700,18,718
公投第１４案,臺中市,北區,賴旺里,1037,1419,223,550,773,35,808
公投第１４案,臺中市,北區,賴旺里,1038,1653,308,555,863,33,896
公投第１４案,臺中市,北區,賴旺里,1039,1233,245,451,696,35,731
公投第１４案,臺中市,北區,賴明里,1040,1243,236,474,710,21,731
公投第１４案,臺中市,北區,賴明里,1041,1219,208,427,635,15,650
公投第１４案,臺中市,北區,賴明里,1042,1272,246,472,718,44,762
公投第１４案,臺中市,北區,梅川里,1043,1285,273,475,748,17,765
公投第１４案,臺中市,北區,梅川里,1044,1780,346,665,1011,39,1050
公投第１４案,臺中市,北區,賴村里,1045,1461,235,489,724,36,760
公投第１４案,臺中市,北區,賴村里,1046,1310,219,552,771,42,813
公投第１４案,臺中市,北區,賴村里,1047,1669,350,546,896,27,923
公投第１４案,臺中市,北區,育德里,1048,1932,405,673,1078,52,1130
公投第１４案,臺中市,北區,育德里,1049,1682,323,593,916,32,948
公投第１４案,臺中市,北區,淡溝里,1050,1891,370,622,992,29,1021
公投第１４案,臺中市,北區,淡溝里,1051,1882,345,666,1011,55,1066
公投第１４案,臺中市,北區,淡溝里,1052,1159,211,428,639,26,665
公投第１４案,臺中市,北區,健行里,1053,1553,200,642,842,45,887
公投第１４案,臺中市,北區,健行里,1054,1607,299,566,865,33,898
公投第１４案,臺中市,北區,健行里,1055,1773,336,626,962,39,1001
公投第１４案,臺中市,北區,健行里,1056,1524,276,555,831,45,876
公投第１４案,臺中市,北區,明德里,1057,1613,309,645,954,57,1011
公投第１４案,臺中市,北區,明德里,1058,1877,359,706,1065,44,1109
公投第１４案,臺中市,北區,明德里,1059,1792,345,639,984,45,1029
公投第１４案,臺中市,北區,明新里,1060,1392,236,552,788,42,830
公投第１４案,臺中市,北區,明新里,1061,1297,250,467,717,33,750
公投第１４案,臺中市,北區,長青里,1062,1556,350,561,911,31,942
公投第１４案,臺中市,北區,長青里,1063,1497,513,289,802,32,834
公投第１４案,臺中市,北區,長青里,1064,1550,254,569,823,43,866
公投第１４案,臺中市,北區,長青里,1065,1434,296,465,761,31,792
公投第１４案,臺中市,北區,立人里,1066,1793,350,651,1001,51,1052
公投第１４案,臺中市,北區,立人里,1067,1866,361,658,1019,39,1058
公投第１４案,臺中市,北區,中達里,1068,1346,228,537,765,36,801
公投第１４案,臺中市,北區,中達里,1069,1267,204,479,683,47,730
公投第１４案,臺中市,中區,綠川里,1070,1652,336,615,951,73,1024
公投第１４案,臺中市,中區,繼光里,1071,1531,261,543,804,47,851
公投第１４案,臺中市,中區,公園里,1072,1431,228,557,785,30,815
公投第１４案,臺中市,中區,光復里,1073,1060,173,407,580,36,616
公投第１４案,臺中市,中區,光復里,1074,982,168,348,516,34,550
公投第１４案,臺中市,中區,大墩里,1075,1191,211,424,635,53,688
公投第１４案,臺中市,中區,大墩里,1076,855,160,293,453,41,494
公投第１４案,臺中市,中區,柳川里,1077,1135,152,364,516,28,544
公投第１４案,臺中市,中區,柳川里,1078,705,106,300,406,14,420
公投第１４案,臺中市,中區,大誠里,1079,1009,174,405,579,31,610
公投第１４案,臺中市,中區,大誠里,1080,1304,221,442,663,65,728
公投第１４案,臺中市,中區,中華里,1081,1841,261,631,892,37,929
公投第１４案,臺中市,西區,三民里,1082,1400,141,349,490,26,516
公投第１４案,臺中市,西區,三民里,1083,861,181,362,543,19,562
公投第１４案,臺中市,西區,利民里,1084,1416,268,546,814,34,848
公投第１４案,臺中市,西區,民生里,1085,1020,223,380,603,39,642
公投第１４案,臺中市,西區,民生里,1086,778,159,327,486,27,513
公投第１４案,臺中市,西區,廣民里,1087,1465,268,539,807,39,846
公投第１４案,臺中市,西區,平和里,1088,1017,190,400,590,17,607
公投第１４案,臺中市,西區,平和里,1089,868,184,321,505,28,533
公投第１４案,臺中市,西區,東昇里,1090,1251,266,505,771,37,808
公投第１４案,臺中市,西區,東昇里,1091,1044,238,420,658,31,689
公投第１４案,臺中市,西區,公民里,1092,1487,282,544,826,39,865
公投第１４案,臺中市,西區,公民里,1093,1573,323,562,885,45,930
公投第１４案,臺中市,西區,公民里,1094,1731,343,659,1002,44,1046
公投第１４案,臺中市,西區,藍興里,1095,1209,206,499,705,31,736
公投第１４案,臺中市,西區,藍興里,1096,1564,301,573,874,35,909
公投第１４案,臺中市,西區,藍興里,1097,1175,277,435,712,25,737
公投第１４案,臺中市,西區,公舘里,1098,1505,317,514,831,36,867
公投第１４案,臺中市,西區,公舘里,1099,1418,305,525,830,31,861
公投第１４案,臺中市,西區,公舘里,1100,1497,215,467,682,60,742
公投第１４案,臺中市,西區,公舘里,1101,1260,255,471,726,42,768
公投第１４案,臺中市,西區,安龍里,1102,1399,280,521,801,47,848
公投第１４案,臺中市,西區,安龍里,1103,1447,285,508,793,46,839
公投第１４案,臺中市,西區,吉龍里,1104,1683,337,595,932,51,983
公投第１４案,臺中市,西區,吉龍里,1105,1585,325,591,916,53,969
公投第１４案,臺中市,西區,吉龍里,1106,1557,330,568,898,34,932
公投第１４案,臺中市,西區,吉龍里,1107,1663,275,584,859,49,908
公投第１４案,臺中市,西區,土庫里,1108,1921,421,660,1081,44,1125
公投第１４案,臺中市,西區,土庫里,1109,1952,357,663,1020,28,1048
公投第１４案,臺中市,西區,土庫里,1110,1708,338,590,928,42,970
公投第１４案,臺中市,西區,大忠里,1111,1131,266,434,700,27,727
公投第１４案,臺中市,西區,大忠里,1112,1916,362,676,1038,25,1063
公投第１４案,臺中市,西區,大忠里,1113,1275,255,502,757,24,781
公投第１４案,臺中市,西區,民龍里,1114,1822,287,620,907,57,964
公投第１４案,臺中市,西區,民龍里,1115,1374,276,490,766,41,807
公投第１４案,臺中市,西區,和龍里,1116,1129,205,395,600,60,660
公投第１４案,臺中市,西區,和龍里,1117,1201,211,421,632,42,674
公投第１４案,臺中市,西區,後龍里,1118,1639,304,601,905,57,962
公投第１４案,臺中市,西區,後龍里,1119,1863,372,661,1033,58,1091
公投第１４案,臺中市,西區,双龍里,1120,1287,225,561,786,39,825
公投第１４案,臺中市,西區,双龍里,1121,1504,324,558,882,43,925
公投第１４案,臺中市,西區,昇平里,1122,1308,251,482,733,33,766
公投第１４案,臺中市,西區,昇平里,1123,1433,276,515,791,54,845
公投第１４案,臺中市,西區,昇平里,1124,1450,275,516,791,34,825
公投第１４案,臺中市,西區,昇平里,1125,1465,319,545,864,60,924
公投第１４案,臺中市,西區,中興里,1126,1818,296,646,942,51,993
公投第１４案,臺中市,西區,中興里,1127,1782,326,662,988,49,1037
公投第１４案,臺中市,西區,公益里,1128,1428,305,525,830,49,879
公投第１４案,臺中市,西區,公益里,1129,1366,216,477,693,37,730
公投第１４案,臺中市,西區,公德里,1130,1498,292,535,827,30,857
公投第１４案,臺中市,西區,公德里,1131,1350,286,515,801,24,825
公投第１４案,臺中市,西區,公德里,1132,1339,282,509,791,27,818
公投第１４案,臺中市,西區,公正里,1133,1613,316,616,932,34,966
公投第１４案,臺中市,西區,公正里,1134,1454,301,526,827,30,857
公投第１４案,臺中市,西區,公正里,1135,1597,356,602,958,27,985
公投第１４案,臺中市,西區,公正里,1136,1411,309,529,838,57,895
公投第１４案,臺中市,西區,公平里,1137,1493,283,555,838,54,892
公投第１４案,臺中市,西區,公平里,1138,1600,279,670,949,36,985
公投第１４案,臺中市,西區,公平里,1139,1710,344,598,942,36,978
公投第１４案,臺中市,西區,忠明里,1140,1139,237,419,656,25,681
公投第１４案,臺中市,西區,忠明里,1141,1105,218,439,657,27,684
公投第１４案,臺中市,西區,忠明里,1142,1498,280,540,820,46,866
公投第１４案,臺中市,西區,忠明里,1143,1921,313,629,942,41,983
公投第１４案,臺中市,西區,忠誠里,1144,1340,253,494,747,39,786
公投第１４案,臺中市,西區,忠誠里,1145,1536,310,612,922,38,960
公投第１４案,臺中市,西區,忠誠里,1146,1361,270,486,756,49,805
公投第１４案,臺中市,西區,忠誠里,1147,1430,305,550,855,38,893
公投第１４案,臺中市,東區,新庄里,1148,1138,147,285,432,17,449
公投第１４案,臺中市,東區,新庄里,1149,984,169,401,570,20,590
公投第１４案,臺中市,東區,新庄里,1150,877,145,346,491,30,521
公投第１４案,臺中市,東區,振興里,1151,1070,215,430,645,43,688
公投第１４案,臺中市,東區,振興里,1152,1106,207,434,641,47,688
公投第１４案,臺中市,東區,振興里,1153,953,171,361,532,47,579
公投第１４案,臺中市,東區,東橋里,1154,1195,228,478,706,26,732
公投第１４案,臺中市,東區,東橋里,1155,1251,206,472,678,39,717
公投第１４案,臺中市,東區,東橋里,1156,1190,217,458,675,33,708
公投第１４案,臺中市,東區,東興里,1157,1394,325,423,748,45,793
公投第１４案,臺中市,東區,東興里,1158,1443,302,573,875,54,929
公投第１４案,臺中市,東區,泉源里,1159,762,116,305,421,33,454
公投第１４案,臺中市,東區,泉源里,1160,1140,212,473,685,47,732
公投第１４案,臺中市,東區,干城里,1161,1211,483,205,688,66,754
公投第１４案,臺中市,東區,干城里,1162,755,149,310,459,25,484
公投第１４案,臺中市,東區,旱溪里,1163,1491,243,538,781,61,842
公投第１４案,臺中市,東區,旱溪里,1164,1000,164,376,540,17,557
公投第１４案,臺中市,東區,樂成里,1165,1114,228,412,640,40,680
公投第１４案,臺中市,東區,樂成里,1166,1101,203,408,611,31,642
公投第１４案,臺中市,東區,東門里,1167,1169,221,484,705,45,750
公投第１４案,臺中市,東區,東門里,1168,1283,237,511,748,63,811
公投第１４案,臺中市,東區,東門里,1169,1168,230,489,719,28,747
公投第１４案,臺中市,東區,東門里,1170,1386,234,506,740,35,775
公投第１４案,臺中市,東區,東門里,1171,1557,329,553,882,44,926
公投第１４案,臺中市,東區,十甲里,1172,1380,264,488,752,61,813
公投第１４案,臺中市,東區,十甲里,1173,1674,319,625,944,44,988
公投第１４案,臺中市,東區,十甲里,1174,1604,328,641,969,31,1000
公投第１４案,臺中市,東區,東英里,1175,1815,367,691,1058,38,1096
公投第１４案,臺中市,東區,東英里,1176,1700,287,633,920,40,960
公投第１４案,臺中市,東區,東英里,1177,1592,273,591,864,48,912
公投第１４案,臺中市,東區,東英里,1178,1850,318,645,963,58,1021
公投第１４案,臺中市,東區,東南里,1179,1252,199,532,731,32,763
公投第１４案,臺中市,東區,東南里,1180,1250,265,498,763,34,797
公投第１４案,臺中市,東區,東南里,1181,1241,200,517,717,37,754
公投第１４案,臺中市,東區,東勢里,1182,1318,247,422,669,42,711
公投第１４案,臺中市,東區,東勢里,1183,1288,206,492,698,45,743
公投第１４案,臺中市,東區,合作里,1184,1442,266,594,860,46,906
公投第１４案,臺中市,東區,合作里,1185,1202,203,473,676,43,719
公投第１４案,臺中市,東區,合作里,1186,1452,223,586,809,47,856
公投第１４案,臺中市,東區,富仁里,1187,1480,239,543,782,44,826
公投第１４案,臺中市,東區,富仁里,1188,1736,264,692,956,31,987
公投第１４案,臺中市,東區,富仁里,1189,867,158,312,470,27,497
公投第１４案,臺中市,東區,富台里,1190,1693,223,626,849,47,896
公投第１４案,臺中市,東區,東信里,1191,1538,276,630,906,47,953
公投第１４案,臺中市,東區,東信里,1192,1593,295,636,931,77,1008
公投第１４案,臺中市,東區,東信里,1193,1481,261,524,785,25,810
公投第１４案,臺中市,東區,東信里,1194,1414,280,559,839,37,876
公投第１４案,臺中市,東區,東信里,1195,1297,236,466,702,41,743
公投第１４案,臺中市,東區,東信里,1196,1394,239,545,784,45,829
公投第１４案,臺中市,南區,長春里,1197,937,181,364,545,29,574
公投第１４案,臺中市,南區,長春里,1198,1001,196,422,618,40,658
公投第１４案,臺中市,南區,長榮里,1199,1249,244,513,757,68,825
公投第１４案,臺中市,南區,長榮里,1200,1202,240,536,776,44,820
公投第１４案,臺中市,南區,城隍里,1201,1130,218,431,649,73,722
公投第１４案,臺中市,南區,城隍里,1202,1239,222,509,731,53,784
公投第１４案,臺中市,南區,城隍里,1203,1238,234,449,683,48,731
公投第１４案,臺中市,南區,國光里,1204,1272,252,481,733,55,788
公投第１４案,臺中市,南區,國光里,1205,1273,224,492,716,56,772
公投第１４案,臺中市,南區,國光里,1206,1317,253,483,736,71,807
公投第１４案,臺中市,南區,南門里,1207,1160,256,496,752,40,792
公投第１４案,臺中市,南區,南門里,1208,1205,267,479,746,45,791
公投第１４案,臺中市,南區,南門里,1209,1111,230,432,662,33,695
公投第１４案,臺中市,南區,德義里,1210,1407,307,576,883,51,934
公投第１４案,臺中市,南區,德義里,1211,1419,265,545,810,46,856
公投第１４案,臺中市,南區,積善里,1212,1157,221,464,685,52,737
公投第１４案,臺中市,南區,積善里,1213,1415,281,501,782,46,828
公投第１４案,臺中市,南區,江川里,1214,1289,245,558,803,45,848
公投第１４案,臺中市,南區,江川里,1215,1454,276,559,835,41,876
公投第１４案,臺中市,南區,新榮里,1216,1491,265,567,832,38,870
公投第１４案,臺中市,南區,新榮里,1217,1394,263,527,790,33,823
公投第１４案,臺中市,南區,新榮里,1218,1430,281,528,809,48,857
公投第１４案,臺中市,南區,福興里,1219,1342,249,506,755,85,840
公投第１４案,臺中市,南區,福興里,1220,1304,277,532,809,73,882
公投第１４案,臺中市,南區,福興里,1221,1190,245,489,734,30,764
公投第１４案,臺中市,南區,福平里,1222,1273,193,508,701,57,758
公投第１４案,臺中市,南區,福平里,1223,1387,281,568,849,54,903
公投第１４案,臺中市,南區,福平里,1224,1356,257,520,777,40,817
公投第１４案,臺中市,南區,福平里,1225,1304,253,523,776,48,824
公投第１４案,臺中市,南區,福順里,1226,1256,255,529,784,24,808
公投第１４案,臺中市,南區,福順里,1227,1364,302,530,832,31,863
公投第１４案,臺中市,南區,福順里,1228,1361,276,504,780,69,849
公投第１４案,臺中市,南區,福順里,1229,1407,309,553,862,13,875
公投第１４案,臺中市,南區,和平里,1230,1308,236,514,750,47,797
公投第１４案,臺中市,南區,和平里,1231,1250,232,467,699,40,739
公投第１４案,臺中市,南區,和平里,1232,1284,249,459,708,33,741
公投第１４案,臺中市,南區,平和里,1233,1175,249,449,698,57,755
公投第１４案,臺中市,南區,平和里,1234,1158,224,507,731,38,769
公投第１４案,臺中市,南區,平和里,1235,1168,256,424,680,37,717
公投第１４案,臺中市,南區,南和里,1236,1626,315,681,996,44,1040
公投第１４案,臺中市,南區,南和里,1237,2115,305,562,867,27,894
公投第１４案,臺中市,南區,南和里,1238,1805,330,653,983,31,1014
公投第１４案,臺中市,南區,南和里,1239,1695,305,616,921,24,945
公投第１４案,臺中市,南區,永興里,1240,1643,346,673,1019,33,1052
公投第１４案,臺中市,南區,永興里,1241,1423,277,576,853,40,893
公投第１４案,臺中市,南區,永興里,1242,1542,294,580,874,51,925
公投第１４案,臺中市,南區,永興里,1243,1533,341,563,904,26,930
公投第１４案,臺中市,南區,永興里,1244,1531,316,623,939,49,988
公投第１４案,臺中市,南區,永和里,1245,1392,211,529,740,31,771
公投第１４案,臺中市,南區,永和里,1246,1592,317,563,880,35,915
公投第１４案,臺中市,南區,永和里,1247,1431,305,536,841,53,894
公投第１４案,臺中市,南區,樹義里,1248,1799,320,626,946,37,983
公投第１４案,臺中市,南區,樹義里,1249,1708,314,718,1032,56,1088
公投第１４案,臺中市,南區,樹義里,1250,1700,654,284,938,51,989
公投第１４案,臺中市,南區,樹義里,1251,1751,304,753,1057,38,1095
公投第１４案,臺中市,南區,樹義里,1252,2109,426,785,1211,67,1278
公投第１４案,臺中市,南區,樹義里,1253,1697,334,613,947,55,1002
公投第１４案,臺中市,南區,工學里,1254,1456,303,516,819,45,864
公投第１４案,臺中市,南區,工學里,1255,1726,370,737,1107,41,1148
公投第１４案,臺中市,南區,工學里,1256,1723,348,680,1028,54,1082
公投第１４案,臺中市,南區,工學里,1257,1569,323,611,934,38,972
公投第１４案,臺中市,南區,樹德里,1258,1274,266,489,755,50,805
公投第１４案,臺中市,南區,樹德里,1259,1390,287,603,890,30,920
公投第１４案,臺中市,南區,樹德里,1260,1295,287,530,817,30,847
公投第１４案,臺中市,南區,樹德里,1261,1312,234,533,767,44,811
公投第１４案,臺中市,南區,樹德里,1262,1417,289,591,880,26,906
公投第１４案,臺中市,南區,樹德里,1263,1230,271,546,817,37,854
公投第１４案,臺中市,南區,西川里,1264,1308,237,518,755,30,785
公投第１４案,臺中市,南區,西川里,1265,1467,276,549,825,59,884
公投第１４案,臺中市,南區,西川里,1266,1399,284,535,819,37,856
公投第１４案,臺中市,南區,崇倫里,1267,1207,214,464,678,53,731
公投第１４案,臺中市,南區,崇倫里,1268,1317,259,495,754,37,791
公投第１４案,臺中市,南區,崇倫里,1269,1563,338,547,885,28,913
公投第１４案,臺中市,南區,崇倫里,1270,1221,247,490,737,35,772
公投第１４案,臺中市,太平區,太平里,1271,1821,282,648,930,69,999
公投第１４案,臺中市,太平區,太平里,1272,1680,246,587,833,34,867
公投第１４案,臺中市,太平區,太平里,1273,1947,310,740,1050,81,1131
公投第１４案,臺中市,太平區,長億里,1274,1910,330,739,1069,72,1141
公投第１４案,臺中市,太平區,長億里,1275,1894,307,670,977,45,1022
公投第１４案,臺中市,太平區,長億里,1276,1953,317,732,1049,50,1099
公投第１４案,臺中市,太平區,永成里,1277,1846,306,680,986,72,1058
公投第１４案,臺中市,太平區,永成里,1278,1493,241,600,841,49,890
公投第１４案,臺中市,太平區,永成里,1279,1605,221,620,841,54,895
公投第１４案,臺中市,太平區,永成里,1280,1619,253,665,918,44,962
公投第１４案,臺中市,太平區,中平里,1281,2011,300,756,1056,49,1105
公投第１４案,臺中市,太平區,中平里,1282,2056,315,739,1054,35,1089
公投第１４案,臺中市,太平區,中政里,1283,1876,309,664,973,48,1021
公投第１４案,臺中市,太平區,中政里,1284,1815,270,645,915,75,990
公投第１４案,臺中市,太平區,平安里,1285,1281,192,486,678,39,717
公投第１４案,臺中市,太平區,平安里,1286,1004,169,418,587,63,650
公投第１４案,臺中市,太平區,中興里,1287,1886,327,732,1059,71,1130
公投第１４案,臺中市,太平區,中興里,1288,1431,214,582,796,66,862
公投第１４案,臺中市,太平區,永平里,1289,1930,308,667,975,71,1046
公投第１４案,臺中市,太平區,永平里,1290,2164,342,714,1056,63,1119
公投第１４案,臺中市,太平區,東平里,1291,2048,288,764,1052,61,1113
公投第１４案,臺中市,太平區,東平里,1292,2035,284,742,1026,62,1088
公投第１４案,臺中市,太平區,成功里,1293,1685,280,572,852,79,931
公投第１４案,臺中市,太平區,成功里,1294,2185,328,681,1009,72,1081
公投第１４案,臺中市,太平區,東和里,1295,1176,182,432,614,24,638
公投第１４案,臺中市,太平區,東和里,1296,1597,264,575,839,29,868
公投第１４案,臺中市,太平區,建國里,1297,1378,485,206,691,62,753
公投第１４案,臺中市,太平區,建國里,1298,1546,233,610,843,26,869
公投第１４案,臺中市,太平區,建興里,1299,1890,173,721,894,64,958
公投第１４案,臺中市,太平區,建興里,1300,1053,151,404,555,42,597
公投第１４案,臺中市,太平區,坪林里,1301,1582,247,638,885,75,960
公投第１４案,臺中市,太平區,坪林里,1302,1699,266,707,973,44,1017
公投第１４案,臺中市,太平區,大興里,1303,1493,242,515,757,58,815
公投第１４案,臺中市,太平區,大興里,1304,1063,156,388,544,35,579
公投第１４案,臺中市,太平區,勤益里,1305,1117,182,457,639,48,687
公投第１４案,臺中市,太平區,勤益里,1306,1084,170,444,614,39,653
公投第１４案,臺中市,太平區,光華里,1307,1776,286,629,915,40,955
公投第１４案,臺中市,太平區,光華里,1308,1729,275,612,887,48,935
公投第１４案,臺中市,太平區,光華里,1309,1658,245,538,783,55,838
公投第１４案,臺中市,太平區,光明里,1310,2010,264,746,1010,55,1065
公投第１４案,臺中市,太平區,光明里,1311,1752,254,636,890,44,934
公投第１４案,臺中市,太平區,中山里,1312,1654,272,682,954,49,1003
公投第１４案,臺中市,太平區,中山里,1313,1951,231,528,759,31,790
公投第１４案,臺中市,太平區,豐年里,1314,2170,384,890,1274,84,1358
公投第１４案,臺中市,太平區,豐年里,1315,2231,373,903,1276,65,1341
公投第１４案,臺中市,太平區,宜欣里,1316,1623,282,633,915,40,955
公投第１４案,臺中市,太平區,宜欣里,1317,1548,195,529,724,53,777
公投第１４案,臺中市,太平區,宜欣里,1318,1442,213,527,740,60,800
公投第１４案,臺中市,太平區,宜欣里,1319,1501,206,511,717,36,753
公投第１４案,臺中市,太平區,宜佳里,1320,2025,117,853,970,28,998
公投第１４案,臺中市,太平區,宜佳里,1321,1885,330,638,968,44,1012
公投第１４案,臺中市,太平區,宜佳里,1322,2155,327,658,985,67,1052
公投第１４案,臺中市,太平區,宜昌里,1323,1775,269,582,851,58,909
公投第１４案,臺中市,太平區,宜昌里,1324,2021,266,615,881,57,938
公投第１４案,臺中市,太平區,新坪里,1325,2075,323,796,1119,73,1192
公投第１４案,臺中市,太平區,新坪里,1326,1723,289,572,861,43,904
公投第１４案,臺中市,太平區,新坪里,1327,2049,349,751,1100,44,1144
公投第１４案,臺中市,太平區,新坪里,1328,1415,232,518,750,28,778
公投第１４案,臺中市,太平區,新吉里,1329,1778,304,616,920,87,1007
公投第１４案,臺中市,太平區,新吉里,1330,1706,265,580,845,46,891
公投第１４案,臺中市,太平區,新吉里,1331,2090,364,735,1099,37,1136
公投第１４案,臺中市,太平區,新城里,1332,2093,306,683,989,52,1041
公投第１４案,臺中市,太平區,新城里,1333,1688,222,556,778,33,811
公投第１４案,臺中市,太平區,新城里,1334,1488,245,476,721,30,751
公投第１４案,臺中市,太平區,新光里,1335,1667,282,652,934,44,978
公投第１４案,臺中市,太平區,新光里,1336,1793,295,677,972,57,1029
公投第１４案,臺中市,太平區,新光里,1337,1903,343,693,1036,33,1069
公投第１４案,臺中市,太平區,新光里,1338,1834,286,683,969,53,1022
公投第１４案,臺中市,太平區,新興里,1339,1526,218,579,797,38,835
公投第１４案,臺中市,太平區,新興里,1340,1483,321,592,913,17,930
公投第１４案,臺中市,太平區,新興里,1341,1694,335,600,935,25,960
公投第１４案,臺中市,太平區,新高里,1342,1952,310,629,939,28,967
公投第１４案,臺中市,太平區,新高里,1343,1995,350,699,1049,45,1094
公投第１４案,臺中市,太平區,新高里,1344,1311,249,490,739,19,758
公投第１４案,臺中市,太平區,新高里,1345,1537,390,591,981,38,1019
公投第１４案,臺中市,太平區,新福里,1346,1974,301,625,926,41,967
公投第１４案,臺中市,太平區,新福里,1347,1828,328,672,1000,39,1039
公投第１４案,臺中市,太平區,新福里,1348,2191,351,688,1039,44,1083
公投第１４案,臺中市,太平區,頭汴里,1349,1825,214,680,894,76,970
公投第１４案,臺中市,太平區,聖和里,1350,1559,207,566,773,17,790
公投第１４案,臺中市,太平區,東汴里,1351,1225,177,460,637,52,689
公投第１４案,臺中市,太平區,興隆里,1352,1678,227,669,896,54,950
公投第１４案,臺中市,太平區,興隆里,1353,1501,241,489,730,73,803
公投第１４案,臺中市,太平區,福隆里,1354,1450,271,593,864,60,924
公投第１４案,臺中市,太平區,福隆里,1355,2126,336,716,1052,69,1121
公投第１４案,臺中市,太平區,黃竹里,1356,699,87,322,409,38,447
公投第１４案,臺中市,太平區,光隆里,1357,1428,233,472,705,36,741
公投第１４案,臺中市,太平區,光隆里,1358,1666,284,716,1000,71,1071
公投第１４案,臺中市,太平區,永隆里,1359,1241,204,466,670,44,714
公投第１４案,臺中市,太平區,永隆里,1360,1266,212,509,721,43,764
公投第１４案,臺中市,太平區,德隆里,1361,1166,167,458,625,44,669
公投第１４案,臺中市,太平區,德隆里,1362,1790,271,695,966,79,1045
公投第１４案,臺中市,太平區,德隆里,1363,1754,207,551,758,47,805
公投第１４案,臺中市,大里區,東湖里,1364,1614,238,554,792,48,840
公投第１４案,臺中市,大里區,東湖里,1365,1599,225,560,785,27,812
公投第１４案,臺中市,大里區,東湖里,1366,1715,293,529,822,52,874
公投第１４案,臺中市,大里區,東湖里,1367,1264,193,514,707,32,739
公投第１４案,臺中市,大里區,東湖里,1368,1416,245,474,719,39,758
公投第１４案,臺中市,大里區,東湖里,1369,1188,180,433,613,31,644
公投第１４案,臺中市,大里區,東湖里,1370,1359,218,450,668,50,718
公投第１４案,臺中市,大里區,西湖里,1371,1457,217,574,791,52,843
公投第１４案,臺中市,大里區,西湖里,1372,1403,220,568,788,45,833
公投第１４案,臺中市,大里區,大里里,1373,1697,263,641,904,50,954
公投第１４案,臺中市,大里區,大里里,1374,1811,319,694,1013,81,1094
公投第１４案,臺中市,大里區,新里里,1375,1830,279,649,928,57,985
公投第１４案,臺中市,大里區,新里里,1376,2228,261,634,895,70,965
公投第１４案,臺中市,大里區,新里里,1377,1997,318,760,1078,60,1138
公投第１４案,臺中市,大里區,新里里,1378,2033,400,866,1266,34,1300
公投第１４案,臺中市,大里區,新里里,1379,1835,350,691,1041,37,1078
公投第１４案,臺中市,大里區,國光里,1380,1268,217,497,714,19,733
公投第１４案,臺中市,大里區,國光里,1381,1645,273,643,916,42,958
公投第１４案,臺中市,大里區,國光里,1382,1561,288,615,903,28,931
公投第１４案,臺中市,大里區,國光里,1383,1301,242,584,826,23,849
公投第１４案,臺中市,大里區,樹王里,1384,1621,274,547,821,66,887
公投第１４案,臺中市,大里區,樹王里,1385,1797,281,633,914,58,972
公投第１４案,臺中市,大里區,祥興里,1386,1230,199,454,653,26,679
公投第１４案,臺中市,大里區,祥興里,1387,1488,214,558,772,52,824
公投第１４案,臺中市,大里區,祥興里,1388,1459,268,467,735,60,795
公投第１４案,臺中市,大里區,祥興里,1389,1647,281,621,902,42,944
公投第１４案,臺中市,大里區,祥興里,1390,1100,193,438,631,70,701
公投第１４案,臺中市,大里區,內新里,1391,1410,234,534,768,45,813
公投第１４案,臺中市,大里區,內新里,1392,1807,260,645,905,55,960
公投第１４案,臺中市,大里區,內新里,1393,1331,239,560,799,48,847
公投第１４案,臺中市,大里區,內新里,1394,1801,316,627,943,27,970
公投第１４案,臺中市,大里區,內新里,1395,1909,298,639,937,35,972
公投第１４案,臺中市,大里區,中新里,1396,1699,221,588,809,56,865
公投第１４案,臺中市,大里區,中新里,1397,1627,274,620,894,47,941
公投第１４案,臺中市,大里區,中新里,1398,1912,353,645,998,45,1043
公投第１４案,臺中市,大里區,東昇里,1399,1753,269,614,883,60,943
公投第１４案,臺中市,大里區,東昇里,1400,1602,250,588,838,47,885
公投第１４案,臺中市,大里區,大元里,1401,1144,202,416,618,55,673
公投第１４案,臺中市,大里區,大元里,1402,1655,271,641,912,64,976
公投第１４案,臺中市,大里區,大元里,1403,1438,247,527,774,40,814
公投第１４案,臺中市,大里區,夏田里,1404,1000,182,369,551,47,598
公投第１４案,臺中市,大里區,仁化里,1405,1711,273,637,910,53,963
公投第１４案,臺中市,大里區,仁化里,1406,1698,256,655,911,16,927
公投第１４案,臺中市,大里區,仁化里,1407,1914,293,702,995,82,1077
公投第１４案,臺中市,大里區,仁化里,1408,1465,261,558,819,36,855
公投第１４案,臺中市,大里區,仁化里,1409,1581,245,590,835,66,901
公投第１４案,臺中市,大里區,仁德里,1410,1509,233,621,854,43,897
公投第１４案,臺中市,大里區,仁德里,1411,1570,238,589,827,27,854
公投第１４案,臺中市,大里區,仁德里,1412,1425,261,537,798,33,831
公投第１４案,臺中市,大里區,仁德里,1413,1384,250,520,770,51,821
公投第１４案,臺中市,大里區,健民里,1414,1204,156,401,557,37,594
公投第１４案,臺中市,大里區,健民里,1415,1761,248,617,865,26,891
公投第１４案,臺中市,大里區,健民里,1416,1473,209,476,685,34,719
公投第１４案,臺中市,大里區,塗城里,1417,1675,346,548,894,55,949
公投第１４案,臺中市,大里區,塗城里,1418,1755,259,675,934,58,992
公投第１４案,臺中市,大里區,塗城里,1419,1593,267,616,883,74,957
公投第１４案,臺中市,大里區,塗城里,1420,1799,275,663,938,61,999
公投第１４案,臺中市,大里區,塗城里,1421,1606,257,609,866,55,921
公投第１４案,臺中市,大里區,東興里,1422,1875,305,684,989,40,1029
公投第１４案,臺中市,大里區,東興里,1423,1670,282,626,908,50,958
公投第１４案,臺中市,大里區,東興里,1424,1898,338,655,993,40,1033
公投第１４案,臺中市,大里區,東興里,1425,1679,263,595,858,37,895
公投第１４案,臺中市,大里區,大明里,1426,1373,207,506,713,45,758
公投第１４案,臺中市,大里區,大明里,1427,1299,222,485,707,45,752
公投第１４案,臺中市,大里區,大明里,1428,1430,260,522,782,34,816
公投第１４案,臺中市,大里區,永隆里,1429,1805,335,774,1109,36,1145
公投第１４案,臺中市,大里區,永隆里,1430,1806,401,747,1148,25,1173
公投第１４案,臺中市,大里區,永隆里,1431,1826,355,794,1149,48,1197
公投第１４案,臺中市,大里區,永隆里,1432,1805,321,816,1137,38,1175
公投第１４案,臺中市,大里區,永隆里,1433,1907,372,740,1112,37,1149
公投第１４案,臺中市,大里區,日新里,1434,1103,187,477,664,25,689
公投第１４案,臺中市,大里區,日新里,1435,1419,218,526,744,49,793
公投第１４案,臺中市,大里區,日新里,1436,1434,177,590,767,52,819
公投第１４案,臺中市,大里區,西榮里,1437,1875,268,651,919,33,952
公投第１４案,臺中市,大里區,西榮里,1438,1862,319,658,977,55,1032
公投第１４案,臺中市,大里區,西榮里,1439,1850,317,646,963,35,998
公投第１４案,臺中市,大里區,長榮里,1440,1622,269,602,871,61,932
公投第１４案,臺中市,大里區,長榮里,1441,1638,301,669,970,45,1015
公投第１４案,臺中市,大里區,長榮里,1442,1633,294,671,965,51,1016
公投第１４案,臺中市,大里區,長榮里,1443,1662,302,618,920,39,959
公投第１４案,臺中市,大里區,長榮里,1444,1917,390,705,1095,31,1126
公投第１４案,臺中市,大里區,金城里,1445,1701,244,605,849,58,907
公投第１４案,臺中市,大里區,金城里,1446,1549,237,522,759,63,822
公投第１４案,臺中市,大里區,金城里,1447,1567,258,636,894,50,944
公投第１４案,臺中市,大里區,金城里,1448,1614,277,616,893,40,933
公投第１４案,臺中市,大里區,金城里,1449,1811,308,662,970,72,1042
公投第１４案,臺中市,大里區,金城里,1450,1336,484,237,721,38,759
公投第１４案,臺中市,大里區,立仁里,1451,1759,261,654,915,48,963
公投第１４案,臺中市,大里區,立仁里,1452,1783,266,615,881,61,942
公投第１４案,臺中市,大里區,立仁里,1453,1736,239,600,839,49,888
公投第１４案,臺中市,大里區,立德里,1454,1874,293,729,1022,42,1064
公投第１４案,臺中市,大里區,立德里,1455,1889,314,691,1005,66,1071
公投第１４案,臺中市,大里區,立德里,1456,1947,269,743,1012,59,1071
公投第１４案,臺中市,大里區,立德里,1457,1938,302,789,1091,41,1132
公投第１４案,臺中市,大里區,新仁里,1458,1836,291,676,967,55,1022
公投第１４案,臺中市,大里區,新仁里,1459,1913,303,728,1031,57,1088
公投第１４案,臺中市,大里區,新仁里,1460,1913,260,670,930,90,1020
公投第１４案,臺中市,大里區,新仁里,1461,1937,235,721,956,51,1007
公投第１４案,臺中市,大里區,瑞城里,1462,1508,226,546,772,50,822
公投第１４案,臺中市,大里區,瑞城里,1463,1340,220,555,775,29,804
公投第１４案,臺中市,大里區,瑞城里,1464,1656,256,665,921,47,968
公投第１４案,臺中市,大里區,瑞城里,1465,1290,192,494,686,36,722
公投第１４案,臺中市,大里區,瑞城里,1466,1655,260,620,880,39,919
公投第１４案,臺中市,大里區,瑞城里,1467,1260,220,386,606,28,634
公投第１４案,臺中市,大里區,瑞城里,1468,1247,227,485,712,32,744
公投第１４案,臺中市,大里區,瑞城里,1469,1548,411,400,811,56,867
公投第１４案,臺中市,霧峰區,桐林里,1470,1205,213,499,712,34,746
公投第１４案,臺中市,霧峰區,吉峰里,1471,1620,257,624,881,45,926
公投第１４案,臺中市,霧峰區,吉峰里,1472,1559,288,622,910,56,966
公投第１４案,臺中市,霧峰區,吉峰里,1473,1660,275,617,892,65,957
公投第１４案,臺中市,霧峰區,吉峰里,1474,1602,282,658,940,48,988
公投第１４案,臺中市,霧峰區,吉峰里,1475,1325,194,494,688,45,733
公投第１４案,臺中市,霧峰區,吉峰里,1476,1515,223,613,836,59,895
公投第１４案,臺中市,霧峰區,甲寅里,1477,1561,302,507,809,66,875
公投第１４案,臺中市,霧峰區,甲寅里,1478,1691,250,620,870,44,914
公投第１４案,臺中市,霧峰區,甲寅里,1479,1486,225,587,812,51,863
公投第１４案,臺中市,霧峰區,本鄉里,1480,975,155,415,570,43,613
公投第１４案,臺中市,霧峰區,本鄉里,1481,1358,207,590,797,52,849
公投第１４案,臺中市,霧峰區,中正里,1482,1141,203,533,736,26,762
公投第１４案,臺中市,霧峰區,中正里,1483,855,143,380,523,43,566
公投第１４案,臺中市,霧峰區,錦榮里,1484,1202,206,467,673,52,725
公投第１４案,臺中市,霧峰區,萊園里,1485,1078,168,402,570,43,613
公投第１４案,臺中市,霧峰區,本堂里,1486,1456,262,575,837,59,896
公投第１４案,臺中市,霧峰區,本堂里,1487,1573,297,609,906,52,958
公投第１４案,臺中市,霧峰區,本堂里,1488,1591,238,674,912,41,953
公投第１４案,臺中市,霧峰區,本堂里,1489,1214,194,539,733,49,782
公投第１４案,臺中市,霧峰區,北柳里,1490,1267,188,494,682,49,731
公投第１４案,臺中市,霧峰區,北柳里,1491,1277,202,508,710,50,760
公投第１４案,臺中市,霧峰區,北柳里,1492,1366,227,507,734,53,787
公投第１４案,臺中市,霧峰區,南柳里,1493,994,193,450,643,47,690
公投第１４案,臺中市,霧峰區,南柳里,1494,863,156,362,518,33,551
公投第１４案,臺中市,霧峰區,四德里,1495,1274,206,488,694,41,735
公投第１４案,臺中市,霧峰區,四德里,1496,1162,175,441,616,70,686
公投第１４案,臺中市,霧峰區,五福里,1497,1252,182,530,712,67,779
公投第１４案,臺中市,霧峰區,五福里,1498,1322,219,517,736,52,788
公投第１４案,臺中市,霧峰區,丁台里,1499,1116,191,470,661,51,712
公投第１４案,臺中市,霧峰區,丁台里,1500,1156,201,464,665,72,737
公投第１４案,臺中市,霧峰區,北勢里,1501,1147,175,501,676,53,729
公投第１４案,臺中市,霧峰區,北勢里,1502,928,129,453,582,48,630
公投第１４案,臺中市,霧峰區,南勢里,1503,1296,189,495,684,47,731
公投第１４案,臺中市,霧峰區,萬豐里,1504,1314,198,466,664,62,726
公投第１４案,臺中市,霧峰區,萬豐里,1505,1328,200,550,750,61,811
公投第１４案,臺中市,霧峰區,舊正里,1506,989,182,350,532,57,589
公投第１４案,臺中市,霧峰區,舊正里,1507,1088,175,446,621,62,683
公投第１４案,臺中市,霧峰區,坑口里,1508,1363,203,606,809,51,860
公投第１４案,臺中市,霧峰區,坑口里,1509,1573,246,656,902,64,966
公投第１４案,臺中市,霧峰區,峰谷里,1510,1117,149,438,587,61,648
公投第１４案,臺中市,霧峰區,六股里,1511,1342,211,587,798,73,871
公投第１４案,臺中市,霧峰區,六股里,1512,1024,190,428,618,64,682
公投第１４案,臺中市,東勢區,慶福里,1513,1299,146,513,659,67,726
公投第１４案,臺中市,東勢區,慶東里,1514,1007,118,407,525,58,583
公投第１４案,臺中市,東勢區,慶東里,1515,859,93,335,428,52,480
公投第１４案,臺中市,東勢區,上城里,1516,991,154,430,584,63,647
公投第１４案,臺中市,東勢區,下城里,1517,863,118,322,440,22,462
公投第１４案,臺中市,東勢區,詒福里,1518,1628,201,627,828,98,926
公投第１４案,臺中市,東勢區,新盛里,1519,1335,213,450,663,55,718
公投第１４案,臺中市,東勢區,新盛里,1520,1092,193,449,642,58,700
公投第１４案,臺中市,東勢區,新盛里,1521,1050,174,465,639,41,680
公投第１４案,臺中市,東勢區,新盛里,1522,1431,185,597,782,47,829
公投第１４案,臺中市,東勢區,福隆里,1523,1372,190,584,774,49,823
公投第１４案,臺中市,東勢區,福隆里,1524,1412,259,590,849,38,887
公投第１４案,臺中市,東勢區,福隆里,1525,878,107,358,465,54,519
公投第１４案,臺中市,東勢區,隆興里,1526,1475,160,539,699,65,764
公投第１４案,臺中市,東勢區,中嵙里,1527,872,95,352,447,26,473
公投第１４案,臺中市,東勢區,中嵙里,1528,1006,121,390,511,61,572
公投第１４案,臺中市,東勢區,泰昌里,1529,1222,184,482,666,30,696
公投第１４案,臺中市,東勢區,泰昌里,1530,1228,183,589,772,49,821
公投第１４案,臺中市,東勢區,泰昌里,1531,1036,159,454,613,34,647
公投第１４案,臺中市,東勢區,上新里,1532,977,166,428,594,26,620
公投第１４案,臺中市,東勢區,廣興里,1533,1395,214,540,754,44,798
公投第１４案,臺中市,東勢區,延平里,1534,1169,182,490,672,69,741
公投第１４案,臺中市,東勢區,延平里,1535,1027,136,451,587,57,644
公投第１４案,臺中市,東勢區,南平里,1536,984,143,427,570,29,599
公投第１４案,臺中市,東勢區,南平里,1537,866,144,405,549,36,585
公投第１４案,臺中市,東勢區,東安里,1538,1031,150,440,590,51,641
公投第１４案,臺中市,東勢區,中寧里,1539,865,128,393,521,56,577
公投第１４案,臺中市,東勢區,北興里,1540,1357,190,620,810,53,863
公投第１４案,臺中市,東勢區,粵寧里,1541,736,108,311,419,34,453
公投第１４案,臺中市,東勢區,粵寧里,1542,1314,177,539,716,62,778
公投第１４案,臺中市,東勢區,下新里,1543,1677,237,581,818,100,918
公投第１４案,臺中市,東勢區,東新里,1544,950,137,428,565,22,587
公投第１４案,臺中市,東勢區,東新里,1545,1007,146,438,584,46,630
公投第１４案,臺中市,東勢區,興隆里,1546,1214,153,437,590,46,636
公投第１４案,臺中市,東勢區,茂興里,1547,907,108,373,481,43,524
公投第１４案,臺中市,東勢區,茂興里,1548,902,132,320,452,44,496
公投第１４案,臺中市,東勢區,泰興里,1549,720,73,239,312,18,330
公投第１４案,臺中市,東勢區,埤頭里,1550,666,78,236,314,15,329
公投第１４案,臺中市,東勢區,明正里,1551,1361,183,517,700,47,747
公投第１４案,臺中市,石岡區,石岡里,1552,1244,201,493,694,40,734
公投第１４案,臺中市,石岡區,萬安里,1553,1539,157,656,813,62,875
公投第１４案,臺中市,石岡區,九房里,1554,1202,184,485,669,46,715
公投第１４案,臺中市,石岡區,金星里,1555,1272,192,440,632,65,697
公投第１４案,臺中市,石岡區,龍興里,1556,652,88,266,354,35,389
公投第１４案,臺中市,石岡區,萬興里,1557,1457,246,656,902,55,957
公投第１４案,臺中市,石岡區,梅子里,1558,1836,276,688,964,75,1039
公投第１４案,臺中市,石岡區,土牛里,1559,1001,134,399,533,48,581
公投第１４案,臺中市,石岡區,德興里,1560,1448,209,627,836,63,899
公投第１４案,臺中市,石岡區,和盛里,1561,1229,203,519,722,42,764
公投第１４案,臺中市,新社區,新社里,1562,1011,165,389,554,28,582
公投第１４案,臺中市,新社區,新社里,1563,1195,171,490,661,40,701
公投第１４案,臺中市,新社區,新社里,1564,1053,180,444,624,25,649
公投第１４案,臺中市,新社區,復盛里,1565,961,97,309,406,28,434
公投第１４案,臺中市,新社區,復盛里,1566,919,119,350,469,17,486
公投第１４案,臺中市,新社區,中正里,1567,1367,195,596,791,54,845
公投第１４案,臺中市,新社區,月湖里,1568,1010,150,373,523,28,551
公投第１４案,臺中市,新社區,崑山里,1569,1169,150,396,546,52,598
公投第１４案,臺中市,新社區,大南里,1570,989,142,374,516,47,563
公投第１４案,臺中市,新社區,大南里,1571,894,137,350,487,15,502
公投第１４案,臺中市,新社區,永源里,1572,1033,114,438,552,20,572
公投第１４案,臺中市,新社區,永源里,1573,1058,115,325,440,29,469
公投第１４案,臺中市,新社區,永源里,1574,845,115,301,416,20,436
公投第１４案,臺中市,新社區,中興里,1575,576,91,265,356,29,385
公投第１４案,臺中市,新社區,協成里,1576,1229,156,429,585,42,627
公投第１４案,臺中市,新社區,協成里,1577,890,137,288,425,17,442
公投第１４案,臺中市,新社區,協成里,1578,781,108,279,387,26,413
公投第１４案,臺中市,新社區,東興里,1579,1244,165,473,638,44,682
公投第１４案,臺中市,新社區,慶西里,1580,213,17,54,71,9,80
公投第１４案,臺中市,新社區,慶西里,1581,676,78,212,290,28,318
公投第１４案,臺中市,新社區,中和里,1582,585,42,218,260,24,284
公投第１４案,臺中市,新社區,福興里,1583,938,112,384,496,40,536
公投第１４案,臺中市,新社區,福興里,1584,224,23,82,105,5,110
公投第１４案,臺中市,和平區,南勢里,1585,956,163,417,580,32,612
公投第１４案,臺中市,和平區,南勢里,1586,963,116,477,593,39,632
公投第１４案,臺中市,和平區,天輪里,1587,456,65,187,252,19,271
公投第１４案,臺中市,和平區,博愛里,1588,1011,115,495,610,50,660
公投第１４案,臺中市,和平區,博愛里,1589,636,76,295,371,14,385
公投第１４案,臺中市,和平區,自由里,1590,270,25,152,177,6,183
公投第１４案,臺中市,和平區,自由里,1591,460,47,295,342,15,357
公投第１４案,臺中市,和平區,自由里,1592,321,46,179,225,18,243
公投第１４案,臺中市,和平區,達觀里,1593,783,128,367,495,21,516
公投第１４案,臺中市,和平區,達觀里,1594,336,47,170,217,14,231
公投第１４案,臺中市,和平區,中坑里,1595,451,79,231,310,11,321
公投第１４案,臺中市,和平區,梨山里,1596,366,28,166,194,11,205
公投第１４案,臺中市,和平區,梨山里,1597,771,73,283,356,10,366
公投第１４案,臺中市,和平區,梨山里,1598,574,60,238,298,23,321
公投第１４案,臺中市,和平區,梨山里,1599,274,31,126,157,14,171
公投第１４案,臺中市,和平區,平等里,1600,157,18,63,81,5,86
公投第１４案,臺中市,和平區,平等里,1601,713,73,345,418,25,443
公投第１４案,臺南市,後壁區,後壁里,1,743,112,271,383,43,426
公投第１４案,臺南市,後壁區,後壁里,2,898,141,279,420,28,448
公投第１４案,臺南市,後壁區,侯伯里,3,786,108,220,328,42,370
公投第１４案,臺南市,後壁區,侯伯里,4,534,77,166,243,32,275
公投第１４案,臺南市,後壁區,嘉苳里,5,1034,147,325,472,57,529
公投第１４案,臺南市,後壁區,嘉苳里,6,232,40,46,86,20,106
公投第１４案,臺南市,後壁區,土溝里,7,479,56,143,199,36,235
公投第１４案,臺南市,後壁區,土溝里,8,837,105,249,354,34,388
公投第１４案,臺南市,後壁區,上茄苳里,9,1085,149,255,404,41,445
公投第１４案,臺南市,後壁區,上茄苳里,10,1157,142,264,406,14,420
公投第１４案,臺南市,後壁區,菁豐里,11,755,82,250,332,54,386
公投第１４案,臺南市,後壁區,菁豐里,12,458,90,131,221,29,250
公投第１４案,臺南市,後壁區,菁寮里,13,371,29,120,149,25,174
公投第１４案,臺南市,後壁區,菁寮里,14,676,99,194,293,35,328
公投第１４案,臺南市,後壁區,菁寮里,15,428,46,114,160,30,190
公投第１４案,臺南市,後壁區,新嘉里,16,547,60,144,204,9,213
公投第１４案,臺南市,後壁區,新嘉里,17,455,55,139,194,41,235
公投第１４案,臺南市,後壁區,長短樹里,18,984,93,246,339,67,406
公投第１４案,臺南市,後壁區,長短樹里,19,483,66,124,190,35,225
公投第１４案,臺南市,後壁區,長短樹里,20,536,53,143,196,29,225
公投第１４案,臺南市,後壁區,竹新里,21,958,106,234,340,14,354
公投第１４案,臺南市,後壁區,竹新里,22,441,68,162,230,21,251
公投第１４案,臺南市,後壁區,新東里,23,677,100,196,296,66,362
公投第１４案,臺南市,後壁區,新東里,24,996,140,341,481,48,529
公投第１４案,臺南市,後壁區,頂安里,25,1255,169,355,524,32,556
公投第１４案,臺南市,後壁區,長安里,26,678,97,179,276,15,291
公投第１４案,臺南市,後壁區,長安里,27,553,57,163,220,14,234
公投第１４案,臺南市,後壁區,福安里,28,616,78,133,211,18,229
公投第１４案,臺南市,後壁區,福安里,29,1189,168,352,520,35,555
公投第１４案,臺南市,白河區,白河里,30,1176,197,368,565,62,627
公投第１４案,臺南市,白河區,白河里,31,546,92,164,256,18,274
公投第１４案,臺南市,白河區,永安里,32,859,164,276,440,26,466
公投第１４案,臺南市,白河區,永安里,33,946,139,347,486,36,522
公投第１４案,臺南市,白河區,永安里,34,1116,165,382,547,28,575
公投第１４案,臺南市,白河區,外角里,35,1397,167,350,517,35,552
公投第１４案,臺南市,白河區,庄內里,36,756,99,186,285,20,305
公投第１４案,臺南市,白河區,庄內里,37,871,125,252,377,48,425
公投第１４案,臺南市,白河區,秀祐里,38,897,135,280,415,32,447
公投第１４案,臺南市,白河區,河東里,39,784,83,158,241,36,277
公投第１４案,臺南市,白河區,河東里,40,572,81,138,219,17,236
公投第１４案,臺南市,白河區,虎山里,41,457,38,106,144,8,152
公投第１４案,臺南市,白河區,大林里,42,600,54,142,196,11,207
公投第１４案,臺南市,白河區,崁頭里,43,375,29,80,109,4,113
公投第１４案,臺南市,白河區,六溪里,44,508,38,88,126,7,133
公投第１４案,臺南市,白河區,關嶺里,45,631,63,129,192,9,201
公投第１４案,臺南市,白河區,關嶺里,46,391,32,76,108,8,116
公投第１４案,臺南市,白河區,仙草里,47,799,67,189,256,16,272
公投第１４案,臺南市,白河區,仙草里,48,506,39,111,150,19,169
公投第１４案,臺南市,白河區,詔豐里,49,832,124,222,346,26,372
公投第１４案,臺南市,白河區,詔豐里,50,1179,162,363,525,30,555
公投第１４案,臺南市,白河區,大竹里,51,744,88,155,243,14,257
公投第１４案,臺南市,白河區,大竹里,52,699,71,176,247,19,266
公投第１４案,臺南市,白河區,廣蓮里,53,633,70,143,213,11,224
公投第１４案,臺南市,白河區,廣蓮里,54,859,154,244,398,62,460
公投第１４案,臺南市,白河區,竹門里,55,884,110,226,336,51,387
公投第１４案,臺南市,白河區,崎內里,56,740,52,145,197,12,209
公投第１４案,臺南市,白河區,昇安里,57,1334,157,354,511,49,560
公投第１４案,臺南市,白河區,汴頭里,58,723,98,195,293,60,353
公投第１４案,臺南市,白河區,內角里,59,682,102,227,329,52,381
公投第１４案,臺南市,白河區,馬稠後里,60,855,132,259,391,47,438
公投第１４案,臺南市,白河區,馬稠後里,61,543,55,140,195,28,223
公投第１４案,臺南市,東山區,東山里,62,1401,166,405,571,47,618
公投第１４案,臺南市,東山區,東中里,63,1185,148,292,440,45,485
公投第１４案,臺南市,東山區,東中里,64,1303,148,331,479,57,536
公投第１４案,臺南市,東山區,東正里,65,732,79,186,265,29,294
公投第１４案,臺南市,東山區,東正里,66,721,79,162,241,35,276
公投第１４案,臺南市,東山區,大客里,67,1104,112,230,342,55,397
公投第１４案,臺南市,東山區,三榮里,68,943,97,263,360,27,387
公投第１４案,臺南市,東山區,科里里,69,653,46,113,159,4,163
公投第１４案,臺南市,東山區,科里里,70,596,85,149,234,59,293
公投第１４案,臺南市,東山區,東河里,71,878,120,225,345,52,397
公投第１４案,臺南市,東山區,聖賢里,72,771,98,185,283,38,321
公投第１４案,臺南市,東山區,聖賢里,73,483,63,129,192,22,214
公投第１４案,臺南市,東山區,聖賢里,74,640,100,182,282,36,318
公投第１４案,臺南市,東山區,南溪里,75,425,29,69,98,2,100
公投第１４案,臺南市,東山區,水雲里,76,394,33,105,138,7,145
公投第１４案,臺南市,東山區,林安里,77,373,44,115,159,28,187
公投第１４案,臺南市,東山區,東原里,78,1257,92,308,400,39,439
公投第１４案,臺南市,東山區,東原里,79,887,56,157,213,7,220
公投第１４案,臺南市,東山區,嶺南里,80,658,39,129,168,9,177
公投第１４案,臺南市,東山區,南勢里,81,1101,92,207,299,24,323
公投第１４案,臺南市,東山區,青山里,82,1057,72,194,266,18,284
公投第１４案,臺南市,東山區,高原里,83,639,69,200,269,35,304
公投第１４案,臺南市,東山區,高原里,84,270,37,69,106,11,117
公投第１４案,臺南市,鹽水區,水秀里,85,1037,145,345,490,69,559
公投第１４案,臺南市,鹽水區,水秀里,86,480,79,155,234,22,256
公投第１４案,臺南市,鹽水區,津城里,87,636,129,223,352,30,382
公投第１４案,臺南市,鹽水區,津城里,88,321,52,109,161,9,170
公投第１４案,臺南市,鹽水區,津城里,89,497,77,192,269,28,297
公投第１４案,臺南市,鹽水區,月港里,90,759,150,267,417,22,439
公投第１４案,臺南市,鹽水區,月港里,91,341,46,106,152,12,164
公投第１４案,臺南市,鹽水區,月港里,92,507,73,184,257,22,279
公投第１４案,臺南市,鹽水區,橋南里,93,863,114,241,355,24,379
公投第１４案,臺南市,鹽水區,橋南里,94,1373,210,425,635,26,661
公投第１４案,臺南市,鹽水區,橋南里,95,1507,217,471,688,65,753
公投第１４案,臺南市,鹽水區,岸內里,96,1374,232,443,675,53,728
公投第１４案,臺南市,鹽水區,岸內里,97,1244,194,349,543,36,579
公投第１４案,臺南市,鹽水區,岸內里,98,1022,139,346,485,55,540
公投第１４案,臺南市,鹽水區,汫水里,99,921,109,205,314,36,350
公投第１４案,臺南市,鹽水區,義中里,100,847,145,268,413,45,458
公投第１４案,臺南市,鹽水區,義中里,101,736,87,153,240,9,249
公投第１４案,臺南市,鹽水區,三明里,102,761,103,265,368,15,383
公投第１４案,臺南市,鹽水區,三明里,103,285,36,90,126,10,136
公投第１４案,臺南市,鹽水區,三明里,104,493,66,138,204,22,226
公投第１４案,臺南市,鹽水區,文昌里,105,621,61,155,216,24,240
公投第１４案,臺南市,鹽水區,文昌里,106,392,42,93,135,8,143
公投第１４案,臺南市,鹽水區,歡雅里,107,925,115,303,418,32,450
公投第１４案,臺南市,鹽水區,歡雅里,108,728,75,210,285,33,318
公投第１４案,臺南市,鹽水區,三和里,109,214,16,48,64,16,80
公投第１４案,臺南市,鹽水區,三和里,110,387,41,124,165,12,177
公投第１４案,臺南市,鹽水區,三和里,111,301,40,95,135,19,154
公投第１４案,臺南市,鹽水區,竹林里,112,755,94,167,261,30,291
公投第１４案,臺南市,鹽水區,竹林里,113,365,38,88,126,22,148
公投第１４案,臺南市,鹽水區,坔頭港里,114,935,141,252,393,29,422
公投第１４案,臺南市,鹽水區,坔頭港里,115,494,76,123,199,23,222
公投第１４案,臺南市,新營區,忠政里,116,1693,234,505,739,55,794
公投第１４案,臺南市,新營區,忠政里,117,1561,238,568,806,66,872
公投第１４案,臺南市,新營區,忠政里,118,1487,233,532,765,42,807
公投第１４案,臺南市,新營區,民權里,119,1232,186,436,622,20,642
公投第１４案,臺南市,新營區,民權里,120,1067,183,346,529,20,549
公投第１４案,臺南市,新營區,三仙里,121,1419,223,407,630,30,660
公投第１４案,臺南市,新營區,三仙里,122,1466,258,513,771,32,803
公投第１４案,臺南市,新營區,永平里,123,932,180,350,530,44,574
公投第１４案,臺南市,新營區,永平里,124,1099,151,332,483,22,505
公投第１４案,臺南市,新營區,永平里,125,757,97,236,333,27,360
公投第１４案,臺南市,新營區,大宏里,126,888,158,307,465,37,502
公投第１４案,臺南市,新營區,大宏里,127,1115,206,352,558,13,571
公投第１４案,臺南市,新營區,大宏里,128,937,146,287,433,21,454
公投第１４案,臺南市,新營區,王公里,129,1387,214,432,646,40,686
公投第１４案,臺南市,新營區,王公里,130,1526,213,500,713,46,759
公投第１４案,臺南市,新營區,王公里,131,1301,232,474,706,28,734
公投第１４案,臺南市,新營區,新東里,132,1538,268,564,832,37,869
公投第１４案,臺南市,新營區,新東里,133,1584,281,534,815,40,855
公投第１４案,臺南市,新營區,新東里,134,1583,300,567,867,25,892
公投第１４案,臺南市,新營區,新東里,135,1530,307,510,817,25,842
公投第１４案,臺南市,新營區,中營里,136,1193,230,428,658,41,699
公投第１４案,臺南市,新營區,土庫里,137,1439,198,358,556,17,573
公投第１４案,臺南市,新營區,興業里,138,1438,223,548,771,37,808
公投第１４案,臺南市,新營區,興業里,139,359,58,132,190,20,210
公投第１４案,臺南市,新營區,南興里,140,1233,167,331,498,28,526
公投第１４案,臺南市,新營區,南興里,141,1227,132,370,502,25,527
公投第１４案,臺南市,新營區,民生里,142,1320,176,403,579,27,606
公投第１４案,臺南市,新營區,民生里,143,1930,283,514,797,26,823
公投第１４案,臺南市,新營區,新北里,144,1501,238,511,749,41,790
公投第１４案,臺南市,新營區,新北里,145,1475,207,486,693,30,723
公投第１４案,臺南市,新營區,新北里,146,1753,302,594,896,38,934
公投第１４案,臺南市,新營區,新南里,147,1748,292,532,824,39,863
公投第１４案,臺南市,新營區,新南里,148,1741,265,584,849,41,890
公投第１４案,臺南市,新營區,新南里,149,1433,217,460,677,21,698
公投第１４案,臺南市,新營區,民榮里,150,1595,253,538,791,38,829
公投第１４案,臺南市,新營區,民榮里,151,959,138,285,423,15,438
公投第１４案,臺南市,新營區,民榮里,152,1865,270,579,849,54,903
公投第１４案,臺南市,新營區,埤寮里,153,1678,228,486,714,71,785
公投第１４案,臺南市,新營區,護鎮里,154,1373,165,398,563,57,620
公投第１４案,臺南市,新營區,太南里,155,1431,178,338,516,28,544
公投第１４案,臺南市,新營區,太南里,156,291,39,65,104,3,107
公投第１４案,臺南市,新營區,太北里,157,1749,283,517,800,53,853
公投第１４案,臺南市,新營區,南紙里,158,1862,250,561,811,36,847
公投第１４案,臺南市,新營區,南紙里,159,1821,306,596,902,83,985
公投第１４案,臺南市,新營區,嘉芳里,160,1845,248,557,805,55,860
公投第１４案,臺南市,新營區,姑爺里,161,542,56,143,199,8,207
公投第１４案,臺南市,新營區,姑爺里,162,402,61,83,144,3,147
公投第１４案,臺南市,新營區,五興里,163,703,118,238,356,55,411
公投第１４案,臺南市,新營區,五興里,164,941,113,272,385,37,422
公投第１４案,臺南市,柳營區,士林里,165,1166,179,351,530,47,577
公投第１４案,臺南市,柳營區,士林里,166,625,111,224,335,12,347
公投第１４案,臺南市,柳營區,光福里,167,738,82,211,293,32,325
公投第１４案,臺南市,柳營區,光福里,168,834,135,307,442,23,465
公投第１４案,臺南市,柳營區,中埕里,169,1104,160,318,478,33,511
公投第１４案,臺南市,柳營區,東昇里,170,1015,153,296,449,24,473
公投第１４案,臺南市,柳營區,東昇里,171,1720,200,646,846,98,944
公投第１４案,臺南市,柳營區,八翁里,172,1391,190,404,594,65,659
公投第１４案,臺南市,柳營區,人和里,173,425,63,129,192,10,202
公投第１４案,臺南市,柳營區,人和里,174,318,36,94,130,9,139
公投第１４案,臺南市,柳營區,太康里,175,753,112,224,336,37,373
公投第１４案,臺南市,柳營區,太康里,176,730,100,200,300,45,345
公投第１４案,臺南市,柳營區,重溪里,177,725,109,207,316,40,356
公投第１４案,臺南市,柳營區,重溪里,178,787,109,277,386,36,422
公投第１４案,臺南市,柳營區,重溪里,179,297,48,100,148,22,170
公投第１４案,臺南市,柳營區,篤農里,180,673,87,247,334,40,374
公投第１４案,臺南市,柳營區,篤農里,181,640,97,203,300,59,359
公投第１４案,臺南市,柳營區,大農里,182,660,102,162,264,31,295
公投第１４案,臺南市,柳營區,神農里,183,1212,164,320,484,47,531
公投第１４案,臺南市,柳營區,神農里,184,202,24,60,84,7,91
公投第１４案,臺南市,柳營區,果毅里,185,1049,127,305,432,77,509
公投第１４案,臺南市,柳營區,果毅里,186,158,21,51,72,3,75
公投第１４案,臺南市,柳營區,旭山里,187,921,118,292,410,54,464
公投第１４案,臺南市,柳營區,旭山里,188,504,67,155,222,12,234
公投第１４案,臺南市,柳營區,旭山里,189,157,13,51,64,3,67
公投第１４案,臺南市,北門區,永隆里,190,484,78,137,215,14,229
公投第１４案,臺南市,北門區,永隆里,191,401,42,113,155,11,166
公投第１４案,臺南市,北門區,北門里,192,456,38,132,170,6,176
公投第１４案,臺南市,北門區,北門里,193,382,71,120,191,17,208
公投第１４案,臺南市,北門區,玉港里,194,356,45,113,158,24,182
公投第１４案,臺南市,北門區,玉港里,195,389,49,87,136,8,144
公投第１４案,臺南市,北門區,保吉里,196,742,69,233,302,7,309
公投第１４案,臺南市,北門區,保吉里,197,599,67,196,263,10,273
公投第１４案,臺南市,北門區,蚵寮里,198,594,64,157,221,27,248
公投第１４案,臺南市,北門區,蚵寮里,199,572,61,168,229,16,245
公投第１４案,臺南市,北門區,蚵寮里,200,318,37,65,102,4,106
公投第１４案,臺南市,北門區,雙春里,201,473,52,114,166,11,177
公投第１４案,臺南市,北門區,錦湖里,202,954,238,75,313,16,329
公投第１４案,臺南市,北門區,慈安里,203,737,94,279,373,24,397
公投第１４案,臺南市,北門區,三光里,204,679,50,180,230,9,239
公投第１４案,臺南市,北門區,三光里,205,521,49,124,173,26,199
公投第１４案,臺南市,北門區,文山里,206,632,59,150,209,18,227
公投第１４案,臺南市,北門區,文山里,207,636,74,157,231,10,241
公投第１４案,臺南市,學甲區,秀昌里,208,862,140,299,439,45,484
公投第１４案,臺南市,學甲區,秀昌里,209,611,108,226,334,9,343
公投第１４案,臺南市,學甲區,秀昌里,210,936,142,311,453,23,476
公投第１４案,臺南市,學甲區,明宜里,211,1066,150,329,479,35,514
公投第１４案,臺南市,學甲區,明宜里,212,869,151,301,452,27,479
公投第１４案,臺南市,學甲區,慈福里,213,635,99,204,303,27,330
公投第１４案,臺南市,學甲區,慈福里,214,822,98,260,358,25,383
公投第１４案,臺南市,學甲區,慈福里,215,443,45,133,178,14,192
公投第１４案,臺南市,學甲區,仁得里,216,1370,192,469,661,33,694
公投第１４案,臺南市,學甲區,仁得里,217,1117,184,384,568,43,611
公投第１４案,臺南市,學甲區,仁得里,218,1365,184,433,617,62,679
公投第１４案,臺南市,學甲區,新達里,219,1489,182,462,644,69,713
公投第１４案,臺南市,學甲區,新達里,220,627,69,166,235,30,265
公投第１４案,臺南市,學甲區,新榮里,221,1052,170,330,500,26,526
公投第１４案,臺南市,學甲區,新榮里,222,1183,184,350,534,26,560
公投第１４案,臺南市,學甲區,大灣里,223,979,111,274,385,29,414
公投第１４案,臺南市,學甲區,豐和里,224,1241,172,337,509,48,557
公投第１４案,臺南市,學甲區,中洲里,225,843,92,205,297,23,320
公投第１４案,臺南市,學甲區,中洲里,226,580,62,189,251,30,281
公投第１４案,臺南市,學甲區,光華里,227,832,90,209,299,18,317
公投第１４案,臺南市,學甲區,光華里,228,406,40,104,144,7,151
公投第１４案,臺南市,學甲區,宅港里,229,818,124,265,389,36,425
公投第１４案,臺南市,學甲區,平和里,230,1052,123,271,394,13,407
公投第１４案,臺南市,學甲區,三慶里,231,578,71,158,229,13,242
公投第１４案,臺南市,學甲區,三慶里,232,430,49,110,159,19,178
公投第１４案,臺南市,學甲區,三慶里,233,361,38,120,158,9,167
公投第１４案,臺南市,將軍區,長榮里,234,1110,188,407,595,41,636
公投第１４案,臺南市,將軍區,西甲里,235,1418,189,463,652,23,675
公投第１４案,臺南市,將軍區,西甲里,236,969,131,312,443,22,465
公投第１４案,臺南市,將軍區,忠嘉里,237,519,93,180,273,30,303
公投第１４案,臺南市,將軍區,忠嘉里,238,1106,157,364,521,18,539
公投第１４案,臺南市,將軍區,忠嘉里,239,542,86,156,242,28,270
公投第１４案,臺南市,將軍區,忠嘉里,240,315,30,95,125,6,131
公投第１４案,臺南市,將軍區,苓仔寮里,241,584,64,154,218,23,241
公投第１４案,臺南市,將軍區,苓仔寮里,242,398,65,116,181,7,188
公投第１４案,臺南市,將軍區,苓仔寮里,243,608,84,158,242,16,258
公投第１４案,臺南市,將軍區,苓仔寮里,244,442,71,141,212,14,226
公投第１４案,臺南市,將軍區,巷埔里,245,650,67,168,235,9,244
公投第１４案,臺南市,將軍區,巷埔里,246,573,60,138,198,10,208
公投第１４案,臺南市,將軍區,將軍里,247,617,65,163,228,7,235
公投第１４案,臺南市,將軍區,將軍里,248,573,69,179,248,23,271
公投第１４案,臺南市,將軍區,將軍里,249,434,43,157,200,19,219
公投第１４案,臺南市,將軍區,玉山里,250,849,106,227,333,13,346
公投第１４案,臺南市,將軍區,廣山里,251,645,62,175,237,22,259
公投第１４案,臺南市,將軍區,長沙里,252,690,66,198,264,18,282
公投第１４案,臺南市,將軍區,長沙里,253,663,48,145,193,8,201
公投第１４案,臺南市,將軍區,平沙里,254,1175,139,355,494,27,521
公投第１４案,臺南市,將軍區,鯤鯓里,255,837,79,196,275,32,307
公投第１４案,臺南市,將軍區,鯤鯓里,256,1061,134,332,466,89,555
公投第１４案,臺南市,將軍區,鯤溟里,257,976,97,246,343,12,355
公投第１４案,臺南市,七股區,後港里,258,534,76,169,245,13,258
公投第１４案,臺南市,七股區,後港里,259,508,80,180,260,12,272
公投第１４案,臺南市,七股區,大潭里,260,665,68,185,253,5,258
公投第１４案,臺南市,七股區,篤加里,261,834,102,242,344,20,364
公投第１４案,臺南市,七股區,頂山里,262,810,87,261,348,10,358
公投第１４案,臺南市,七股區,西寮里,263,480,33,126,159,12,171
公投第１４案,臺南市,七股區,塩埕里,264,445,42,119,161,12,173
公投第１４案,臺南市,七股區,中寮里,265,680,44,134,178,17,195
公投第１４案,臺南市,七股區,龍山里,266,838,97,240,337,11,348
公投第１４案,臺南市,七股區,龍山里,267,780,77,206,283,17,300
公投第１４案,臺南市,七股區,溪南里,268,350,64,123,187,9,196
公投第１４案,臺南市,七股區,七股里,269,907,171,301,472,48,520
公投第１４案,臺南市,七股區,玉成里,270,780,86,241,327,17,344
公投第１４案,臺南市,七股區,大埕里,271,1658,235,463,698,37,735
公投第１４案,臺南市,七股區,大埕里,272,913,121,274,395,19,414
公投第１４案,臺南市,七股區,樹林里,273,1202,200,354,554,50,604
公投第１４案,臺南市,七股區,樹林里,274,696,78,173,251,9,260
公投第１４案,臺南市,七股區,竹橋里,275,647,84,201,285,36,321
公投第１４案,臺南市,七股區,竹橋里,276,622,106,253,359,31,390
公投第１４案,臺南市,七股區,義合里,277,1175,172,435,607,66,673
公投第１４案,臺南市,七股區,義合里,278,698,108,185,293,21,314
公投第１４案,臺南市,七股區,永吉里,279,983,131,322,453,60,513
公投第１４案,臺南市,七股區,三股里,280,1366,162,348,510,34,544
公投第１４案,臺南市,七股區,十份里,281,1379,179,363,542,65,607
公投第１４案,臺南市,佳里區,東寧里,282,1391,233,502,735,42,777
公投第１４案,臺南市,佳里區,東寧里,283,829,157,303,460,31,491
公投第１４案,臺南市,佳里區,忠仁里,284,1401,187,417,604,39,643
公投第１４案,臺南市,佳里區,忠仁里,285,1452,188,428,616,20,636
公投第１４案,臺南市,佳里區,鎮山里,286,1382,229,462,691,44,735
公投第１４案,臺南市,佳里區,鎮山里,287,1463,224,503,727,48,775
公投第１４案,臺南市,佳里區,鎮山里,288,1280,188,412,600,39,639
公投第１４案,臺南市,佳里區,鎮山里,289,1486,244,504,748,69,817
公投第１４案,臺南市,佳里區,安西里,290,1378,257,454,711,52,763
公投第１４案,臺南市,佳里區,安西里,291,1505,231,540,771,49,820
公投第１４案,臺南市,佳里區,安西里,292,1860,265,647,912,55,967
公投第１４案,臺南市,佳里區,安西里,293,1134,190,377,567,66,633
公投第１４案,臺南市,佳里區,文新里,294,1426,165,577,742,17,759
公投第１４案,臺南市,佳里區,文新里,295,1779,299,570,869,66,935
公投第１４案,臺南市,佳里區,文新里,296,1906,322,675,997,45,1042
公投第１４案,臺南市,佳里區,建南里,297,1425,225,462,687,38,725
公投第１４案,臺南市,佳里區,建南里,298,1255,199,422,621,37,658
公投第１４案,臺南市,佳里區,建南里,299,1524,241,459,700,47,747
公投第１４案,臺南市,佳里區,南勢里,300,1631,275,526,801,30,831
公投第１４案,臺南市,佳里區,南勢里,301,1546,243,569,812,53,865
公投第１４案,臺南市,佳里區,南勢里,302,1187,221,447,668,42,710
公投第１４案,臺南市,佳里區,六安里,303,1381,240,465,705,26,731
公投第１４案,臺南市,佳里區,六安里,304,1364,206,456,662,26,688
公投第１４案,臺南市,佳里區,六安里,305,1314,228,457,685,21,706
公投第１４案,臺南市,佳里區,佳化里,306,1164,281,324,605,45,650
公投第１４案,臺南市,佳里區,佳化里,307,961,135,333,468,48,516
公投第１４案,臺南市,佳里區,佳興里,308,1218,173,409,582,43,625
公投第１４案,臺南市,佳里區,佳興里,309,919,154,325,479,18,497
公投第１４案,臺南市,佳里區,營溪里,310,689,109,228,337,24,361
公投第１４案,臺南市,佳里區,營溪里,311,383,62,105,167,10,177
公投第１４案,臺南市,佳里區,海澄里,312,1507,201,481,682,42,724
公投第１４案,臺南市,佳里區,海澄里,313,702,93,220,313,33,346
公投第１４案,臺南市,佳里區,下營里,314,907,128,340,468,36,504
公投第１４案,臺南市,佳里區,下營里,315,937,170,348,518,47,565
公投第１４案,臺南市,佳里區,塭內里,316,1030,180,312,492,73,565
公投第１４案,臺南市,佳里區,塭內里,317,981,145,324,469,42,511
公投第１４案,臺南市,佳里區,塭內里,318,787,108,241,349,28,377
公投第１４案,臺南市,佳里區,民安里,319,1513,194,518,712,63,775
公投第１４案,臺南市,佳里區,子龍里,320,714,99,190,289,19,308
公投第１４案,臺南市,佳里區,子龍里,321,745,123,201,324,44,368
公投第１４案,臺南市,佳里區,子龍里,322,951,150,268,418,27,445
公投第１４案,臺南市,西港區,西港里,323,933,143,303,446,20,466
公投第１４案,臺南市,西港區,西港里,324,901,157,290,447,25,472
公投第１４案,臺南市,西港區,西港里,325,1314,206,391,597,25,622
公投第１４案,臺南市,西港區,慶安里,326,1349,211,422,633,59,692
公投第１４案,臺南市,西港區,慶安里,327,1014,174,346,520,43,563
公投第１４案,臺南市,西港區,慶安里,328,1900,230,506,736,31,767
公投第１４案,臺南市,西港區,南海里,329,1663,270,430,700,45,745
公投第１４案,臺南市,西港區,南海里,330,738,109,193,302,15,317
公投第１４案,臺南市,西港區,港東里,331,1211,187,424,611,35,646
公投第１４案,臺南市,西港區,港東里,332,382,55,112,167,18,185
公投第１４案,臺南市,西港區,檨林里,333,786,100,256,356,22,378
公投第１４案,臺南市,西港區,檨林里,334,838,107,277,384,16,400
公投第１４案,臺南市,西港區,後營里,335,1449,203,369,572,42,614
公投第１４案,臺南市,西港區,營西里,336,1479,175,415,590,32,622
公投第１４案,臺南市,西港區,金砂里,337,763,110,265,375,48,423
公投第１４案,臺南市,西港區,劉厝里,338,1297,158,410,568,21,589
公投第１４案,臺南市,西港區,竹林里,339,1393,198,417,615,33,648
公投第１４案,臺南市,西港區,永樂里,340,958,124,250,374,13,387
公投第１４案,臺南市,西港區,永樂里,341,391,66,129,195,21,216
公投第１４案,臺南市,西港區,新復里,342,805,111,268,379,44,423
公投第１４案,臺南市,下營區,下營里,343,1558,192,441,633,48,681
公投第１４案,臺南市,下營區,仁里里,344,1112,160,264,424,33,457
公投第１４案,臺南市,下營區,仁里里,345,893,127,252,379,45,424
公投第１４案,臺南市,下營區,宅內里,346,1623,183,437,620,53,673
公投第１４案,臺南市,下營區,後街里,347,1568,229,481,710,63,773
公投第１４案,臺南市,下營區,新興里,348,985,127,349,476,29,505
公投第１４案,臺南市,下營區,新興里,349,953,137,279,416,18,434
公投第１４案,臺南市,下營區,營前里,350,1031,152,308,460,22,482
公投第１４案,臺南市,下營區,營前里,351,1077,173,363,536,65,601
公投第１４案,臺南市,下營區,大吉里,352,703,98,165,263,35,298
公投第１４案,臺南市,下營區,大吉里,353,854,102,240,342,19,361
公投第１４案,臺南市,下營區,茅營里,354,1164,171,369,540,46,586
公投第１４案,臺南市,下營區,茅營里,355,1091,155,307,462,19,481
公投第１４案,臺南市,下營區,開化里,356,959,128,318,446,47,493
公投第１４案,臺南市,下營區,開化里,357,935,154,261,415,30,445
公投第１４案,臺南市,下營區,西連里,358,893,157,264,421,41,462
公投第１４案,臺南市,下營區,賀建里,359,1293,199,408,607,72,679
公投第１４案,臺南市,下營區,紅甲里,360,1185,198,320,518,108,626
公投第１４案,臺南市,下營區,紅甲里,361,1070,126,253,379,18,397
公投第１４案,臺南市,六甲區,六甲里,362,819,137,279,416,53,469
公投第１４案,臺南市,六甲區,六甲里,363,645,105,201,306,20,326
公投第１４案,臺南市,六甲區,六甲里,364,1444,228,387,615,40,655
公投第１４案,臺南市,六甲區,甲東里,365,1554,203,414,617,44,661
公投第１４案,臺南市,六甲區,甲東里,366,1171,166,301,467,34,501
公投第１４案,臺南市,六甲區,甲南里,367,1351,197,391,588,60,648
公投第１４案,臺南市,六甲區,七甲里,368,1010,121,271,392,77,469
公投第１４案,臺南市,六甲區,七甲里,369,919,131,249,380,54,434
公投第１４案,臺南市,六甲區,二甲里,370,1369,217,396,613,51,664
公投第１４案,臺南市,六甲區,二甲里,371,976,154,301,455,54,509
公投第１４案,臺南市,六甲區,二甲里,372,1015,163,347,510,50,560
公投第１４案,臺南市,六甲區,水林里,373,1176,169,330,499,28,527
公投第１４案,臺南市,六甲區,水林里,374,939,135,302,437,46,483
公投第１４案,臺南市,六甲區,中社里,375,712,117,211,328,45,373
公投第１４案,臺南市,六甲區,中社里,376,881,153,273,426,32,458
公投第１４案,臺南市,六甲區,龜港里,377,1184,216,416,632,55,687
公投第１４案,臺南市,六甲區,菁埔里,378,599,99,242,341,24,365
公投第１４案,臺南市,六甲區,王爺里,379,759,69,169,238,7,245
公投第１４案,臺南市,六甲區,大丘里,380,621,66,150,216,31,247
公投第１４案,臺南市,麻豆區,新興里,381,1205,86,486,572,42,614
公投第１４案,臺南市,麻豆區,新興里,382,660,116,230,346,23,369
公投第１４案,臺南市,麻豆區,巷口里,383,523,97,181,278,13,291
公投第１４案,臺南市,麻豆區,巷口里,384,1597,273,488,761,33,794
公投第１４案,臺南市,麻豆區,東角里,385,1262,227,434,661,41,702
公投第１４案,臺南市,麻豆區,東角里,386,1325,228,480,708,39,747
公投第１４案,臺南市,麻豆區,晋江里,387,1384,260,411,671,23,694
公投第１４案,臺南市,麻豆區,晋江里,388,1121,196,353,549,24,573
公投第１４案,臺南市,麻豆區,中興里,389,1021,173,305,478,12,490
公投第１４案,臺南市,麻豆區,中興里,390,954,169,288,457,21,478
公投第１４案,臺南市,麻豆區,興農里,391,1513,234,427,661,24,685
公投第１４案,臺南市,麻豆區,油車里,392,1726,236,500,736,33,769
公投第１４案,臺南市,麻豆區,油車里,393,1804,275,568,843,64,907
公投第１４案,臺南市,麻豆區,北勢里,394,1106,151,343,494,32,526
公投第１４案,臺南市,麻豆區,大埕里,395,1503,256,488,744,40,784
公投第１４案,臺南市,麻豆區,大埕里,396,1302,204,419,623,43,666
公投第１４案,臺南市,麻豆區,清水里,397,645,104,197,301,13,314
公投第１４案,臺南市,麻豆區,清水里,398,777,128,274,402,34,436
公投第１４案,臺南市,麻豆區,南勢里,399,1612,246,480,726,39,765
公投第１４案,臺南市,麻豆區,南勢里,400,718,113,193,306,11,317
公投第１４案,臺南市,麻豆區,寮廍里,401,1656,246,444,690,15,705
公投第１４案,臺南市,麻豆區,埤頭里,402,1355,238,369,607,57,664
公投第１４案,臺南市,麻豆區,埤頭里,403,977,133,252,385,23,408
公投第１４案,臺南市,麻豆區,海埔里,404,1012,159,270,429,26,455
公投第１４案,臺南市,麻豆區,海埔里,405,626,126,204,330,18,348
公投第１４案,臺南市,麻豆區,海埔里,406,467,48,100,148,3,151
公投第１４案,臺南市,麻豆區,港尾里,407,1260,182,361,543,21,564
公投第１４案,臺南市,麻豆區,麻口里,408,1111,185,366,551,36,587
公投第１４案,臺南市,麻豆區,安業里,409,550,104,172,276,20,296
公投第１４案,臺南市,麻豆區,安業里,410,798,140,233,373,39,412
公投第１４案,臺南市,麻豆區,謝厝寮里,411,852,164,288,452,57,509
公投第１４案,臺南市,麻豆區,謝厝寮里,412,830,130,208,338,12,350
公投第１４案,臺南市,麻豆區,安正里,413,941,150,237,387,17,404
公投第１４案,臺南市,麻豆區,井東里,414,1158,198,363,561,36,597
公投第１４案,臺南市,麻豆區,井東里,415,612,79,194,273,7,280
公投第１４案,臺南市,官田區,官田里,416,1104,148,327,475,19,494
公投第１４案,臺南市,官田區,官田里,417,965,150,288,438,36,474
公投第１４案,臺南市,官田區,二鎮里,418,1402,230,430,660,41,701
公投第１４案,臺南市,官田區,二鎮里,419,1653,278,500,778,130,908
公投第１４案,臺南市,官田區,烏山頭里,420,966,130,265,395,57,452
公投第１４案,臺南市,官田區,烏山頭里,421,284,36,78,114,11,125
公投第１４案,臺南市,官田區,大崎里,422,402,55,60,115,7,122
公投第１４案,臺南市,官田區,隆田里,423,982,169,309,478,9,487
公投第１４案,臺南市,官田區,隆田里,424,975,320,76,396,30,426
公投第１４案,臺南市,官田區,隆本里,425,802,126,251,377,21,398
公投第１４案,臺南市,官田區,隆本里,426,1118,188,381,569,36,605
公投第１４案,臺南市,官田區,隆本里,427,1455,245,441,686,31,717
公投第１４案,臺南市,官田區,南廍里,428,1208,184,390,574,32,606
公投第１４案,臺南市,官田區,東西庄里,429,1293,186,377,563,57,620
公投第１４案,臺南市,官田區,東西庄里,430,607,86,133,219,24,243
公投第１４案,臺南市,官田區,渡拔里,431,501,73,145,218,22,240
公投第１４案,臺南市,官田區,渡拔里,432,728,127,221,348,53,401
公投第１４案,臺南市,官田區,渡拔里,433,842,153,233,386,24,410
公投第１４案,臺南市,官田區,渡拔里,434,515,72,170,242,36,278
公投第１４案,臺南市,官田區,社子里,435,873,118,249,367,16,383
公投第１４案,臺南市,大內區,石湖里,436,759,87,204,291,41,332
公投第１４案,臺南市,大內區,石湖里,437,262,16,70,86,2,88
公投第１４案,臺南市,大內區,石林里,438,646,82,146,228,17,245
公投第１４案,臺南市,大內區,石城里,439,1473,165,378,543,57,600
公投第１４案,臺南市,大內區,內江里,440,915,109,322,431,66,497
公投第１４案,臺南市,大內區,大內里,441,779,137,261,398,41,439
公投第１４案,臺南市,大內區,內郭里,442,637,126,211,337,51,388
公投第１４案,臺南市,大內區,頭社里,443,993,123,293,416,30,446
公投第１４案,臺南市,大內區,環湖里,444,766,77,298,375,35,410
公投第１４案,臺南市,大內區,二溪里,445,841,96,289,385,37,422
公投第１４案,臺南市,大內區,曲溪里,446,583,58,186,244,42,286
公投第１４案,臺南市,楠西區,楠西里,447,978,101,326,427,49,476
公投第１４案,臺南市,楠西區,楠西里,448,870,123,303,426,50,476
公投第１４案,臺南市,楠西區,灣丘里,449,1160,91,286,377,15,392
公投第１４案,臺南市,楠西區,密枝里,450,699,69,213,282,22,304
公投第１４案,臺南市,楠西區,照興里,451,990,82,282,364,22,386
公投第１４案,臺南市,楠西區,鹿田里,452,928,102,279,381,33,414
公投第１４案,臺南市,楠西區,龜丹里,453,660,68,207,275,44,319
公投第１４案,臺南市,楠西區,東勢里,454,1187,138,385,523,64,587
公投第１４案,臺南市,楠西區,東勢里,455,1056,118,340,458,35,493
公投第１４案,臺南市,南化區,南化里,456,690,111,224,335,39,374
公投第１４案,臺南市,南化區,南化里,457,695,104,227,331,56,387
公投第１４案,臺南市,南化區,小崙里,458,806,84,246,330,32,362
公投第１４案,臺南市,南化區,東和里,459,654,53,188,241,30,271
公投第１４案,臺南市,南化區,西埔里,460,783,81,169,250,35,285
公投第１４案,臺南市,南化區,中坑里,461,425,59,137,196,10,206
公投第１４案,臺南市,南化區,北平里,462,559,69,178,247,29,276
公投第１４案,臺南市,南化區,北寮里,463,1189,155,349,504,24,528
公投第１４案,臺南市,南化區,玉山里,464,1044,135,365,500,43,543
公投第１４案,臺南市,南化區,關山里,465,941,123,334,457,29,486
公投第１４案,臺南市,玉井區,玉井里,466,1242,163,412,575,32,607
公投第１４案,臺南市,玉井區,玉田里,467,1141,141,423,564,33,597
公投第１４案,臺南市,玉井區,玉田里,468,698,97,226,323,20,343
公投第１４案,臺南市,玉井區,玉田里,469,849,126,273,399,26,425
公投第１４案,臺南市,玉井區,玉田里,470,949,119,348,467,43,510
公投第１４案,臺南市,玉井區,中正里,471,618,78,216,294,21,315
公投第１４案,臺南市,玉井區,中正里,472,594,70,166,236,15,251
公投第１４案,臺南市,玉井區,竹圍里,473,927,113,259,372,18,390
公投第１４案,臺南市,玉井區,竹圍里,474,512,64,174,238,37,275
公投第１４案,臺南市,玉井區,沙田里,475,509,58,164,222,20,242
公投第１４案,臺南市,玉井區,三埔里,476,496,64,179,243,25,268
公投第１４案,臺南市,玉井區,三和里,477,759,88,249,337,17,354
公投第１４案,臺南市,玉井區,望明里,478,669,60,191,251,9,260
公投第１４案,臺南市,玉井區,望明里,479,787,77,246,323,56,379
公投第１４案,臺南市,玉井區,層林里,480,620,79,175,254,40,294
公投第１４案,臺南市,玉井區,豐里里,481,987,146,300,446,57,503
公投第１４案,臺南市,左鎮區,光和里,482,392,39,124,163,26,189
公投第１４案,臺南市,左鎮區,榮和里,483,644,78,220,298,40,338
公投第１４案,臺南市,左鎮區,左鎮里,484,468,47,124,171,15,186
公投第１４案,臺南市,左鎮區,中正里,485,753,69,216,285,42,327
公投第１４案,臺南市,左鎮區,睦光里,486,345,33,112,145,14,159
公投第１４案,臺南市,左鎮區,內庄里,487,393,48,106,154,16,170
公投第１４案,臺南市,左鎮區,岡林里,488,420,43,142,185,18,203
公投第１４案,臺南市,左鎮區,草山里,489,313,26,82,108,12,120
公投第１４案,臺南市,左鎮區,二寮里,490,186,13,52,65,3,68
公投第１４案,臺南市,左鎮區,澄山里,491,504,51,130,181,45,226
公投第１４案,臺南市,善化區,東關里,492,1132,165,343,508,12,520
公投第１４案,臺南市,善化區,坐駕里,493,1845,300,562,862,52,914
公投第１４案,臺南市,善化區,坐駕里,494,2090,349,649,998,52,1050
公投第１４案,臺南市,善化區,光文里,495,1582,286,539,825,51,876
公投第１４案,臺南市,善化區,光文里,496,1901,371,616,987,67,1054
公投第１４案,臺南市,善化區,光文里,497,1818,288,608,896,53,949
公投第１４案,臺南市,善化區,文昌里,498,1639,273,540,813,46,859
公投第１４案,臺南市,善化區,文昌里,499,1061,204,366,570,32,602
公投第１４案,臺南市,善化區,南關里,500,1786,298,630,928,69,997
公投第１４案,臺南市,善化區,頂街里,501,1147,163,408,571,40,611
公投第１４案,臺南市,善化區,文正里,502,1581,260,472,732,56,788
公投第１４案,臺南市,善化區,胡家里,503,1240,224,362,586,70,656
公投第１４案,臺南市,善化區,胡厝里,504,1743,248,458,706,33,739
公投第１４案,臺南市,善化區,什乃里,505,1246,260,398,658,41,699
公投第１４案,臺南市,善化區,溪美里,506,961,153,302,455,22,477
公投第１４案,臺南市,善化區,溪美里,507,938,134,290,424,14,438
公投第１４案,臺南市,善化區,六分里,508,722,122,232,354,13,367
公投第１４案,臺南市,善化區,六德里,509,1062,148,312,460,35,495
公投第１４案,臺南市,善化區,田寮里,510,1715,285,510,795,80,875
公投第１４案,臺南市,善化區,昌隆里,511,1120,170,334,504,44,548
公投第１４案,臺南市,善化區,昌隆里,512,865,134,263,397,38,435
公投第１４案,臺南市,善化區,牛庄里,513,1574,291,467,758,62,820
公投第１４案,臺南市,善化區,嘉北里,514,1535,210,418,628,67,695
公投第１４案,臺南市,善化區,嘉南里,515,1106,192,333,525,58,583
公投第１４案,臺南市,善化區,小新里,516,1402,222,439,661,28,689
公投第１４案,臺南市,善化區,小新里,517,1458,256,549,805,62,867
公投第１４案,臺南市,善化區,小新里,518,1380,227,384,611,35,646
公投第１４案,臺南市,善化區,蓮潭里,519,1232,268,365,633,10,643
公投第１４案,臺南市,善化區,蓮潭里,520,1069,252,319,571,12,583
公投第１４案,臺南市,安定區,蘇林里,521,1251,212,475,687,85,772
公投第１４案,臺南市,安定區,蘇林里,522,899,136,321,457,40,497
公投第１４案,臺南市,安定區,蘇厝里,523,1106,177,361,538,71,609
公投第１４案,臺南市,安定區,蘇厝里,524,948,128,352,480,48,528
公投第１４案,臺南市,安定區,安定里,525,1442,222,427,649,50,699
公投第１４案,臺南市,安定區,安加里,526,1385,220,409,629,66,695
公投第１４案,臺南市,安定區,安加里,527,801,117,293,410,48,458
公投第１４案,臺南市,安定區,港尾里,528,736,105,212,317,27,344
公投第１４案,臺南市,安定區,港尾里,529,781,120,248,368,35,403
公投第１４案,臺南市,安定區,中榮里,530,795,139,278,417,17,434
公投第１４案,臺南市,安定區,中榮里,531,862,147,318,465,44,509
公投第１４案,臺南市,安定區,港口里,532,1487,202,502,704,33,737
公投第１４案,臺南市,安定區,港口里,533,1385,192,474,666,39,705
公投第１４案,臺南市,安定區,港南里,534,1518,226,474,700,31,731
公投第１４案,臺南市,安定區,港南里,535,1094,185,416,601,40,641
公投第１４案,臺南市,安定區,嘉同里,536,1590,234,557,791,93,884
公投第１４案,臺南市,安定區,嘉同里,537,754,107,284,391,37,428
公投第１４案,臺南市,安定區,中沙里,538,716,112,255,367,44,411
公投第１４案,臺南市,安定區,新吉里,539,1492,245,512,757,57,814
公投第１４案,臺南市,安定區,新吉里,540,943,160,324,484,37,521
公投第１４案,臺南市,安定區,海寮里,541,1157,186,419,605,29,634
公投第１４案,臺南市,安定區,海寮里,542,1384,212,478,690,79,769
公投第１４案,臺南市,安定區,文科里,543,967,154,310,464,62,526
公投第１４案,臺南市,安定區,文科里,544,611,110,202,312,20,332
公投第１４案,臺南市,新市區,新市里,545,960,132,314,446,26,472
公投第１４案,臺南市,新市區,新市里,546,1118,210,407,617,36,653
公投第１４案,臺南市,新市區,新市里,547,850,123,277,400,16,416
公投第１４案,臺南市,新市區,新和里,548,1241,197,422,619,42,661
公投第１４案,臺南市,新市區,新和里,549,1297,228,443,671,34,705
公投第１４案,臺南市,新市區,新和里,550,962,161,343,504,38,542
公投第１４案,臺南市,新市區,新和里,551,1237,215,443,658,41,699
公投第１４案,臺南市,新市區,新和里,552,1326,232,436,668,45,713
公投第１４案,臺南市,新市區,社內里,553,1211,205,424,629,48,677
公投第１４案,臺南市,新市區,社內里,554,1305,219,412,631,33,664
公投第１４案,臺南市,新市區,大洲里,555,688,104,238,342,35,377
公投第１４案,臺南市,新市區,豐華里,556,911,170,319,489,26,515
公投第１４案,臺南市,新市區,三舍里,557,1525,153,548,701,37,738
公投第１４案,臺南市,新市區,大營里,558,1091,164,285,449,5,454
公投第１４案,臺南市,新市區,大營里,559,1122,173,375,548,19,567
公投第１４案,臺南市,新市區,大營里,560,1049,150,355,505,30,535
公投第１４案,臺南市,新市區,大社里,561,1564,268,428,696,19,715
公投第１４案,臺南市,新市區,大社里,562,1515,234,534,768,45,813
公投第１４案,臺南市,新市區,大社里,563,1378,200,478,678,38,716
公投第１４案,臺南市,新市區,潭頂里,564,827,170,306,476,39,515
公投第１４案,臺南市,新市區,潭頂里,565,960,183,352,535,77,612
公投第１４案,臺南市,新市區,港墘里,566,951,127,333,460,40,500
公投第１４案,臺南市,新市區,港墘里,567,1264,205,448,653,43,696
公投第１４案,臺南市,新市區,港墘里,568,1173,208,382,590,33,623
公投第１４案,臺南市,新市區,永就里,569,684,134,232,366,25,391
公投第１４案,臺南市,新市區,永就里,570,1055,189,410,599,50,649
公投第１４案,臺南市,新市區,永就里,571,1122,227,427,654,37,691
公投第１４案,臺南市,山上區,明和里,572,855,99,215,314,48,362
公投第１４案,臺南市,山上區,明和里,573,836,84,210,294,35,329
公投第１４案,臺南市,山上區,南洲里,574,753,114,211,325,50,375
公投第１４案,臺南市,山上區,南洲里,575,788,110,222,332,39,371
公投第１４案,臺南市,山上區,山上里,576,984,164,288,452,41,493
公投第１４案,臺南市,山上區,新莊里,577,972,136,277,413,14,427
公投第１４案,臺南市,山上區,玉峯里,578,553,44,124,168,4,172
公投第１４案,臺南市,山上區,平陽里,579,378,44,107,151,5,156
公投第１４案,臺南市,山上區,豐德里,580,392,57,112,169,19,188
公投第１４案,臺南市,新化區,武安里,581,746,125,303,428,23,451
公投第１４案,臺南市,新化區,武安里,582,1102,209,404,613,40,653
公投第１４案,臺南市,新化區,武安里,583,370,59,144,203,14,217
公投第１４案,臺南市,新化區,武安里,584,947,182,327,509,58,567
公投第１４案,臺南市,新化區,東榮里,585,1154,155,398,553,58,611
公投第１４案,臺南市,新化區,東榮里,586,1082,206,342,548,59,607
公投第１４案,臺南市,新化區,東榮里,587,1075,190,378,568,43,611
公投第１４案,臺南市,新化區,東榮里,588,640,88,228,316,22,338
公投第１４案,臺南市,新化區,護國里,589,410,65,132,197,19,216
公投第１４案,臺南市,新化區,護國里,590,533,72,176,248,29,277
公投第１４案,臺南市,新化區,護國里,591,836,170,281,451,15,466
公投第１４案,臺南市,新化區,護國里,592,978,109,285,394,26,420
公投第１４案,臺南市,新化區,太平里,593,1348,253,445,698,37,735
公投第１４案,臺南市,新化區,太平里,594,1015,173,331,504,34,538
公投第１４案,臺南市,新化區,太平里,595,1228,185,368,553,33,586
公投第１４案,臺南市,新化區,太平里,596,789,145,270,415,39,454
公投第１４案,臺南市,新化區,協興里,597,1022,165,351,516,27,543
公投第１４案,臺南市,新化區,協興里,598,1021,145,350,495,24,519
公投第１４案,臺南市,新化區,協興里,599,1229,237,421,658,49,707
公投第１４案,臺南市,新化區,唪口里,600,1153,199,380,579,21,600
公投第１４案,臺南市,新化區,唪口里,601,1012,141,274,415,29,444
公投第１４案,臺南市,新化區,北勢里,602,1458,255,495,750,53,803
公投第１４案,臺南市,新化區,豐榮里,603,1645,271,590,861,55,916
公投第１４案,臺南市,新化區,豐榮里,604,1016,188,356,544,46,590
公投第１４案,臺南市,新化區,豐榮里,605,559,104,172,276,10,286
公投第１４案,臺南市,新化區,全興里,606,1222,207,445,652,29,681
公投第１４案,臺南市,新化區,全興里,607,1562,219,749,968,47,1015
公投第１４案,臺南市,新化區,崙頂里,608,994,149,303,452,22,474
公投第１４案,臺南市,新化區,崙頂里,609,1013,158,339,497,66,563
公投第１４案,臺南市,新化區,知義里,610,1197,191,427,618,54,672
公投第１４案,臺南市,新化區,知義里,611,1021,124,347,471,39,510
公投第１４案,臺南市,新化區,山脚里,612,1428,189,402,591,59,650
公投第１４案,臺南市,新化區,大坑里,613,456,58,129,187,29,216
公投第１４案,臺南市,新化區,𦰡拔里,614,1037,163,374,537,46,583
公投第１４案,臺南市,新化區,𦰡拔里,615,1097,160,402,562,52,614
公投第１４案,臺南市,新化區,羊林里,616,902,149,307,456,46,502
公投第１４案,臺南市,新化區,礁坑里,617,999,130,289,419,91,510
公投第１４案,臺南市,安南區,東和里,618,2549,510,794,1304,39,1343
公投第１４案,臺南市,安南區,󻕯南里,619,2321,368,777,1145,52,1197
公投第１４案,臺南市,安南區,󻕯南里,620,2156,370,766,1136,59,1195
公投第１４案,臺南市,安南區,州南里,621,1662,287,622,909,62,971
公投第１４案,臺南市,安南區,州南里,622,1512,236,562,798,90,888
公投第１４案,臺南市,安南區,州南里,623,1625,231,534,765,60,825
公投第１４案,臺南市,安南區,安順里,624,2143,321,623,944,55,999
公投第１４案,臺南市,安南區,安順里,625,2457,425,830,1255,72,1327
公投第１４案,臺南市,安南區,州北里,626,2148,412,698,1110,91,1201
公投第１４案,臺南市,安南區,州北里,627,2364,439,722,1161,71,1232
公投第１４案,臺南市,安南區,新順里,628,1868,297,567,864,47,911
公投第１４案,臺南市,安南區,新順里,629,1797,333,660,993,51,1044
公投第１４案,臺南市,安南區,新順里,630,2268,351,808,1159,61,1220
公投第１４案,臺南市,安南區,頂安里,631,2291,360,611,971,68,1039
公投第１４案,臺南市,安南區,頂安里,632,2255,375,733,1108,49,1157
公投第１４案,臺南市,安南區,安慶里,633,1940,308,579,887,53,940
公投第１４案,臺南市,安南區,安慶里,634,2013,371,685,1056,31,1087
公投第１４案,臺南市,安南區,安慶里,635,2024,327,649,976,69,1045
公投第１４案,臺南市,安南區,溪北里,636,1613,328,588,916,71,987
公投第１４案,臺南市,安南區,溪北里,637,1178,186,378,564,45,609
公投第１４案,臺南市,安南區,安和里,638,2143,349,717,1066,76,1142
公投第１４案,臺南市,安南區,安西里,639,1721,340,559,899,66,965
公投第１４案,臺南市,安南區,安西里,640,1773,336,613,949,58,1007
公投第１４案,臺南市,安南區,溪頂里,641,1428,260,464,724,42,766
公投第１４案,臺南市,安南區,溪頂里,642,1626,263,580,843,48,891
公投第１４案,臺南市,安南區,溪頂里,643,1358,264,432,696,39,735
公投第１４案,臺南市,安南區,安東里,644,1447,266,540,806,44,850
公投第１４案,臺南市,安南區,安東里,645,1358,227,468,695,76,771
公投第１４案,臺南市,安南區,鳳凰里,646,2116,329,682,1011,35,1046
公投第１４案,臺南市,安南區,鳳凰里,647,2321,340,733,1073,43,1116
公投第１４案,臺南市,安南區,梅花里,648,2117,322,694,1016,38,1054
公投第１４案,臺南市,安南區,梅花里,649,1927,306,599,905,54,959
公投第１４案,臺南市,安南區,理想里,650,2242,378,679,1057,88,1145
公投第１４案,臺南市,安南區,理想里,651,2334,344,733,1077,60,1137
公投第１４案,臺南市,安南區,大安里,652,1822,302,629,931,60,991
公投第１４案,臺南市,安南區,大安里,653,1813,305,640,945,70,1015
公投第１４案,臺南市,安南區,原佃里,654,2188,364,724,1088,79,1167
公投第１４案,臺南市,安南區,長安里,655,2399,377,719,1096,77,1173
公投第１４案,臺南市,安南區,長安里,656,2247,358,636,994,67,1061
公投第１４案,臺南市,安南區,公親里,657,1165,211,447,658,61,719
公投第１４案,臺南市,安南區,布袋里,658,1539,248,473,721,56,777
公投第１４案,臺南市,安南區,總頭里,659,1835,297,644,941,93,1034
公投第１４案,臺南市,安南區,南興里,660,1797,290,611,901,76,977
公投第１４案,臺南市,安南區,學東里,661,2223,333,688,1021,75,1096
公投第１４案,臺南市,安南區,公󻕯里,662,977,184,375,559,63,622
公投第１４案,臺南市,安南區,佃東里,663,1642,235,499,734,33,767
公投第１４案,臺南市,安南區,佃東里,664,1697,282,599,881,58,939
公投第１４案,臺南市,安南區,佃西里,665,1966,284,613,897,52,949
公投第１４案,臺南市,安南區,淵西里,666,1319,210,418,628,73,701
公投第１４案,臺南市,安南區,淵西里,667,1909,338,543,881,54,935
公投第１４案,臺南市,安南區,海西里,668,1763,297,593,890,58,948
公投第１４案,臺南市,安南區,海西里,669,965,160,308,468,50,518
公投第１４案,臺南市,安南區,海東里,670,1547,214,444,658,52,710
公投第１４案,臺南市,安南區,海東里,671,1784,289,560,849,54,903
公投第１４案,臺南市,安南區,海東里,672,2145,321,655,976,50,1026
公投第１４案,臺南市,安南區,溪心里,673,2443,411,842,1253,55,1308
公投第１４案,臺南市,安南區,溪心里,674,2565,320,769,1089,41,1130
公投第１４案,臺南市,安南區,溪心里,675,2480,392,827,1219,71,1290
公投第１４案,臺南市,安南區,淵東里,676,2349,337,642,979,82,1061
公投第１４案,臺南市,安南區,淵東里,677,2168,374,709,1083,78,1161
公投第１４案,臺南市,安南區,淵中里,678,1630,258,541,799,46,845
公投第１４案,臺南市,安南區,淵中里,679,1675,241,502,743,43,786
公投第１４案,臺南市,安南區,溪墘里,680,1627,281,650,931,88,1019
公投第１４案,臺南市,安南區,溪墘里,681,1493,242,509,751,67,818
公投第１４案,臺南市,安南區,海佃里,682,1397,244,476,720,67,787
公投第１４案,臺南市,安南區,海佃里,683,1416,231,463,694,50,744
公投第１４案,臺南市,安南區,海佃里,684,1460,246,499,745,30,775
公投第１４案,臺南市,安南區,國安里,685,2222,328,641,969,42,1011
公投第１４案,臺南市,安南區,溪東里,686,2070,349,685,1034,64,1098
公投第１４案,臺南市,安南區,溪東里,687,1739,300,612,912,40,952
公投第１４案,臺南市,安南區,安富里,688,1830,275,577,852,82,934
公投第１４案,臺南市,安南區,安富里,689,1803,341,645,986,70,1056
公投第１４案,臺南市,安南區,安富里,690,1800,348,610,958,57,1015
公投第１４案,臺南市,安南區,幸福里,691,1815,271,515,786,66,852
公投第１４案,臺南市,安南區,幸福里,692,1846,283,574,857,35,892
公投第１４案,臺南市,安南區,海南里,693,905,179,333,512,44,556
公投第１４案,臺南市,安南區,海南里,694,1073,210,394,604,59,663
公投第１４案,臺南市,安南區,城東里,695,1579,234,611,845,67,912
公投第１４案,臺南市,安南區,城南里,696,1876,270,604,874,99,973
公投第１４案,臺南市,安南區,城南里,697,1194,203,373,576,41,617
公投第１４案,臺南市,安南區,青草里,698,1475,170,412,582,17,599
公投第１４案,臺南市,安南區,城西里,699,1380,202,462,664,18,682
公投第１４案,臺南市,安南區,城北里,700,1462,244,449,693,31,724
公投第１４案,臺南市,安南區,城中里,701,1044,263,303,566,53,619
公投第１４案,臺南市,安南區,砂崙里,702,603,126,225,351,44,395
公投第１４案,臺南市,安南區,砂崙里,703,690,120,255,375,23,398
公投第１４案,臺南市,安南區,顯宮里,704,1447,238,439,677,46,723
公投第１４案,臺南市,安南區,鹿耳里,705,910,157,405,562,35,597
公投第１４案,臺南市,安南區,四草里,706,1850,268,561,829,66,895
公投第１４案,臺南市,安南區,塩田里,707,1501,253,578,831,50,881
公投第１４案,臺南市,永康區,五王里,708,1398,253,454,707,56,763
公投第１４案,臺南市,永康區,五王里,709,1478,227,409,636,29,665
公投第１４案,臺南市,永康區,五王里,710,1442,262,443,705,17,722
公投第１４案,臺南市,永康區,五王里,711,1353,186,452,638,29,667
公投第１４案,臺南市,永康區,三合里,712,1160,192,389,581,23,604
公投第１４案,臺南市,永康區,三合里,713,1122,196,394,590,32,622
公投第１４案,臺南市,永康區,三合里,714,1165,192,383,575,13,588
公投第１４案,臺南市,永康區,六合里,715,1317,236,390,626,32,658
公投第１４案,臺南市,永康區,六合里,716,1376,206,466,672,34,706
公投第１４案,臺南市,永康區,六合里,717,1361,252,452,704,25,729
公投第１４案,臺南市,永康區,六合里,718,1374,301,481,782,20,802
公投第１４案,臺南市,永康區,網寮里,719,1709,265,519,784,51,835
公投第１４案,臺南市,永康區,網寮里,720,1717,270,524,794,42,836
公投第１４案,臺南市,永康區,網寮里,721,1759,269,537,806,41,847
公投第１４案,臺南市,永康區,網寮里,722,1636,279,538,817,36,853
公投第１４案,臺南市,永康區,二王里,723,1442,246,462,708,47,755
公投第１４案,臺南市,永康區,二王里,724,1545,261,483,744,31,775
公投第１４案,臺南市,永康區,二王里,725,1565,214,538,752,45,797
公投第１４案,臺南市,永康區,二王里,726,1684,275,506,781,34,815
公投第１４案,臺南市,永康區,二王里,727,1548,239,498,737,22,759
公投第１４案,臺南市,永康區,永康里,728,1389,237,498,735,28,763
公投第１４案,臺南市,永康區,永康里,729,1369,254,428,682,44,726
公投第１４案,臺南市,永康區,永康里,730,1415,216,497,713,60,773
公投第１４案,臺南市,永康區,永康里,731,1386,184,434,618,14,632
公投第１４案,臺南市,永康區,永康里,732,1747,115,299,414,6,420
公投第１４案,臺南市,永康區,永康里,733,1485,253,476,729,40,769
公投第１４案,臺南市,永康區,埔園里,734,1747,291,542,833,58,891
公投第１４案,臺南市,永康區,埔園里,735,1744,264,487,751,45,796
公投第１４案,臺南市,永康區,埔園里,736,1797,257,557,814,38,852
公投第１４案,臺南市,永康區,埔園里,737,1800,306,609,915,51,966
公投第１４案,臺南市,永康區,龍埔里,738,1720,244,568,812,20,832
公投第１４案,臺南市,永康區,龍埔里,739,1708,305,580,885,34,919
公投第１４案,臺南市,永康區,正強里,740,1519,265,560,825,25,850
公投第１４案,臺南市,永康區,正強里,741,1497,224,558,782,59,841
公投第１４案,臺南市,永康區,正強里,742,1509,224,557,781,28,809
公投第１４案,臺南市,永康區,正強里,743,1542,263,585,848,61,909
公投第１４案,臺南市,永康區,正強里,744,1536,321,497,818,22,840
公投第１４案,臺南市,永康區,大橋里,745,1531,298,487,785,38,823
公投第１４案,臺南市,永康區,大橋里,746,1327,249,483,732,33,765
公投第１４案,臺南市,永康區,大橋里,747,1456,252,489,741,19,760
公投第１４案,臺南市,永康區,大橋里,748,1396,291,467,758,20,778
公投第１４案,臺南市,永康區,東橋里,749,1636,271,535,806,41,847
公投第１４案,臺南市,永康區,東橋里,750,1592,318,509,827,36,863
公投第１４案,臺南市,永康區,東橋里,751,2017,406,538,944,16,960
公投第１４案,臺南市,永康區,東橋里,752,672,117,239,356,13,369
公投第１４案,臺南市,永康區,西橋里,753,1611,259,490,749,21,770
公投第１４案,臺南市,永康區,西橋里,754,1502,291,466,757,36,793
公投第１４案,臺南市,永康區,安康里,755,1660,272,450,722,20,742
公投第１４案,臺南市,永康區,安康里,756,1561,269,395,664,27,691
公投第１４案,臺南市,永康區,安康里,757,1590,269,481,750,27,777
公投第１４案,臺南市,永康區,蔦松里,758,924,186,280,466,17,483
公投第１４案,臺南市,永康區,蔦松里,759,938,183,334,517,28,545
公投第１４案,臺南市,永康區,三民里,760,957,182,335,517,24,541
公投第１４案,臺南市,永康區,三民里,761,496,91,159,250,27,277
公投第１４案,臺南市,永康區,塩行里,762,1717,299,544,843,66,909
公投第１４案,臺南市,永康區,塩行里,763,1615,244,484,728,40,768
公投第１４案,臺南市,永康區,塩行里,764,1554,232,516,748,25,773
公投第１４案,臺南市,永康區,塩興里,765,1196,182,395,577,24,601
公投第１４案,臺南市,永康區,塩興里,766,1274,227,415,642,27,669
公投第１４案,臺南市,永康區,塩興里,767,1215,221,406,627,26,653
公投第１４案,臺南市,永康區,塩洲里,768,1457,246,497,743,18,761
公投第１４案,臺南市,永康區,塩洲里,769,1451,255,501,756,26,782
公投第１４案,臺南市,永康區,塩洲里,770,1423,230,424,654,36,690
公投第１４案,臺南市,永康區,塩洲里,771,1394,222,506,728,29,757
公投第１４案,臺南市,永康區,甲頂里,772,890,155,317,472,45,517
公投第１４案,臺南市,永康區,甲頂里,773,1018,208,374,582,33,615
公投第１４案,臺南市,永康區,甲頂里,774,368,61,135,196,19,215
公投第１４案,臺南市,永康區,尚頂里,775,1208,208,475,683,37,720
公投第１４案,臺南市,永康區,尚頂里,776,1187,210,353,563,36,599
公投第１４案,臺南市,永康區,尚頂里,777,1381,239,436,675,25,700
公投第１４案,臺南市,永康區,龍潭里,778,1405,237,457,694,39,733
公投第１４案,臺南市,永康區,龍潭里,779,1445,241,422,663,64,727
公投第１４案,臺南市,永康區,龍潭里,780,1687,301,509,810,42,852
公投第１４案,臺南市,永康區,龍潭里,781,1535,237,433,670,31,701
公投第１４案,臺南市,永康區,永明里,782,1542,256,542,798,39,837
公投第１４案,臺南市,永康區,永明里,783,1618,262,541,803,32,835
公投第１４案,臺南市,永康區,永明里,784,1338,239,481,720,22,742
公投第１４案,臺南市,永康區,王行里,785,1285,229,449,678,65,743
公投第１４案,臺南市,永康區,王行里,786,1240,200,420,620,28,648
公投第１４案,臺南市,永康區,烏竹里,787,1343,207,425,632,46,678
公投第１４案,臺南市,永康區,烏竹里,788,1327,252,480,732,34,766
公投第１４案,臺南市,永康區,西勢里,789,1565,269,515,784,33,817
公投第１４案,臺南市,永康區,西勢里,790,1476,256,497,753,69,822
公投第１４案,臺南市,永康區,西勢里,791,1476,256,478,734,39,773
公投第１４案,臺南市,永康區,西勢里,792,1463,279,526,805,38,843
公投第１４案,臺南市,永康區,新樹里,793,983,182,322,504,72,576
公投第１４案,臺南市,永康區,新樹里,794,1116,188,412,600,53,653
公投第１４案,臺南市,永康區,大灣里,795,1117,180,357,537,55,592
公投第１４案,臺南市,永康區,大灣里,796,1069,171,327,498,25,523
公投第１４案,臺南市,永康區,大灣里,797,1180,217,441,658,39,697
公投第１４案,臺南市,永康區,東灣里,798,1176,176,394,570,78,648
公投第１４案,臺南市,永康區,東灣里,799,1158,208,363,571,37,608
公投第１４案,臺南市,永康區,東灣里,800,1208,216,444,660,51,711
公投第１４案,臺南市,永康區,西灣里,801,1501,255,492,747,60,807
公投第１４案,臺南市,永康區,西灣里,802,1298,229,485,714,27,741
公投第１４案,臺南市,永康區,西灣里,803,1542,275,514,789,26,815
公投第１４案,臺南市,永康區,西灣里,804,1537,298,532,830,32,862
公投第１４案,臺南市,永康區,西灣里,805,1359,281,501,782,44,826
公投第１４案,臺南市,永康區,南灣里,806,1139,172,332,504,35,539
公投第１４案,臺南市,永康區,南灣里,807,1158,174,366,540,34,574
公投第１４案,臺南市,永康區,南灣里,808,1538,263,465,728,55,783
公投第１４案,臺南市,永康區,崑山里,809,1166,158,400,558,22,580
公投第１４案,臺南市,永康區,崑山里,810,1228,204,394,598,25,623
公投第１４案,臺南市,永康區,崑山里,811,1200,213,431,644,41,685
公投第１４案,臺南市,永康區,崑山里,812,1131,231,380,611,29,640
公投第１４案,臺南市,永康區,崑山里,813,1147,214,380,594,21,615
公投第１４案,臺南市,永康區,北灣里,814,1442,231,455,686,47,733
公投第１４案,臺南市,永康區,北灣里,815,1325,238,408,646,27,673
公投第１４案,臺南市,永康區,北灣里,816,1260,190,378,568,31,599
公投第１４案,臺南市,永康區,北興里,817,1631,238,508,746,55,801
公投第１４案,臺南市,永康區,北興里,818,1549,243,493,736,34,770
公投第１４案,臺南市,永康區,北興里,819,1666,269,538,807,26,833
公投第１４案,臺南市,永康區,復興里,820,1012,130,324,454,43,497
公投第１４案,臺南市,永康區,復興里,821,976,127,312,439,15,454
公投第１４案,臺南市,永康區,光復里,822,531,79,199,278,11,289
公投第１４案,臺南市,永康區,建國里,823,859,140,312,452,34,486
公投第１４案,臺南市,永康區,建國里,824,937,172,269,441,30,471
公投第１４案,臺南市,永康區,復國里,825,1307,207,459,666,38,704
公投第１４案,臺南市,永康區,復國里,826,1482,212,418,630,18,648
公投第１４案,臺南市,永康區,復國里,827,1341,200,409,609,22,631
公投第１４案,臺南市,永康區,復國里,828,1376,242,420,662,39,701
公投第１４案,臺南市,永康區,復國里,829,1390,217,440,657,35,692
公投第１４案,臺南市,永康區,復國里,830,1534,263,536,799,35,834
公投第１４案,臺南市,永康區,復華里,831,1460,233,539,772,34,806
公投第１４案,臺南市,永康區,復華里,832,1383,214,475,689,16,705
公投第１４案,臺南市,永康區,復華里,833,1299,229,335,564,35,599
公投第１４案,臺南市,永康區,復華里,834,1264,223,457,680,20,700
公投第１４案,臺南市,永康區,復華里,835,1355,266,474,740,32,772
公投第１４案,臺南市,永康區,復華里,836,1414,236,449,685,20,705
公投第１４案,臺南市,永康區,復華里,837,1109,206,398,604,23,627
公投第１４案,臺南市,永康區,神洲里,838,1151,160,394,554,35,589
公投第１４案,臺南市,永康區,成功里,839,1026,214,408,622,38,660
公投第１４案,臺南市,永康區,成功里,840,1071,147,382,529,24,553
公投第１４案,臺南市,永康區,中華里,841,1387,258,567,825,47,872
公投第１４案,臺南市,永康區,中華里,842,1377,279,503,782,32,814
公投第１４案,臺南市,永康區,中興里,843,1687,269,587,856,51,907
公投第１４案,臺南市,永康區,中興里,844,1700,391,411,802,36,838
公投第１４案,臺南市,永康區,勝利里,845,1444,247,527,774,25,799
公投第１４案,臺南市,永康區,勝利里,846,1485,236,490,726,35,761
公投第１４案,臺南市,永康區,勝利里,847,1717,242,544,786,37,823
公投第１４案,臺南市,永康區,勝利里,848,1701,289,472,761,40,801
公投第１４案,臺南市,永康區,勝利里,849,1382,222,470,692,15,707
公投第１４案,臺南市,北區,開元里,850,1793,276,573,849,61,910
公投第１４案,臺南市,北區,開元里,851,1708,259,532,791,45,836
公投第１４案,臺南市,北區,元寶里,852,997,203,295,498,17,515
公投第１４案,臺南市,北區,元寶里,853,1452,267,368,635,19,654
公投第１４案,臺南市,北區,元寶里,854,1351,254,408,662,22,684
公投第１４案,臺南市,北區,合興里,855,1323,262,523,785,44,829
公投第１４案,臺南市,北區,合興里,856,1073,171,424,595,20,615
公投第１４案,臺南市,北區,合興里,857,1138,208,433,641,23,664
公投第１４案,臺南市,北區,力行里,858,1189,195,419,614,20,634
公投第１４案,臺南市,北區,力行里,859,1262,256,483,739,31,770
公投第１４案,臺南市,北區,重興里,860,1017,206,385,591,19,610
公投第１４案,臺南市,北區,重興里,861,847,163,291,454,13,467
公投第１４案,臺南市,北區,東興里,862,1076,419,167,586,36,622
公投第１４案,臺南市,北區,東興里,863,954,182,362,544,25,569
公投第１４案,臺南市,北區,長勝里,864,1300,188,453,641,52,693
公投第１４案,臺南市,北區,長勝里,865,1390,195,508,703,32,735
公投第１４案,臺南市,北區,長勝里,866,1318,215,497,712,32,744
公投第１４案,臺南市,北區,振興里,867,974,160,340,500,16,516
公投第１４案,臺南市,北區,振興里,868,990,169,357,526,19,545
公投第１４案,臺南市,北區,仁愛里,869,1016,223,382,605,20,625
公投第１４案,臺南市,北區,仁愛里,870,1053,179,386,565,26,591
公投第１４案,臺南市,北區,中樓里,871,1466,252,461,713,52,765
公投第１４案,臺南市,北區,永祥里,872,1535,300,500,800,53,853
公投第１４案,臺南市,北區,永祥里,873,1544,216,547,763,52,815
公投第１４案,臺南市,北區,北門里,874,1760,292,642,934,49,983
公投第１４案,臺南市,北區,北門里,875,1372,234,446,680,24,704
公投第１４案,臺南市,北區,北門里,876,1002,184,378,562,25,587
公投第１４案,臺南市,北區,北門里,877,1171,207,441,648,32,680
公投第１４案,臺南市,北區,大光里,878,1285,194,418,612,23,635
公投第１４案,臺南市,北區,大光里,879,1036,138,373,511,34,545
公投第１４案,臺南市,北區,大光里,880,1392,222,485,707,41,748
公投第１４案,臺南市,北區,大光里,881,1147,180,425,605,35,640
公投第１４案,臺南市,北區,大興里,882,1526,202,464,666,26,692
公投第１４案,臺南市,北區,大興里,883,1559,264,531,795,34,829
公投第１４案,臺南市,北區,公園里,884,892,143,323,466,48,514
公投第１４案,臺南市,北區,公園里,885,937,170,279,449,40,489
公投第１４案,臺南市,北區,北華里,886,1449,272,504,776,59,835
公投第１４案,臺南市,北區,北華里,887,1160,213,374,587,28,615
公投第１４案,臺南市,北區,北華里,888,1567,207,351,558,37,595
公投第１４案,臺南市,北區,長興里,889,1346,234,435,669,46,715
公投第１４案,臺南市,北區,長興里,890,1451,251,429,680,15,695
公投第１４案,臺南市,北區,小北里,891,1522,270,473,743,40,783
公投第１４案,臺南市,北區,小北里,892,1278,198,441,639,24,663
公投第１４案,臺南市,北區,小北里,893,1164,177,384,561,45,606
公投第１４案,臺南市,北區,正覺里,894,1091,192,315,507,20,527
公投第１４案,臺南市,北區,正覺里,895,993,161,334,495,23,518
公投第１４案,臺南市,北區,正覺里,896,1119,176,322,498,32,530
公投第１４案,臺南市,北區,成功里,897,1685,298,571,869,60,929
公投第１４案,臺南市,北區,成功里,898,1368,257,452,709,21,730
公投第１４案,臺南市,北區,成功里,899,1389,253,463,716,39,755
公投第１４案,臺南市,北區,華德里,900,1469,294,527,821,27,848
公投第１４案,臺南市,北區,華德里,901,1655,337,571,908,43,951
公投第１４案,臺南市,北區,福德里,902,1261,247,455,702,19,721
公投第１４案,臺南市,北區,福德里,903,1490,270,493,763,17,780
公投第１４案,臺南市,北區,福德里,904,1436,301,504,805,27,832
公投第１４案,臺南市,北區,成德里,905,1340,241,502,743,51,794
公投第１４案,臺南市,北區,成德里,906,1464,282,491,773,37,810
公投第１４案,臺南市,北區,成德里,907,1513,309,535,844,28,872
公投第１４案,臺南市,北區,和順里,908,1709,366,582,948,19,967
公投第１４案,臺南市,北區,和順里,909,1517,335,539,874,35,909
公投第１４案,臺南市,北區,和順里,910,1598,315,512,827,24,851
公投第１４案,臺南市,北區,立人里,911,1399,296,401,697,41,738
公投第１４案,臺南市,北區,立人里,912,1214,210,389,599,48,647
公投第１４案,臺南市,北區,雙安里,913,1064,225,359,584,16,600
公投第１４案,臺南市,北區,雙安里,914,1148,260,412,672,33,705
公投第１４案,臺南市,北區,文成里,915,1391,252,492,744,36,780
公投第１４案,臺南市,北區,文成里,916,1584,293,559,852,40,892
公投第１４案,臺南市,北區,元美里,917,1595,288,567,855,35,890
公投第１４案,臺南市,北區,元美里,918,1397,244,468,712,29,741
公投第１４案,臺南市,北區,文元里,919,1662,321,525,846,43,889
公投第１４案,臺南市,北區,文元里,920,1634,318,483,801,39,840
公投第１４案,臺南市,北區,大和里,921,1793,320,650,970,46,1016
公投第１４案,臺南市,北區,大和里,922,1872,349,651,1000,42,1042
公投第１４案,臺南市,北區,大港里,923,1874,327,631,958,57,1015
公投第１４案,臺南市,北區,大港里,924,1760,288,569,857,56,913
公投第１４案,臺南市,北區,大港里,925,1753,285,568,853,53,906
公投第１４案,臺南市,北區,大豐里,926,1502,239,418,657,22,679
公投第１４案,臺南市,北區,大豐里,927,1470,254,501,755,39,794
公投第１４案,臺南市,北區,大豐里,928,1319,253,390,643,64,707
公投第１４案,臺南市,北區,賢北里,929,1876,331,675,1006,44,1050
公投第１４案,臺南市,北區,賢北里,930,1720,306,581,887,16,903
公投第１４案,臺南市,中西區,赤嵌里,931,1332,260,425,685,55,740
公投第１４案,臺南市,中西區,赤嵌里,932,1246,213,475,688,43,731
公投第１４案,臺南市,中西區,赤嵌里,933,1276,190,450,640,36,676
公投第１４案,臺南市,中西區,郡王里,934,1583,328,544,872,28,900
公投第１４案,臺南市,中西區,郡王里,935,1464,313,496,809,28,837
公投第１４案,臺南市,中西區,法華里,936,1234,229,408,637,12,649
公投第１４案,臺南市,中西區,法華里,937,1368,247,498,745,44,789
公投第１４案,臺南市,中西區,開山里,938,1322,213,416,629,24,653
公投第１４案,臺南市,中西區,開山里,939,1216,229,373,602,39,641
公投第１４案,臺南市,中西區,永華里,940,1289,247,418,665,30,695
公投第１４案,臺南市,中西區,永華里,941,1237,202,473,675,31,706
公投第１４案,臺南市,中西區,藥王里,942,1189,193,340,533,33,566
公投第１４案,臺南市,中西區,藥王里,943,1201,212,413,625,59,684
公投第１４案,臺南市,中西區,藥王里,944,1065,207,389,596,41,637
公投第１４案,臺南市,中西區,光賢里,945,1055,188,394,582,36,618
公投第１４案,臺南市,中西區,光賢里,946,1170,267,420,687,31,718
公投第１４案,臺南市,中西區,光賢里,947,1280,241,530,771,25,796
公投第１４案,臺南市,中西區,大涼里,948,1223,241,425,666,29,695
公投第１４案,臺南市,中西區,大涼里,949,1292,214,483,697,46,743
公投第１４案,臺南市,中西區,西湖里,950,993,217,349,566,16,582
公投第１４案,臺南市,中西區,西湖里,951,1541,295,516,811,35,846
公投第１４案,臺南市,中西區,西湖里,952,1652,344,585,929,58,987
公投第１４案,臺南市,中西區,西湖里,953,1212,232,435,667,23,690
公投第１４案,臺南市,中西區,西賢里,954,1621,314,564,878,43,921
公投第１４案,臺南市,中西區,西賢里,955,1660,340,561,901,35,936
公投第１４案,臺南市,中西區,西賢里,956,1595,274,547,821,45,866
公投第１４案,臺南市,中西區,城隍里,957,1436,246,481,727,42,769
公投第１４案,臺南市,中西區,城隍里,958,1265,224,456,680,46,726
公投第１４案,臺南市,中西區,城隍里,959,856,164,334,498,28,526
公投第１４案,臺南市,中西區,南美里,960,1168,205,390,595,34,629
公投第１４案,臺南市,中西區,南美里,961,1134,227,402,629,40,669
公投第１４案,臺南市,中西區,南美里,962,995,212,376,588,36,624
公投第１４案,臺南市,中西區,南門里,963,1313,234,556,790,25,815
公投第１４案,臺南市,中西區,南門里,964,1265,253,470,723,37,760
公投第１４案,臺南市,中西區,小西門里,965,1215,216,397,613,37,650
公投第１４案,臺南市,中西區,小西門里,966,1248,208,439,647,41,688
公投第１４案,臺南市,中西區,小西門里,967,687,137,215,352,29,381
公投第１４案,臺南市,中西區,五條港里,968,1139,210,375,585,54,639
公投第１４案,臺南市,中西區,五條港里,969,971,183,342,525,42,567
公投第１４案,臺南市,中西區,兌悅里,970,1254,165,339,504,46,550
公投第１４案,臺南市,中西區,兌悅里,971,979,172,357,529,38,567
公投第１４案,臺南市,中西區,兌悅里,972,1745,294,559,853,47,900
公投第１４案,臺南市,中西區,淺草里,973,1074,179,374,553,34,587
公投第１４案,臺南市,中西區,淺草里,974,1436,231,467,698,29,727
公投第１４案,臺南市,中西區,府前里,975,865,171,296,467,37,504
公投第１４案,臺南市,中西區,府前里,976,1164,377,216,593,47,640
公投第１４案,臺南市,中西區,南廠里,977,1285,241,366,607,28,635
公投第１４案,臺南市,中西區,南廠里,978,1078,169,386,555,39,594
公投第１４案,臺南市,中西區,南廠里,979,1704,238,497,735,42,777
公投第１４案,臺南市,中西區,西和里,980,1296,233,471,704,53,757
公投第１４案,臺南市,中西區,西和里,981,1128,194,399,593,36,629
公投第１４案,臺南市,中西區,西和里,982,1245,230,430,660,29,689
公投第１４案,臺南市,安平區,文平里,983,1753,307,613,920,42,962
公投第１４案,臺南市,安平區,文平里,984,1859,335,587,922,42,964
公投第１４案,臺南市,安平區,文平里,985,1382,249,543,792,28,820
公投第１４案,臺南市,安平區,建平里,986,2547,399,831,1230,49,1279
公投第１４案,臺南市,安平區,建平里,987,2407,431,780,1211,44,1255
公投第１４案,臺南市,安平區,怡平里,988,2070,347,586,933,38,971
公投第１４案,臺南市,安平區,怡平里,989,2132,349,749,1098,28,1126
公投第１４案,臺南市,安平區,華平里,990,1450,274,512,786,14,800
公投第１４案,臺南市,安平區,華平里,991,1605,294,493,787,21,808
公投第１４案,臺南市,安平區,華平里,992,1755,308,596,904,43,947
公投第１４案,臺南市,安平區,平通里,993,1728,279,504,783,33,816
公投第１４案,臺南市,安平區,平通里,994,1754,258,458,716,32,748
公投第１４案,臺南市,安平區,平通里,995,1686,319,499,818,54,872
公投第１４案,臺南市,安平區,平通里,996,1843,310,653,963,35,998
公投第１４案,臺南市,安平區,億載里,997,1565,288,562,850,35,885
公投第１４案,臺南市,安平區,億載里,998,1288,236,444,680,21,701
公投第１４案,臺南市,安平區,育平里,999,1653,309,482,791,17,808
公投第１４案,臺南市,安平區,育平里,1000,1697,284,527,811,19,830
公投第１４案,臺南市,安平區,育平里,1001,2154,342,638,980,37,1017
公投第１４案,臺南市,安平區,育平里,1002,2107,343,657,1000,30,1030
公投第１４案,臺南市,安平區,國平里,1003,1675,321,568,889,41,930
公投第１４案,臺南市,安平區,國平里,1004,1979,389,592,981,46,1027
公投第１４案,臺南市,安平區,國平里,1005,1602,278,490,768,31,799
公投第１４案,臺南市,安平區,國平里,1006,1586,281,485,766,37,803
公投第１４案,臺南市,安平區,漁光里,1007,438,59,132,191,6,197
公投第１４案,臺南市,安平區,平安里,1008,1780,336,516,852,47,899
公投第１４案,臺南市,安平區,平安里,1009,1623,287,483,770,32,802
公投第１４案,臺南市,安平區,天妃里,1010,2157,325,666,991,75,1066
公投第１４案,臺南市,安平區,天妃里,1011,1286,203,421,624,39,663
公投第１４案,臺南市,安平區,王城里,1012,1492,226,509,735,53,788
公投第１４案,臺南市,安平區,王城里,1013,1325,172,425,597,31,628
公投第１４案,臺南市,安平區,金城里,1014,2001,284,625,909,83,992
公投第１４案,臺南市,南區,大恩里,1015,1221,221,439,660,43,703
公投第１４案,臺南市,南區,大恩里,1016,2171,304,648,952,61,1013
公投第１４案,臺南市,南區,大林里,1017,1150,200,427,627,32,659
公投第１４案,臺南市,南區,大林里,1018,1122,197,419,616,32,648
公投第１４案,臺南市,南區,大忠里,1019,1444,198,479,677,38,715
公投第１４案,臺南市,南區,大忠里,1020,1765,299,537,836,24,860
公投第１４案,臺南市,南區,大忠里,1021,1298,230,481,711,43,754
公投第１４案,臺南市,南區,新生里,1022,1458,206,553,759,43,802
公投第１４案,臺南市,南區,新生里,1023,1940,300,639,939,29,968
公投第１４案,臺南市,南區,竹溪里,1024,1637,265,555,820,50,870
公投第１４案,臺南市,南區,明德里,1025,871,147,239,386,10,396
公投第１４案,臺南市,南區,大成里,1026,589,128,191,319,22,341
公投第１４案,臺南市,南區,大成里,1027,801,168,319,487,42,529
公投第１４案,臺南市,南區,田寮里,1028,990,146,375,521,47,568
公投第１４案,臺南市,南區,田寮里,1029,1222,200,507,707,35,742
公投第１４案,臺南市,南區,田寮里,1030,997,187,354,541,58,599
公投第１４案,臺南市,南區,新興里,1031,1204,200,389,589,26,615
公投第１４案,臺南市,南區,新興里,1032,1570,265,451,716,31,747
公投第１４案,臺南市,南區,再興里,1033,1222,235,400,635,43,678
公投第１４案,臺南市,南區,再興里,1034,1076,181,338,519,16,535
公投第１４案,臺南市,南區,廣州里,1035,1127,212,389,601,21,622
公投第１４案,臺南市,南區,廣州里,1036,1135,214,385,599,40,639
公投第１４案,臺南市,南區,新昌里,1037,1263,207,412,619,51,670
公投第１４案,臺南市,南區,新昌里,1038,1014,170,326,496,23,519
公投第１４案,臺南市,南區,文華里,1039,1491,246,544,790,48,838
公投第１４案,臺南市,南區,文華里,1040,1815,324,600,924,47,971
公投第１４案,臺南市,南區,文南里,1041,1398,254,454,708,19,727
公投第１４案,臺南市,南區,文南里,1042,2107,285,602,887,31,918
公投第１４案,臺南市,南區,文南里,1043,1587,299,605,904,44,948
公投第１４案,臺南市,南區,金華里,1044,1626,269,555,824,53,877
公投第１４案,臺南市,南區,金華里,1045,1761,282,549,831,38,869
公投第１４案,臺南市,南區,金華里,1046,1630,301,515,816,53,869
公投第１４案,臺南市,南區,國宅里,1047,1542,255,532,787,46,833
公投第１４案,臺南市,南區,國宅里,1048,1464,268,436,704,75,779
公投第１４案,臺南市,南區,鹽埕里,1049,1727,249,578,827,84,911
公投第１４案,臺南市,南區,鹽埕里,1050,1085,213,391,604,52,656
公投第１４案,臺南市,南區,鹽埕里,1051,939,147,321,468,22,490
公投第１４案,臺南市,南區,光明里,1052,1419,193,427,620,62,682
公投第１４案,臺南市,南區,光明里,1053,1333,218,414,632,38,670
公投第１４案,臺南市,南區,光明里,1054,1465,249,445,694,44,738
公投第１４案,臺南市,南區,明亮里,1055,1099,196,371,567,26,593
公投第１４案,臺南市,南區,明亮里,1056,1133,166,373,539,22,561
公投第１４案,臺南市,南區,明亮里,1057,1375,192,450,642,73,715
公投第１４案,臺南市,南區,府南里,1058,1781,282,510,792,28,820
公投第１４案,臺南市,南區,府南里,1059,1542,264,571,835,41,876
公投第１４案,臺南市,南區,府南里,1060,1486,219,474,693,35,728
公投第１４案,臺南市,南區,明興里,1061,1640,264,589,853,62,915
公投第１４案,臺南市,南區,明興里,1062,1701,241,492,733,39,772
公投第１４案,臺南市,南區,郡南里,1063,1541,215,484,699,58,757
公投第１４案,臺南市,南區,郡南里,1064,2027,308,627,935,89,1024
公投第１４案,臺南市,南區,建南里,1065,1774,326,650,976,62,1038
公投第１４案,臺南市,南區,建南里,1066,1613,253,531,784,52,836
公投第１４案,臺南市,南區,建南里,1067,1707,252,568,820,22,842
公投第１４案,臺南市,南區,南都里,1068,1657,180,388,568,22,590
公投第１４案,臺南市,南區,南都里,1069,1077,174,377,551,33,584
公投第１４案,臺南市,南區,南華里,1070,1185,203,394,597,36,633
公投第１４案,臺南市,南區,南華里,1071,1249,226,391,617,41,658
公投第１４案,臺南市,南區,開南里,1072,1985,268,592,860,32,892
公投第１４案,臺南市,南區,開南里,1073,2017,310,560,870,48,918
公投第１４案,臺南市,南區,開南里,1074,1717,269,504,773,79,852
公投第１４案,臺南市,南區,彰南里,1075,929,168,328,496,28,524
公投第１４案,臺南市,南區,彰南里,1076,695,135,233,368,26,394
公投第１４案,臺南市,南區,鯤鯓里,1077,997,124,329,453,23,476
公投第１４案,臺南市,南區,鯤鯓里,1078,784,114,257,371,15,386
公投第１４案,臺南市,南區,喜北里,1079,1119,142,450,592,61,653
公投第１４案,臺南市,南區,喜北里,1080,1054,155,301,456,23,479
公投第１４案,臺南市,南區,喜南里,1081,1245,194,379,573,72,645
公投第１４案,臺南市,南區,喜東里,1082,2064,284,638,922,46,968
公投第１４案,臺南市,南區,省躬里,1083,2056,279,532,811,27,838
公投第１４案,臺南市,南區,省躬里,1084,1373,194,422,616,26,642
公投第１４案,臺南市,南區,永寧里,1085,1002,139,294,433,32,465
公投第１４案,臺南市,南區,永寧里,1086,760,142,245,387,56,443
公投第１４案,臺南市,南區,松安里,1087,1031,191,324,515,54,569
公投第１４案,臺南市,南區,松安里,1088,744,137,234,371,43,414
公投第１４案,臺南市,南區,佛壇里,1089,1186,219,369,588,59,647
公投第１４案,臺南市,南區,佛壇里,1090,1358,243,447,690,54,744
公投第１４案,臺南市,南區,同安里,1091,897,120,280,400,29,429
公投第１４案,臺南市,南區,同安里,1092,1265,206,418,624,40,664
公投第１４案,臺南市,南區,興農里,1093,1093,159,330,489,34,523
公投第１４案,臺南市,南區,興農里,1094,1016,206,334,540,32,572
公投第１４案,臺南市,東區,崇信里,1095,2681,325,705,1030,40,1070
公投第１４案,臺南市,東區,崇信里,1096,1811,338,581,919,38,957
公投第１４案,臺南市,東區,崇學里,1097,1491,296,583,879,59,938
公投第１４案,臺南市,東區,崇學里,1098,1378,256,467,723,32,755
公投第１４案,臺南市,東區,崇德里,1099,1552,323,530,853,42,895
公投第１４案,臺南市,東區,崇德里,1100,1326,248,511,759,14,773
公投第１４案,臺南市,東區,崇德里,1101,1594,305,552,857,44,901
公投第１４案,臺南市,東區,崇善里,1102,1639,327,585,912,36,948
公投第１４案,臺南市,東區,崇善里,1103,1724,328,570,898,45,943
公投第１４案,臺南市,東區,崇善里,1104,1629,275,576,851,57,908
公投第１４案,臺南市,東區,崇成里,1105,1399,292,471,763,23,786
公投第１４案,臺南市,東區,崇成里,1106,1534,293,527,820,32,852
公投第１４案,臺南市,東區,崇文里,1107,1656,380,529,909,27,936
公投第１４案,臺南市,東區,崇文里,1108,1322,222,471,693,38,731
公投第１４案,臺南市,東區,崇文里,1109,1620,310,551,861,27,888
公投第１４案,臺南市,東區,崇文里,1110,1331,266,521,787,28,815
公投第１４案,臺南市,東區,東智里,1111,1039,162,402,564,35,599
公投第１４案,臺南市,東區,東智里,1112,1257,194,420,614,27,641
公投第１４案,臺南市,東區,大智里,1113,2067,326,667,993,70,1063
公投第１４案,臺南市,東區,大智里,1114,2153,333,805,1138,26,1164
公投第１４案,臺南市,東區,大智里,1115,2363,399,803,1202,44,1246
公投第１４案,臺南市,東區,德高里,1116,1427,222,517,739,44,783
公投第１４案,臺南市,東區,德高里,1117,1555,288,574,862,38,900
公投第１４案,臺南市,東區,仁和里,1118,2115,306,622,928,41,969
公投第１４案,臺南市,東區,仁和里,1119,2340,400,709,1109,53,1162
公投第１４案,臺南市,東區,和平里,1120,2474,449,930,1379,36,1415
公投第１４案,臺南市,東區,和平里,1121,2391,377,812,1189,51,1240
公投第１４案,臺南市,東區,虎尾里,1122,1673,331,574,905,26,931
公投第１４案,臺南市,東區,虎尾里,1123,1594,287,538,825,38,863
公投第１４案,臺南市,東區,虎尾里,1124,1607,289,581,870,50,920
公投第１４案,臺南市,東區,裕聖里,1125,2087,431,753,1184,25,1209
公投第１４案,臺南市,東區,裕聖里,1126,2369,449,861,1310,29,1339
公投第１４案,臺南市,東區,復興里,1127,1696,275,572,847,65,912
公投第１４案,臺南市,東區,復興里,1128,1612,295,568,863,34,897
公投第１４案,臺南市,東區,自強里,1129,1708,302,556,858,36,894
公投第１４案,臺南市,東區,自強里,1130,1560,284,544,828,32,860
公投第１４案,臺南市,東區,自強里,1131,1854,350,601,951,50,1001
公投第１４案,臺南市,東區,東聖里,1132,2278,396,699,1095,36,1131
公投第１４案,臺南市,東區,關聖里,1133,2093,376,685,1061,32,1093
公投第１４案,臺南市,東區,關聖里,1134,2242,431,809,1240,36,1276
公投第１４案,臺南市,東區,南聖里,1135,1152,234,427,661,35,696
公投第１４案,臺南市,東區,南聖里,1136,1318,269,504,773,21,794
公投第１４案,臺南市,東區,文聖里,1137,2200,432,760,1192,41,1233
公投第１４案,臺南市,東區,文聖里,1138,1960,405,708,1113,31,1144
公投第１４案,臺南市,東區,後甲里,1139,1489,277,494,771,41,812
公投第１４案,臺南市,東區,後甲里,1140,1443,282,463,745,50,795
公投第１４案,臺南市,東區,東光里,1141,1498,343,536,879,32,911
公投第１４案,臺南市,東區,東光里,1142,1622,306,585,891,19,910
公投第１４案,臺南市,東區,東光里,1143,1738,341,603,944,25,969
公投第１４案,臺南市,東區,東明里,1144,1501,284,468,752,42,794
公投第１４案,臺南市,東區,東明里,1145,1482,248,554,802,36,838
公投第１４案,臺南市,東區,莊敬里,1146,1829,297,568,865,37,902
公投第１４案,臺南市,東區,莊敬里,1147,1764,365,554,919,42,961
公投第１４案,臺南市,東區,小東里,1148,1427,251,553,804,29,833
公投第１４案,臺南市,東區,小東里,1149,1427,261,464,725,47,772
公投第１４案,臺南市,東區,小東里,1150,1388,258,485,743,39,782
公投第１４案,臺南市,東區,大學里,1151,1131,271,402,673,22,695
公投第１４案,臺南市,東區,成大里,1152,1000,176,344,520,27,547
公投第１４案,臺南市,東區,成大里,1153,996,161,373,534,20,554
公投第１４案,臺南市,東區,東門里,1154,935,148,329,477,25,502
公投第１４案,臺南市,東區,東門里,1155,947,186,320,506,40,546
公投第１４案,臺南市,東區,圍下里,1156,1090,225,355,580,15,595
公投第１４案,臺南市,東區,圍下里,1157,896,157,287,444,38,482
公投第１４案,臺南市,東區,中西里,1158,1589,298,533,831,25,856
公投第１４案,臺南市,東區,中西里,1159,1497,302,514,816,36,852
公投第１４案,臺南市,東區,東安里,1160,1386,232,458,690,40,730
公投第１４案,臺南市,東區,新東里,1161,1101,190,412,602,15,617
公投第１４案,臺南市,東區,新東里,1162,1332,258,461,719,54,773
公投第１４案,臺南市,東區,崇誨里,1163,1185,218,425,643,31,674
公投第１４案,臺南市,東區,崇誨里,1164,1262,221,485,706,41,747
公投第１４案,臺南市,東區,衛國里,1165,1517,217,510,727,47,774
公投第１４案,臺南市,東區,裕農里,1166,1287,222,429,651,64,715
公投第１４案,臺南市,東區,裕農里,1167,1657,318,558,876,47,923
公投第１４案,臺南市,東區,富強里,1168,2238,395,759,1154,62,1216
公投第１４案,臺南市,東區,富強里,1169,2246,413,723,1136,43,1179
公投第１４案,臺南市,東區,富裕里,1170,2191,387,731,1118,41,1159
公投第１４案,臺南市,東區,忠孝里,1171,2063,368,684,1052,42,1094
公投第１４案,臺南市,東區,忠孝里,1172,2177,403,789,1192,68,1260
公投第１４案,臺南市,東區,崇明里,1173,1863,334,712,1046,42,1088
公投第１４案,臺南市,東區,崇明里,1174,2185,292,883,1175,39,1214
公投第１４案,臺南市,東區,大福里,1175,1721,260,537,797,35,832
公投第１４案,臺南市,東區,大德里,1176,1556,266,521,787,77,864
公投第１４案,臺南市,東區,路東里,1177,1602,312,570,882,38,920
公投第１４案,臺南市,東區,大同里,1178,1523,250,508,758,50,808
公投第１４案,臺南市,東區,大同里,1179,1382,242,433,675,33,708
公投第１４案,臺南市,東區,泉南里,1180,1486,266,507,773,30,803
公投第１４案,臺南市,東區,泉南里,1181,1560,298,538,836,43,879
公投第１４案,臺南市,東區,泉南里,1182,1684,293,493,786,55,841
公投第１４案,臺南市,東區,龍山里,1183,1653,331,549,880,37,917
公投第１４案,臺南市,東區,龍山里,1184,1554,342,504,846,12,858
公投第１４案,臺南市,東區,龍山里,1185,1408,298,485,783,19,802
公投第１４案,臺南市,東區,德光里,1186,2084,367,793,1160,33,1193
公投第１４案,臺南市,東區,德光里,1187,1896,395,604,999,32,1031
公投第１４案,臺南市,仁德區,太子里,1188,1318,226,454,680,51,731
公投第１４案,臺南市,仁德區,太子里,1189,1406,230,492,722,47,769
公投第１４案,臺南市,仁德區,太子里,1190,1465,215,498,713,53,766
公投第１４案,臺南市,仁德區,太子里,1191,1192,237,436,673,47,720
公投第１４案,臺南市,仁德區,土庫里,1192,1429,239,530,769,54,823
公投第１４案,臺南市,仁德區,土庫里,1193,1320,234,411,645,78,723
公投第１４案,臺南市,仁德區,一甲里,1194,1373,234,536,770,63,833
公投第１４案,臺南市,仁德區,一甲里,1195,1330,203,526,729,40,769
公投第１４案,臺南市,仁德區,仁德里,1196,1687,339,577,916,31,947
公投第１４案,臺南市,仁德區,仁德里,1197,1491,247,453,700,56,756
公投第１４案,臺南市,仁德區,仁德里,1198,1151,149,370,519,25,544
公投第１４案,臺南市,仁德區,仁德里,1199,1407,211,499,710,18,728
公投第１４案,臺南市,仁德區,仁德里,1200,1465,239,548,787,44,831
公投第１４案,臺南市,仁德區,仁義里,1201,1335,239,493,732,26,758
公投第１４案,臺南市,仁德區,仁義里,1202,1490,240,501,741,47,788
公投第１４案,臺南市,仁德區,仁義里,1203,1453,263,548,811,42,853
公投第１４案,臺南市,仁德區,仁義里,1204,990,158,329,487,19,506
公投第１４案,臺南市,仁德區,仁義里,1205,1573,243,600,843,45,888
公投第１４案,臺南市,仁德區,仁義里,1206,1031,150,372,522,47,569
公投第１４案,臺南市,仁德區,仁義里,1207,1194,189,427,616,29,645
公投第１４案,臺南市,仁德區,新田里,1208,1268,206,410,616,37,653
公投第１４案,臺南市,仁德區,新田里,1209,929,178,318,496,31,527
公投第１４案,臺南市,仁德區,新田里,1210,1145,175,358,533,11,544
公投第１４案,臺南市,仁德區,後壁里,1211,1413,241,462,703,38,741
公投第１４案,臺南市,仁德區,後壁里,1212,1465,229,479,708,79,787
公投第１４案,臺南市,仁德區,後壁里,1213,1390,251,503,754,41,795
公投第１４案,臺南市,仁德區,後壁里,1214,1396,233,470,703,63,766
公投第１４案,臺南市,仁德區,後壁里,1215,1906,343,610,953,45,998
公投第１４案,臺南市,仁德區,後壁里,1216,1546,227,521,748,25,773
公投第１４案,臺南市,仁德區,上崙里,1217,1546,228,441,669,26,695
公投第１４案,臺南市,仁德區,上崙里,1218,1399,228,480,708,41,749
公投第１４案,臺南市,仁德區,上崙里,1219,1748,303,547,850,79,929
公投第１４案,臺南市,仁德區,上崙里,1220,1140,192,422,614,22,636
公投第１４案,臺南市,仁德區,文賢里,1221,1277,203,436,639,25,664
公投第１４案,臺南市,仁德區,文賢里,1222,1019,188,423,611,36,647
公投第１４案,臺南市,仁德區,保安里,1223,1414,210,465,675,31,706
公投第１４案,臺南市,仁德區,保安里,1224,1349,198,416,614,18,632
公投第１４案,臺南市,仁德區,成功里,1225,1471,232,487,719,18,737
公投第１４案,臺南市,仁德區,成功里,1226,1324,221,453,674,22,696
公投第１４案,臺南市,仁德區,成功里,1227,1310,158,431,589,49,638
公投第１４案,臺南市,仁德區,成功里,1228,554,106,182,288,23,311
公投第１４案,臺南市,仁德區,仁和里,1229,1395,171,549,720,30,750
公投第１４案,臺南市,仁德區,仁愛里,1230,1264,187,440,627,17,644
公投第１４案,臺南市,仁德區,二行里,1231,1180,184,394,578,62,640
公投第１４案,臺南市,仁德區,二行里,1232,928,135,287,422,26,448
公投第１４案,臺南市,仁德區,大甲里,1233,965,152,290,442,15,457
公投第１４案,臺南市,仁德區,大甲里,1234,1119,181,355,536,29,565
公投第１４案,臺南市,仁德區,中洲里,1235,1206,175,432,607,50,657
公投第１４案,臺南市,仁德區,中洲里,1236,1466,222,469,691,35,726
公投第１４案,臺南市,歸仁區,南保里,1237,1560,235,523,758,51,809
公投第１４案,臺南市,歸仁區,南保里,1238,1383,253,537,790,47,837
公投第１４案,臺南市,歸仁區,南保里,1239,1491,257,502,759,32,791
公投第１４案,臺南市,歸仁區,南保里,1240,1482,234,475,709,45,754
公投第１４案,臺南市,歸仁區,南興里,1241,1330,230,464,694,23,717
公投第１４案,臺南市,歸仁區,南興里,1242,1399,268,479,747,41,788
公投第１４案,臺南市,歸仁區,南興里,1243,1416,245,433,678,35,713
公投第１４案,臺南市,歸仁區,六甲里,1244,1336,186,364,550,34,584
公投第１４案,臺南市,歸仁區,六甲里,1245,1183,176,361,537,52,589
公投第１４案,臺南市,歸仁區,六甲里,1246,1237,205,376,581,25,606
公投第１４案,臺南市,歸仁區,歸南里,1247,1133,206,385,591,45,636
公投第１４案,臺南市,歸仁區,歸南里,1248,1149,197,364,561,34,595
公投第１４案,臺南市,歸仁區,後市里,1249,1105,177,378,555,9,564
公投第１４案,臺南市,歸仁區,後市里,1250,1099,199,365,564,38,602
公投第１４案,臺南市,歸仁區,後市里,1251,1082,175,395,570,64,634
公投第１４案,臺南市,歸仁區,文化里,1252,1519,557,247,804,41,845
公投第１４案,臺南市,歸仁區,文化里,1253,1467,267,535,802,39,841
公投第１４案,臺南市,歸仁區,辜厝里,1254,1090,185,352,537,37,574
公投第１４案,臺南市,歸仁區,辜厝里,1255,1131,186,376,562,24,586
公投第１４案,臺南市,歸仁區,辜厝里,1256,1080,169,360,529,27,556
公投第１４案,臺南市,歸仁區,新厝里,1257,1121,158,336,494,24,518
公投第１４案,臺南市,歸仁區,新厝里,1258,1336,226,445,671,54,725
公投第１４案,臺南市,歸仁區,許厝里,1259,1128,189,376,565,52,617
公投第１４案,臺南市,歸仁區,許厝里,1260,1055,168,371,539,18,557
公投第１４案,臺南市,歸仁區,許厝里,1261,1102,174,383,557,32,589
公投第１４案,臺南市,歸仁區,看西里,1262,1068,185,373,558,33,591
公投第１４案,臺南市,歸仁區,看西里,1263,1033,185,365,550,43,593
公投第１４案,臺南市,歸仁區,看東里,1264,1772,240,476,716,19,735
公投第１４案,臺南市,歸仁區,崙頂里,1265,1399,235,475,710,62,772
公投第１４案,臺南市,歸仁區,崙頂里,1266,1544,282,526,808,21,829
公投第１４案,臺南市,歸仁區,沙崙里,1267,684,89,210,299,10,309
公投第１４案,臺南市,歸仁區,大潭里,1268,839,164,312,476,28,504
公投第１４案,臺南市,歸仁區,大潭里,1269,1014,215,333,548,48,596
公投第１４案,臺南市,歸仁區,武東里,1270,1906,241,450,691,22,713
公投第１４案,臺南市,歸仁區,歸仁里,1271,1245,213,468,681,34,715
公投第１４案,臺南市,歸仁區,歸仁里,1272,1048,170,360,530,27,557
公投第１４案,臺南市,歸仁區,八甲里,1273,1175,185,409,594,18,612
公投第１４案,臺南市,歸仁區,八甲里,1274,1411,228,436,664,26,690
公投第１４案,臺南市,歸仁區,七甲里,1275,1514,288,530,818,38,856
公投第１４案,臺南市,歸仁區,七甲里,1276,1678,306,541,847,57,904
公投第１４案,臺南市,歸仁區,媽廟里,1277,949,166,329,495,27,522
公投第１４案,臺南市,歸仁區,媽廟里,1278,1009,173,386,559,44,603
公投第１４案,臺南市,歸仁區,西埔里,1279,984,217,385,602,3,605
公投第１４案,臺南市,歸仁區,西埔里,1280,756,126,300,426,26,452
公投第１４案,臺南市,歸仁區,大廟里,1281,1478,277,560,837,43,880
公投第１４案,臺南市,歸仁區,大廟里,1282,1467,278,541,819,51,870
公投第１４案,臺南市,關廟區,關廟里,1283,982,172,327,499,23,522
公投第１４案,臺南市,關廟區,關廟里,1284,1156,216,439,655,34,689
公投第１４案,臺南市,關廟區,山西里,1285,1006,130,341,471,22,493
公投第１４案,臺南市,關廟區,山西里,1286,1043,203,385,588,45,633
公投第１４案,臺南市,關廟區,香洋里,1287,1012,179,339,518,69,587
公投第１４案,臺南市,關廟區,香洋里,1288,1013,101,351,452,15,467
公投第１４案,臺南市,關廟區,香洋里,1289,1294,194,423,617,27,644
公投第１４案,臺南市,關廟區,北勢里,1290,1264,195,390,585,48,633
公投第１４案,臺南市,關廟區,北勢里,1291,1166,185,407,592,31,623
公投第１４案,臺南市,關廟區,新埔里,1292,1018,173,315,488,17,505
公投第１４案,臺南市,關廟區,新光里,1293,733,92,215,307,36,343
公投第１４案,臺南市,關廟區,五甲里,1294,1093,160,456,616,27,643
公投第１４案,臺南市,關廟區,五甲里,1295,1081,169,400,569,37,606
公投第１４案,臺南市,關廟區,五甲里,1296,978,162,372,534,41,575
公投第１４案,臺南市,關廟區,東勢里,1297,1116,169,336,505,25,530
公投第１４案,臺南市,關廟區,東勢里,1298,972,123,361,484,37,521
公投第１４案,臺南市,關廟區,東勢里,1299,1045,175,366,541,64,605
公投第１４案,臺南市,關廟區,松腳里,1300,872,165,281,446,25,471
公投第１４案,臺南市,關廟區,松腳里,1301,1007,174,375,549,40,589
公投第１４案,臺南市,關廟區,花園里,1302,763,133,290,423,34,457
公投第１４案,臺南市,關廟區,花園里,1303,630,94,211,305,29,334
公投第１４案,臺南市,關廟區,花園里,1304,959,151,344,495,60,555
公投第１４案,臺南市,關廟區,花園里,1305,1123,164,397,561,27,588
公投第１４案,臺南市,關廟區,深坑里,1306,804,126,272,398,62,460
公投第１４案,臺南市,關廟區,深坑里,1307,720,117,233,350,12,362
公投第１４案,臺南市,關廟區,布袋里,1308,843,107,260,367,22,389
公投第１４案,臺南市,關廟區,布袋里,1309,358,43,120,163,12,175
公投第１４案,臺南市,關廟區,南雄里,1310,797,106,271,377,51,428
公投第１４案,臺南市,關廟區,南雄里,1311,709,76,223,299,18,317
公投第１４案,臺南市,關廟區,埤頭里,1312,904,127,270,397,17,414
公投第１４案,臺南市,關廟區,埤頭里,1313,963,140,344,484,21,505
公投第１４案,臺南市,關廟區,下湖里,1314,489,95,170,265,11,276
公投第１４案,臺南市,龍崎區,崎頂里,1315,1047,158,321,479,56,535
公投第１４案,臺南市,龍崎區,土崎里,1316,630,74,217,291,16,307
公投第１４案,臺南市,龍崎區,中坑里,1317,141,16,37,53,4,57
公投第１４案,臺南市,龍崎區,楠坑里,1318,367,47,120,167,13,180
公投第１４案,臺南市,龍崎區,牛埔里,1319,337,52,115,167,16,183
公投第１４案,臺南市,龍崎區,大坪里,1320,318,41,96,137,6,143
公投第１４案,臺南市,龍崎區,龍船里,1321,427,45,150,195,19,214
公投第１４案,臺南市,龍崎區,石𥕢里,1322,446,50,124,174,21,195
公投第１４案,桃園市,桃園區,大林里,1,1593,240,526,766,41,807
公投第１４案,桃園市,桃園區,大林里,2,1934,283,543,826,26,852
公投第１４案,桃園市,桃園區,大林里,3,1661,284,580,864,49,913
公投第１４案,桃園市,桃園區,大林里,4,1448,215,440,655,19,674
公投第１４案,桃園市,桃園區,大樹里,5,1974,310,599,909,41,950
公投第１４案,桃園市,桃園區,大樹里,6,1882,259,554,813,51,864
公投第１４案,桃園市,桃園區,大豐里,7,1800,323,527,850,32,882
公投第１４案,桃園市,桃園區,大豐里,8,1598,301,530,831,41,872
公投第１４案,桃園市,桃園區,大豐里,9,1626,248,463,711,59,770
公投第１４案,桃園市,桃園區,建國里,10,1590,264,487,751,42,793
公投第１４案,桃園市,桃園區,建國里,11,1637,282,512,794,39,833
公投第１４案,桃園市,桃園區,建國里,12,1943,316,579,895,52,947
公投第１４案,桃園市,桃園區,雲林里,13,1482,266,470,736,40,776
公投第１４案,桃園市,桃園區,雲林里,14,1423,249,490,739,43,782
公投第１４案,桃園市,桃園區,雲林里,15,1509,307,488,795,35,830
公投第１４案,桃園市,桃園區,雲林里,16,1567,266,555,821,28,849
公投第１４案,桃園市,桃園區,福安里,17,1305,238,442,680,38,718
公投第１４案,桃園市,桃園區,福安里,18,1416,224,435,659,29,688
公投第１４案,桃園市,桃園區,福安里,19,1439,287,492,779,30,809
公投第１４案,桃園市,桃園區,福林里,20,1399,237,509,746,43,789
公投第１４案,桃園市,桃園區,福林里,21,1540,282,540,822,39,861
公投第１４案,桃園市,桃園區,福林里,22,1638,258,525,783,23,806
公投第１４案,桃園市,桃園區,福林里,23,1228,182,451,633,27,660
公投第１４案,桃園市,桃園區,豐林里,24,1649,244,516,760,66,826
公投第１４案,桃園市,桃園區,豐林里,25,1601,264,533,797,36,833
公投第１４案,桃園市,桃園區,豐林里,26,1477,248,430,678,78,756
公投第１４案,桃園市,桃園區,豐林里,27,1503,252,523,775,41,816
公投第１４案,桃園市,桃園區,中和里,28,1375,256,481,737,63,800
公投第１４案,桃園市,桃園區,中興里,29,1743,299,601,900,43,943
公投第１４案,桃園市,桃園區,中興里,30,1862,300,569,869,43,912
公投第１４案,桃園市,桃園區,中興里,31,1728,307,569,876,28,904
公投第１４案,桃園市,桃園區,文化里,32,690,139,211,350,13,363
公投第１４案,桃園市,桃園區,文昌里,33,852,176,311,487,29,516
公投第１４案,桃園市,桃園區,文明里,34,1353,256,455,711,60,771
公投第１４案,桃園市,桃園區,北門里,35,1698,224,407,631,27,658
公投第１４案,桃園市,桃園區,民生里,36,1452,249,445,694,46,740
公投第１４案,桃園市,桃園區,永興里,37,1681,289,527,816,58,874
公投第１４案,桃園市,桃園區,光興里,38,1669,290,523,813,47,860
公投第１４案,桃園市,桃園區,光興里,39,1530,214,618,832,43,875
公投第１４案,桃園市,桃園區,光興里,40,1582,334,490,824,39,863
公投第１４案,桃園市,桃園區,西門里,41,1587,251,486,737,27,764
公投第１４案,桃園市,桃園區,西湖里,42,1451,256,496,752,45,797
公投第１４案,桃園市,桃園區,武陵里,43,1582,240,443,683,45,728
公投第１４案,桃園市,桃園區,長美里,44,1028,207,344,551,34,585
公投第１４案,桃園市,桃園區,南門里,45,1934,299,628,927,38,965
公投第１４案,桃園市,桃園區,南門里,46,1016,163,344,507,45,552
公投第１４案,桃園市,桃園區,南門里,47,1079,198,348,546,34,580
公投第１４案,桃園市,桃園區,南門里,48,1837,367,577,944,16,960
公投第１４案,桃園市,桃園區,南華里,49,1390,222,495,717,44,761
公投第１４案,桃園市,桃園區,中山里,50,1489,247,531,778,22,800
公投第１４案,桃園市,桃園區,中山里,51,1821,379,621,1000,20,1020
公投第１４案,桃園市,桃園區,中山里,52,1563,250,486,736,21,757
公投第１４案,桃園市,桃園區,中山里,53,1697,321,551,872,38,910
公投第１４案,桃園市,桃園區,中平里,54,1740,290,615,905,34,939
公投第１４案,桃園市,桃園區,中平里,55,1626,270,542,812,47,859
公投第１４案,桃園市,桃園區,中平里,56,1239,243,429,672,22,694
公投第１４案,桃園市,桃園區,中正里,57,1766,312,598,910,29,939
公投第１４案,桃園市,桃園區,中正里,58,1555,258,540,798,39,837
公投第１４案,桃園市,桃園區,中正里,59,1831,339,587,926,35,961
公投第１４案,桃園市,桃園區,中成里,60,1115,201,438,639,30,669
公投第１４案,桃園市,桃園區,中成里,61,1562,295,531,826,34,860
公投第１４案,桃園市,桃園區,中成里,62,1744,272,599,871,27,898
公投第１４案,桃園市,桃園區,中信里,63,1838,289,537,826,37,863
公投第１４案,桃園市,桃園區,中信里,64,1889,340,636,976,42,1018
公投第１４案,桃園市,桃園區,中信里,65,1985,306,579,885,54,939
公投第１４案,桃園市,桃園區,中原里,66,1524,299,537,836,35,871
公投第１４案,桃園市,桃園區,中原里,67,1425,263,581,844,31,875
公投第１４案,桃園市,桃園區,中原里,68,1606,296,591,887,37,924
公投第１４案,桃園市,桃園區,中泰里,69,2056,374,729,1103,27,1130
公投第１４案,桃園市,桃園區,中泰里,70,2010,357,715,1072,40,1112
公投第１４案,桃園市,桃園區,中聖里,71,2245,345,702,1047,60,1107
公投第１４案,桃園市,桃園區,中聖里,72,1590,322,491,813,33,846
公投第１４案,桃園市,桃園區,中聖里,73,1536,294,594,888,21,909
公投第１４案,桃園市,桃園區,中路里,74,1949,317,585,902,43,945
公投第１４案,桃園市,桃園區,中路里,75,1965,318,613,931,45,976
公投第１４案,桃園市,桃園區,中德里,76,2414,358,667,1025,53,1078
公投第１４案,桃園市,桃園區,中德里,77,1942,306,631,937,43,980
公投第１４案,桃園市,桃園區,中德里,78,2156,335,713,1048,62,1110
公投第１４案,桃園市,桃園區,文中里,79,1404,254,493,747,45,792
公投第１４案,桃園市,桃園區,文中里,80,1194,227,460,687,33,720
公投第１４案,桃園市,桃園區,玉山里,81,1449,273,506,779,56,835
公投第１４案,桃園市,桃園區,玉山里,82,1803,273,549,822,60,882
公投第１４案,桃園市,桃園區,玉山里,83,1692,286,571,857,42,899
公投第１４案,桃園市,桃園區,泰山里,84,1913,351,615,966,42,1008
公投第１４案,桃園市,桃園區,泰山里,85,1815,308,603,911,40,951
公投第１４案,桃園市,桃園區,龍山里,86,1173,196,359,555,34,589
公投第１４案,桃園市,桃園區,龍山里,87,1162,186,372,558,20,578
公投第１４案,桃園市,桃園區,龍山里,88,1194,136,365,501,56,557
公投第１４案,桃園市,桃園區,龍安里,89,1695,302,561,863,43,906
公投第１４案,桃園市,桃園區,龍安里,90,1797,307,576,883,15,898
公投第１４案,桃園市,桃園區,龍安里,91,1592,252,550,802,19,821
公投第１４案,桃園市,桃園區,龍岡里,92,1780,274,558,832,66,898
公投第１４案,桃園市,桃園區,龍岡里,93,1904,309,539,848,29,877
公投第１４案,桃園市,桃園區,龍岡里,94,2021,327,634,961,29,990
公投第１４案,桃園市,桃園區,龍祥里,95,1545,222,531,753,46,799
公投第１４案,桃園市,桃園區,龍祥里,96,1617,241,514,755,28,783
公投第１４案,桃園市,桃園區,龍祥里,97,1683,279,544,823,31,854
公投第１４案,桃園市,桃園區,龍壽里,98,1834,305,652,957,46,1003
公投第１４案,桃園市,桃園區,龍壽里,99,2055,330,608,938,33,971
公投第１４案,桃園市,桃園區,龍壽里,100,1828,279,570,849,23,872
公投第１４案,桃園市,桃園區,龍鳳里,101,1873,303,574,877,36,913
公投第１４案,桃園市,桃園區,龍鳳里,102,3687,256,479,735,35,770
公投第１４案,桃園市,桃園區,龍鳳里,103,1850,317,598,915,29,944
公投第１４案,桃園市,桃園區,龍鳳里,104,1827,297,600,897,28,925
公投第１４案,桃園市,桃園區,中埔里,105,1149,192,466,658,36,694
公投第１４案,桃園市,桃園區,中埔里,106,1061,201,379,580,43,623
公投第１４案,桃園市,桃園區,中寧里,107,1831,296,548,844,28,872
公投第１４案,桃園市,桃園區,中寧里,108,2168,370,673,1043,38,1081
公投第１４案,桃園市,桃園區,中寧里,109,1874,332,576,908,14,922
公投第１４案,桃園市,桃園區,北埔里,110,1524,242,442,684,21,705
公投第１４案,桃園市,桃園區,北埔里,111,1528,267,478,745,23,768
公投第１４案,桃園市,桃園區,北埔里,112,1489,288,515,803,30,833
公投第１４案,桃園市,桃園區,永安里,113,1308,344,285,629,50,679
公投第１４案,桃園市,桃園區,永安里,114,1583,243,533,776,41,817
公投第１４案,桃園市,桃園區,永安里,115,1618,280,564,844,41,885
公投第１４案,桃園市,桃園區,同安里,116,2127,354,628,982,53,1035
公投第１４案,桃園市,桃園區,同安里,117,2033,328,626,954,30,984
公投第１４案,桃園市,桃園區,同安里,118,2098,340,690,1030,22,1052
公投第１４案,桃園市,桃園區,同安里,119,2126,362,715,1077,72,1149
公投第１４案,桃園市,桃園區,同德里,120,1917,285,628,913,39,952
公投第１４案,桃園市,桃園區,同德里,121,1997,343,603,946,32,978
公投第１４案,桃園市,桃園區,同德里,122,1929,316,659,975,30,1005
公投第１４案,桃園市,桃園區,自強里,123,1691,314,512,826,34,860
公投第１４案,桃園市,桃園區,自強里,124,1900,329,508,837,24,861
公投第１４案,桃園市,桃園區,自強里,125,1761,291,578,869,64,933
公投第１４案,桃園市,桃園區,自強里,126,1922,332,619,951,21,972
公投第１４案,桃園市,桃園區,西埔里,127,1995,292,641,933,56,989
公投第１４案,桃園市,桃園區,西埔里,128,1063,193,367,560,29,589
公投第１４案,桃園市,桃園區,明德里,129,1412,247,460,707,29,736
公投第１４案,桃園市,桃園區,明德里,130,1746,342,572,914,32,946
公投第１４案,桃園市,桃園區,東埔里,131,1689,261,493,754,46,800
公投第１４案,桃園市,桃園區,東埔里,132,1542,222,446,668,25,693
公投第１４案,桃園市,桃園區,東埔里,133,1437,213,466,679,44,723
公投第１４案,桃園市,桃園區,長安里,134,1679,260,573,833,30,863
公投第１４案,桃園市,桃園區,長安里,135,1886,289,539,828,50,878
公投第１４案,桃園市,桃園區,長德里,136,1657,316,518,834,52,886
公投第１４案,桃園市,桃園區,長德里,137,1349,247,455,702,24,726
公投第１４案,桃園市,桃園區,長德里,138,1805,308,601,909,32,941
公投第１４案,桃園市,桃園區,信光里,139,1846,319,575,894,45,939
公投第１４案,桃園市,桃園區,信光里,140,1644,258,477,735,42,777
公投第１４案,桃園市,桃園區,信光里,141,1674,261,513,774,32,806
公投第１４案,桃園市,桃園區,信光里,142,1737,283,566,849,36,885
公投第１４案,桃園市,桃園區,南埔里,143,1566,245,547,792,47,839
公投第１４案,桃園市,桃園區,南埔里,144,1517,272,496,768,42,810
公投第１４案,桃園市,桃園區,南埔里,145,1619,268,451,719,32,751
公投第１４案,桃園市,桃園區,莊敬里,146,1774,328,552,880,31,911
公投第１４案,桃園市,桃園區,莊敬里,147,1666,269,569,838,34,872
公投第１４案,桃園市,桃園區,莊敬里,148,1528,268,518,786,13,799
公投第１４案,桃園市,桃園區,莊敬里,149,1709,311,508,819,45,864
公投第１４案,桃園市,桃園區,莊敬里,150,1719,314,524,838,19,857
公投第１４案,桃園市,桃園區,慈文里,151,1569,80,618,698,33,731
公投第１４案,桃園市,桃園區,慈文里,152,1505,217,506,723,22,745
公投第１４案,桃園市,桃園區,慈文里,153,1496,232,487,719,40,759
公投第１４案,桃園市,桃園區,慈文里,154,1505,281,487,768,36,804
公投第１４案,桃園市,桃園區,新埔里,155,1807,309,567,876,36,912
公投第１４案,桃園市,桃園區,新埔里,156,1857,405,510,915,36,951
公投第１４案,桃園市,桃園區,新埔里,157,1589,240,596,836,57,893
公投第１４案,桃園市,桃園區,新埔里,158,2088,365,659,1024,35,1059
公投第１４案,桃園市,桃園區,新埔里,159,1893,321,589,910,41,951
公投第１４案,桃園市,桃園區,瑞慶里,160,1303,179,384,563,32,595
公投第１４案,桃園市,桃園區,瑞慶里,161,1416,262,463,725,31,756
公投第１４案,桃園市,桃園區,瑞慶里,162,1351,221,415,636,30,666
公投第１４案,桃園市,桃園區,瑞慶里,163,1659,284,517,801,20,821
公投第１４案,桃園市,桃園區,寶安里,164,2103,314,667,981,34,1015
公投第１４案,桃園市,桃園區,寶安里,165,1943,306,616,922,40,962
公投第１４案,桃園市,桃園區,寶安里,166,1927,340,610,950,34,984
公投第１４案,桃園市,桃園區,寶安里,167,1929,282,565,847,37,884
公投第１４案,桃園市,桃園區,寶慶里,168,2204,428,776,1204,29,1233
公投第１４案,桃園市,桃園區,寶慶里,169,2033,360,541,901,29,930
公投第１４案,桃園市,桃園區,寶慶里,170,1656,268,558,826,16,842
公投第１４案,桃園市,桃園區,三元里,171,1712,324,505,829,43,872
公投第１４案,桃園市,桃園區,三元里,172,1738,325,524,849,30,879
公投第１４案,桃園市,桃園區,三民里,173,1432,280,559,839,24,863
公投第１４案,桃園市,桃園區,三民里,174,1421,277,510,787,35,822
公投第１４案,桃園市,桃園區,三民里,175,1344,242,439,681,22,703
公投第１４案,桃園市,桃園區,大有里,176,1942,306,577,883,21,904
公投第１４案,桃園市,桃園區,大有里,177,2001,342,638,980,28,1008
公投第１４案,桃園市,桃園區,大有里,178,1941,323,551,874,22,896
公投第１４案,桃園市,桃園區,大業里,179,1702,328,549,877,35,912
公投第１４案,桃園市,桃園區,大業里,180,1589,292,487,779,43,822
公投第１４案,桃園市,桃園區,大業里,181,1544,267,464,731,34,765
公投第１４案,桃園市,桃園區,大興里,182,1860,251,520,771,41,812
公投第１４案,桃園市,桃園區,大興里,183,1726,281,539,820,50,870
公投第１４案,桃園市,桃園區,大興里,184,1798,278,554,832,38,870
公投第１４案,桃園市,桃園區,成功里,185,1925,348,612,960,22,982
公投第１４案,桃園市,桃園區,成功里,186,1945,347,586,933,34,967
公投第１４案,桃園市,桃園區,汴洲里,187,1764,282,519,801,33,834
公投第１４案,桃園市,桃園區,汴洲里,188,1899,288,685,973,60,1033
公投第１４案,桃園市,桃園區,汴洲里,189,1415,237,474,711,17,728
公投第１４案,桃園市,桃園區,忠義里,190,1790,282,545,827,28,855
公投第１４案,桃園市,桃園區,忠義里,191,1693,275,505,780,35,815
公投第１４案,桃園市,桃園區,東山里,192,1916,265,609,874,40,914
公投第１４案,桃園市,桃園區,東門里,193,1434,243,415,658,23,681
公投第１４案,桃園市,桃園區,東門里,194,1494,284,516,800,48,848
公投第１４案,桃園市,桃園區,青溪里,195,1311,212,464,676,47,723
公投第１４案,桃園市,桃園區,青溪里,196,1476,242,491,733,42,775
公投第１４案,桃園市,桃園區,青溪里,197,1484,311,483,794,40,834
公投第１４案,桃園市,桃園區,春日里,198,1514,268,479,747,32,779
公投第１４案,桃園市,桃園區,春日里,199,1446,233,479,712,43,755
公投第１４案,桃園市,桃園區,春日里,200,1573,236,507,743,21,764
公投第１４案,桃園市,桃園區,春日里,201,1564,212,479,691,34,725
公投第１４案,桃園市,桃園區,朝陽里,202,1015,201,345,546,28,574
公投第１４案,桃園市,桃園區,朝陽里,203,955,165,287,452,34,486
公投第１４案,桃園市,桃園區,會稽里,204,1796,294,572,866,30,896
公投第１４案,桃園市,桃園區,會稽里,205,1878,334,561,895,16,911
公投第１４案,桃園市,桃園區,會稽里,206,1729,284,539,823,30,853
公投第１４案,桃園市,桃園區,會稽里,207,1843,271,561,832,24,856
公投第１４案,桃園市,桃園區,會稽里,208,1817,476,279,755,25,780
公投第１４案,桃園市,桃園區,萬壽里,209,979,172,357,529,24,553
公投第１４案,桃園市,桃園區,福元里,210,1363,248,468,716,17,733
公投第１４案,桃園市,桃園區,福元里,211,1546,276,493,769,16,785
公投第１４案,桃園市,桃園區,福元里,212,1308,251,387,638,23,661
公投第１４案,桃園市,桃園區,寶山里,213,2164,324,699,1023,50,1073
公投第１４案,桃園市,桃園區,寶山里,214,2020,317,623,940,39,979
公投第１４案,桃園市,桃園區,寶山里,215,1924,277,562,839,22,861
公投第１４案,桃園市,桃園區,寶山里,216,2088,276,590,866,38,904
公投第１４案,桃園市,龜山區,精忠里,217,874,123,338,461,23,484
公投第１４案,桃園市,龜山區,精忠里,218,2014,262,732,994,60,1054
公投第１４案,桃園市,龜山區,精忠里,219,2145,392,633,1025,25,1050
公投第１４案,桃園市,龜山區,陸光里,220,1744,222,683,905,41,946
公投第１４案,桃園市,龜山區,陸光里,221,1885,263,688,951,69,1020
公投第１４案,桃園市,龜山區,中興里,222,1546,219,485,704,48,752
公投第１４案,桃園市,龜山區,中興里,223,1684,270,510,780,56,836
公投第１４案,桃園市,龜山區,中興里,224,1477,206,429,635,45,680
公投第１４案,桃園市,龜山區,新興里,225,1528,191,630,821,41,862
公投第１４案,桃園市,龜山區,新興里,226,1428,90,178,268,23,291
公投第１４案,桃園市,龜山區,新路里,227,1525,245,527,772,62,834
公投第１４案,桃園市,龜山區,新路里,228,1041,196,368,564,44,608
公投第１４案,桃園市,龜山區,新路里,229,1404,237,425,662,32,694
公投第１４案,桃園市,龜山區,新路里,230,1478,242,531,773,44,817
公投第１４案,桃園市,龜山區,龜山里,231,2178,337,739,1076,53,1129
公投第１４案,桃園市,龜山區,龜山里,232,1672,261,586,847,52,899
公投第１４案,桃園市,龜山區,龜山里,233,1376,194,461,655,26,681
公投第１４案,桃園市,龜山區,龜山里,234,1480,237,475,712,41,753
公投第１４案,桃園市,龜山區,大同里,235,1258,228,423,651,40,691
公投第１４案,桃園市,龜山區,大同里,236,1464,250,469,719,29,748
公投第１４案,桃園市,龜山區,大同里,237,1844,285,588,873,68,941
公投第１４案,桃園市,龜山區,大同里,238,1169,214,373,587,23,610
公投第１４案,桃園市,龜山區,山頂里,239,1921,243,488,731,39,770
公投第１４案,桃園市,龜山區,山頂里,240,1694,247,535,782,32,814
公投第１４案,桃園市,龜山區,山頂里,241,1771,323,607,930,57,987
公投第１４案,桃園市,龜山區,山德里,242,1665,236,506,742,44,786
公投第１４案,桃園市,龜山區,山德里,243,1439,254,440,694,54,748
公投第１４案,桃園市,龜山區,山德里,244,1728,211,525,736,53,789
公投第１４案,桃園市,龜山區,山福里,245,1788,276,603,879,44,923
公投第１４案,桃園市,龜山區,山福里,246,1465,210,449,659,41,700
公投第１４案,桃園市,龜山區,幸福里,247,1659,195,443,638,54,692
公投第１４案,桃園市,龜山區,幸福里,248,1693,238,466,704,32,736
公投第１４案,桃園市,龜山區,幸福里,249,1818,250,439,689,18,707
公投第１４案,桃園市,龜山區,龍壽里,250,1752,305,545,850,35,885
公投第１４案,桃園市,龜山區,龍華里,251,1818,310,594,904,23,927
公投第１４案,桃園市,龜山區,龍華里,252,1499,274,465,739,22,761
公投第１４案,桃園市,龜山區,迴龍里,253,1916,313,610,923,45,968
公投第１４案,桃園市,龜山區,迴龍里,254,1804,328,549,877,34,911
公投第１４案,桃園市,龜山區,迴龍里,255,2127,362,626,988,27,1015
公投第１４案,桃園市,龜山區,嶺頂里,256,1005,162,330,492,48,540
公投第１４案,桃園市,龜山區,嶺頂里,257,1449,243,476,719,40,759
公投第１４案,桃園市,龜山區,嶺頂里,258,1498,256,412,668,57,725
公投第１４案,桃園市,龜山區,新嶺里,259,2149,301,616,917,57,974
公投第１４案,桃園市,龜山區,新嶺里,260,1771,211,431,642,46,688
公投第１４案,桃園市,龜山區,兔坑里,261,841,141,272,413,21,434
公投第１４案,桃園市,龜山區,兔坑里,262,2284,292,702,994,52,1046
公投第１４案,桃園市,龜山區,兔坑里,263,1228,176,412,588,67,655
公投第１４案,桃園市,龜山區,福源里,264,1979,255,612,867,49,916
公投第１４案,桃園市,龜山區,舊路里,265,1378,171,441,612,32,644
公投第１４案,桃園市,龜山區,舊路里,266,1061,164,332,496,36,532
公投第１４案,桃園市,龜山區,大坑里,267,1917,271,592,863,58,921
公投第１４案,桃園市,龜山區,楓福里,268,1540,267,605,872,29,901
公投第１４案,桃園市,龜山區,楓福里,269,1433,247,503,750,27,777
公投第１４案,桃園市,龜山區,楓樹里,270,1455,242,474,716,27,743
公投第１４案,桃園市,龜山區,楓樹里,271,2280,393,767,1160,59,1219
公投第１４案,桃園市,龜山區,樂善里,272,1668,221,530,751,39,790
公投第１４案,桃園市,龜山區,樂善里,273,1885,309,587,896,32,928
公投第１４案,桃園市,龜山區,長庚里,274,1849,420,466,886,21,907
公投第１４案,桃園市,龜山區,長庚里,275,1704,441,493,934,14,948
公投第１４案,桃園市,龜山區,公西里,276,1156,194,386,580,41,621
公投第１４案,桃園市,龜山區,大崗里,277,2114,285,560,845,46,891
公投第１４案,桃園市,龜山區,大崗里,278,1943,296,523,819,36,855
公投第１４案,桃園市,龜山區,大湖里,279,1800,312,494,806,32,838
公投第１４案,桃園市,龜山區,大湖里,280,2020,369,563,932,43,975
公投第１４案,桃園市,龜山區,大湖里,281,1319,239,463,702,30,732
公投第１４案,桃園市,龜山區,大華里,282,2229,408,729,1137,47,1184
公投第１４案,桃園市,龜山區,大華里,283,1992,332,593,925,30,955
公投第１４案,桃園市,龜山區,大華里,284,2237,371,630,1001,50,1051
公投第１４案,桃園市,龜山區,大華里,285,2133,468,529,997,32,1029
公投第１４案,桃園市,龜山區,文化里,286,2187,482,581,1063,41,1104
公投第１４案,桃園市,龜山區,文化里,287,1959,301,608,909,42,951
公投第１４案,桃園市,龜山區,文化里,288,1910,341,506,847,34,881
公投第１４案,桃園市,龜山區,南上里,289,1840,310,594,904,77,981
公投第１４案,桃園市,龜山區,南美里,290,2266,336,759,1095,38,1133
公投第１４案,桃園市,龜山區,文青里,291,2387,332,711,1043,30,1073
公投第１４案,桃園市,龜山區,文青里,292,1692,275,514,789,22,811
公投第１４案,桃園市,龜山區,文青里,293,904,182,282,464,8,472
公投第１４案,桃園市,龜山區,文青里,294,1469,284,476,760,25,785
公投第１４案,桃園市,八德區,興仁里,295,1761,243,516,759,71,830
公投第１４案,桃園市,八德區,興仁里,296,1804,273,444,717,14,731
公投第１４案,桃園市,八德區,興仁里,297,1813,169,322,491,22,513
公投第１４案,桃園市,八德區,興仁里,298,1784,261,537,798,27,825
公投第１４案,桃園市,八德區,福興里,299,2257,305,620,925,23,948
公投第１４案,桃園市,八德區,福興里,300,1857,237,532,769,27,796
公投第１４案,桃園市,八德區,福興里,301,2261,446,526,972,32,1004
公投第１４案,桃園市,八德區,福興里,302,1903,291,655,946,42,988
公投第１４案,桃園市,八德區,瑞豐里,303,1955,259,663,922,58,980
公投第１４案,桃園市,八德區,瑞豐里,304,1665,264,447,711,18,729
公投第１４案,桃園市,八德區,瑞興里,305,1431,273,457,730,56,786
公投第１４案,桃園市,八德區,瑞興里,306,1263,204,459,663,34,697
公投第１４案,桃園市,八德區,瑞泰里,307,1583,261,560,821,55,876
公投第１４案,桃園市,八德區,瑞泰里,308,1246,200,456,656,28,684
公投第１４案,桃園市,八德區,瑞泰里,309,1356,204,490,694,38,732
公投第１４案,桃園市,八德區,瑞發里,310,1630,263,573,836,66,902
公投第１４案,桃園市,八德區,瑞發里,311,1586,219,535,754,38,792
公投第１４案,桃園市,八德區,瑞德里,312,1649,263,543,806,63,869
公投第１４案,桃園市,八德區,瑞德里,313,1910,243,571,814,81,895
公投第１４案,桃園市,八德區,瑞祥里,314,1612,232,595,827,74,901
公投第１４案,桃園市,八德區,瑞祥里,315,1640,241,569,810,46,856
公投第１４案,桃園市,八德區,廣德里,316,1303,219,419,638,41,679
公投第１４案,桃園市,八德區,廣德里,317,1413,255,507,762,45,807
公投第１４案,桃園市,八德區,廣興里,318,1711,243,587,830,42,872
公投第１４案,桃園市,八德區,廣興里,319,1562,221,514,735,70,805
公投第１４案,桃園市,八德區,廣隆里,320,1735,239,585,824,61,885
公投第１４案,桃園市,八德區,廣隆里,321,1658,269,548,817,31,848
公投第１４案,桃園市,八德區,廣隆里,322,1022,161,414,575,36,611
公投第１４案,桃園市,八德區,竹園里,323,1673,215,510,725,42,767
公投第１４案,桃園市,八德區,竹園里,324,1741,248,577,825,37,862
公投第１４案,桃園市,八德區,霄裡里,325,2110,288,719,1007,58,1065
公投第１４案,桃園市,八德區,龍友里,326,1145,144,446,590,27,617
公投第１４案,桃園市,八德區,龍友里,327,1010,143,439,582,28,610
公投第１４案,桃園市,八德區,茄明里,328,1848,270,519,789,31,820
公投第１４案,桃園市,八德區,茄明里,329,1334,219,463,682,38,720
公投第１４案,桃園市,八德區,茄明里,330,1349,187,381,568,23,591
公投第１４案,桃園市,八德區,茄苳里,331,1341,254,482,736,30,766
公投第１４案,桃園市,八德區,茄苳里,332,1178,178,492,670,9,679
公投第１４案,桃園市,八德區,永豐里,333,1374,216,486,702,43,745
公投第１４案,桃園市,八德區,永豐里,334,1462,245,439,684,58,742
公投第１４案,桃園市,八德區,高明里,335,1943,237,561,798,60,858
公投第１４案,桃園市,八德區,高明里,336,1928,254,438,692,71,763
公投第１４案,桃園市,八德區,高城里,337,1403,217,440,657,26,683
公投第１４案,桃園市,八德區,高城里,338,1672,242,509,751,56,807
公投第１４案,桃園市,八德區,白鷺里,339,1947,301,574,875,32,907
公投第１４案,桃園市,八德區,白鷺里,340,1200,184,429,613,45,658
公投第１４案,桃園市,八德區,大湳里,341,1895,264,579,843,56,899
公投第１４案,桃園市,八德區,大湳里,342,1988,303,553,856,59,915
公投第１４案,桃園市,八德區,大發里,343,2006,310,674,984,65,1049
公投第１４案,桃園市,八德區,大仁里,344,2061,281,616,897,11,908
公投第１４案,桃園市,八德區,大仁里,345,2108,274,652,926,50,976
公投第１４案,桃園市,八德區,大明里,346,1862,263,579,842,51,893
公投第１４案,桃園市,八德區,大明里,347,1681,263,500,763,23,786
公投第１４案,桃園市,八德區,大安里,348,1317,195,459,654,57,711
公投第１４案,桃園市,八德區,大安里,349,2093,412,747,1159,53,1212
公投第１４案,桃園市,八德區,大竹里,350,1499,228,574,802,51,853
公投第１４案,桃園市,八德區,大興里,351,1782,258,597,855,52,907
公投第１４案,桃園市,八德區,大興里,352,1763,281,574,855,31,886
公投第１４案,桃園市,八德區,大愛里,353,1226,198,421,619,51,670
公投第１４案,桃園市,八德區,大愛里,354,1311,241,450,691,30,721
公投第１４案,桃園市,八德區,大華里,355,1170,219,413,632,34,666
公投第１４案,桃園市,八德區,大華里,356,1313,201,490,691,30,721
公投第１４案,桃園市,八德區,大順里,357,1186,202,421,623,30,653
公投第１４案,桃園市,八德區,大順里,358,1481,234,449,683,41,724
公投第１４案,桃園市,八德區,大和里,359,1998,321,643,964,63,1027
公投第１４案,桃園市,八德區,大和里,360,916,155,334,489,26,515
公投第１４案,桃園市,八德區,大和里,361,1943,272,609,881,44,925
公投第１４案,桃園市,八德區,大和里,362,2076,298,657,955,35,990
公投第１４案,桃園市,八德區,大昌里,363,1363,206,473,679,54,733
公投第１４案,桃園市,八德區,大昌里,364,1491,227,512,739,51,790
公投第１４案,桃園市,八德區,大信里,365,1474,220,476,696,66,762
公投第１４案,桃園市,八德區,大信里,366,718,27,134,161,13,174
公投第１４案,桃園市,八德區,大信里,367,1386,223,450,673,58,731
公投第１４案,桃園市,八德區,陸光里,368,1487,211,492,703,70,773
公投第１４案,桃園市,八德區,陸光里,369,1552,195,534,729,83,812
公投第１４案,桃園市,八德區,陸光里,370,1255,150,407,557,64,621
公投第１４案,桃園市,八德區,大同里,371,1505,250,543,793,56,849
公投第１４案,桃園市,八德區,大慶里,372,1436,201,452,653,50,703
公投第１４案,桃園市,八德區,大成里,373,1618,291,528,819,60,879
公投第１４案,桃園市,八德區,大成里,374,1685,223,580,803,54,857
公投第１４案,桃園市,八德區,大義里,375,1835,273,526,799,44,843
公投第１４案,桃園市,八德區,大義里,376,1881,304,592,896,56,952
公投第１４案,桃園市,八德區,大忠里,377,1766,254,579,833,36,869
公投第１４案,桃園市,八德區,大智里,378,1817,265,593,858,66,924
公投第１４案,桃園市,八德區,大智里,379,2198,349,754,1103,26,1129
公投第１４案,桃園市,八德區,大宏里,380,1732,304,580,884,25,909
公投第１４案,桃園市,八德區,大宏里,381,2089,372,677,1049,25,1074
公投第１４案,桃園市,八德區,大正里,382,1257,212,454,666,31,697
公投第１４案,桃園市,八德區,大正里,383,1267,212,408,620,36,656
公投第１４案,桃園市,八德區,大正里,384,1427,258,498,756,19,775
公投第１４案,桃園市,八德區,大福里,385,1685,301,622,923,46,969
公投第１４案,桃園市,八德區,大福里,386,1748,287,608,895,51,946
公投第１４案,桃園市,八德區,大福里,387,1650,313,793,1106,39,1145
公投第１４案,桃園市,八德區,大強里,388,1478,276,480,756,55,811
公投第１４案,桃園市,八德區,大強里,389,1607,242,584,826,48,874
公投第１４案,桃園市,八德區,大勇里,390,1841,290,645,935,88,1023
公投第１４案,桃園市,八德區,大勇里,391,2082,352,646,998,53,1051
公投第１４案,桃園市,八德區,大榮里,392,1959,256,603,859,46,905
公投第１４案,桃園市,八德區,大千里,393,2209,372,701,1073,54,1127
公投第１４案,桃園市,八德區,大漢里,394,1864,318,613,931,38,969
公投第１４案,桃園市,八德區,大漢里,395,2000,331,589,920,41,961
公投第１４案,桃園市,蘆竹區,新興里,396,1358,197,452,649,63,712
公投第１４案,桃園市,蘆竹區,新興里,397,1538,216,489,705,66,771
公投第１４案,桃園市,蘆竹區,中福里,398,2118,241,593,834,61,895
公投第１４案,桃園市,蘆竹區,中福里,399,1673,257,622,879,60,939
公投第１４案,桃園市,蘆竹區,上興里,400,1500,261,523,784,30,814
公投第１４案,桃園市,蘆竹區,上興里,401,1699,281,574,855,50,905
公投第１４案,桃園市,蘆竹區,中興里,402,2250,341,765,1106,43,1149
公投第１４案,桃園市,蘆竹區,中興里,403,2354,365,668,1033,23,1056
公投第１４案,桃園市,蘆竹區,新莊里,404,1446,206,459,665,24,689
公投第１４案,桃園市,蘆竹區,新莊里,405,1623,248,458,706,57,763
公投第１４案,桃園市,蘆竹區,新莊里,406,1747,275,542,817,30,847
公投第１４案,桃園市,蘆竹區,上竹里,407,1988,316,650,966,57,1023
公投第１４案,桃園市,蘆竹區,上竹里,408,1437,238,485,723,31,754
公投第１４案,桃園市,蘆竹區,宏竹里,409,1532,241,571,812,53,865
公投第１４案,桃園市,蘆竹區,宏竹里,410,1447,201,484,685,30,715
公投第１４案,桃園市,蘆竹區,大竹里,411,2189,338,715,1053,49,1102
公投第１４案,桃園市,蘆竹區,大竹里,412,2498,342,776,1118,51,1169
公投第１４案,桃園市,蘆竹區,富竹里,413,1322,227,462,689,29,718
公投第１４案,桃園市,蘆竹區,蘆竹里,414,1991,254,519,773,77,850
公投第１４案,桃園市,蘆竹區,蘆竹里,415,2097,313,615,928,59,987
公投第１４案,桃園市,蘆竹區,南興里,416,1558,305,497,802,46,848
公投第１４案,桃園市,蘆竹區,南興里,417,1891,366,594,960,30,990
公投第１４案,桃園市,蘆竹區,南興里,418,1590,268,476,744,29,773
公投第１４案,桃園市,蘆竹區,福昌里,419,2404,335,697,1032,50,1082
公投第１４案,桃園市,蘆竹區,福昌里,420,2522,413,796,1209,41,1250
公投第１４案,桃園市,蘆竹區,福興里,421,1633,270,551,821,23,844
公投第１４案,桃園市,蘆竹區,福興里,422,1715,311,536,847,39,886
公投第１４案,桃園市,蘆竹區,正興里,423,2215,324,677,1001,27,1028
公投第１４案,桃園市,蘆竹區,正興里,424,2029,222,713,935,41,976
公投第１４案,桃園市,蘆竹區,順興里,425,1731,282,530,812,30,842
公投第１４案,桃園市,蘆竹區,順興里,426,1820,295,595,890,29,919
公投第１４案,桃園市,蘆竹區,蘆興里,427,1633,283,554,837,49,886
公投第１４案,桃園市,蘆竹區,南榮里,428,1668,221,510,731,22,753
公投第１４案,桃園市,蘆竹區,南榮里,429,1493,280,305,585,31,616
公投第１４案,桃園市,蘆竹區,南崁里,430,1864,265,664,929,40,969
公投第１４案,桃園市,蘆竹區,南崁里,431,1703,314,493,807,29,836
公投第１４案,桃園市,蘆竹區,錦興里,432,1893,320,606,926,32,958
公投第１４案,桃園市,蘆竹區,錦興里,433,1922,367,658,1025,34,1059
公投第１４案,桃園市,蘆竹區,興榮里,434,1393,240,486,726,23,749
公投第１４案,桃園市,蘆竹區,興榮里,435,1338,237,482,719,18,737
公投第１４案,桃園市,蘆竹區,錦中里,436,1688,261,569,830,27,857
公投第１４案,桃園市,蘆竹區,錦中里,437,1462,226,473,699,49,748
公投第１４案,桃園市,蘆竹區,長興里,438,1232,172,459,631,22,653
公投第１４案,桃園市,蘆竹區,長興里,439,1356,188,435,623,25,648
公投第１４案,桃園市,蘆竹區,五福里,440,1181,224,456,680,36,716
公投第１４案,桃園市,蘆竹區,五福里,441,1199,185,392,577,27,604
公投第１４案,桃園市,蘆竹區,中山里,442,1710,305,577,882,28,910
公投第１４案,桃園市,蘆竹區,中山里,443,1423,234,448,682,18,700
公投第１４案,桃園市,蘆竹區,福祿里,444,1522,295,494,789,26,815
公投第１４案,桃園市,蘆竹區,福祿里,445,1639,271,574,845,34,879
公投第１４案,桃園市,蘆竹區,羊稠里,446,2055,340,640,980,40,1020
公投第１４案,桃園市,蘆竹區,羊稠里,447,2178,400,559,959,35,994
公投第１４案,桃園市,蘆竹區,吉祥里,448,1709,328,574,902,29,931
公投第１４案,桃園市,蘆竹區,長壽里,449,1667,284,594,878,38,916
公投第１４案,桃園市,蘆竹區,長壽里,450,1745,322,593,915,31,946
公投第１４案,桃園市,蘆竹區,長壽里,451,1967,371,659,1030,45,1075
公投第１４案,桃園市,蘆竹區,吉祥里,452,1802,329,658,987,21,1008
公投第１４案,桃園市,蘆竹區,營盤里,453,2727,433,849,1282,36,1318
公投第１４案,桃園市,蘆竹區,營盤里,454,1868,320,531,851,26,877
公投第１４案,桃園市,蘆竹區,營福里,455,1537,264,480,744,36,780
公投第１４案,桃園市,蘆竹區,營福里,456,1616,292,526,818,28,846
公投第１４案,桃園市,蘆竹區,瓦窯里,457,1483,276,547,823,35,858
公投第１４案,桃園市,蘆竹區,瓦窯里,458,1689,273,524,797,52,849
公投第１４案,桃園市,蘆竹區,內厝里,459,1318,160,361,521,43,564
公投第１４案,桃園市,蘆竹區,內厝里,460,1203,193,494,687,74,761
公投第１４案,桃園市,蘆竹區,山鼻里,461,1771,274,522,796,28,824
公投第１４案,桃園市,蘆竹區,山腳里,462,1832,244,549,793,62,855
公投第１４案,桃園市,蘆竹區,山腳里,463,1763,259,546,805,85,890
公投第１４案,桃園市,蘆竹區,外社里,464,1497,231,406,637,15,652
公投第１４案,桃園市,蘆竹區,坑子里,465,1671,258,628,886,107,993
公投第１４案,桃園市,蘆竹區,坑口里,466,929,160,322,482,56,538
公投第１４案,桃園市,蘆竹區,坑口里,467,1559,255,533,788,89,877
公投第１４案,桃園市,蘆竹區,海湖里,468,1497,231,540,771,22,793
公投第１４案,桃園市,蘆竹區,海湖里,469,1441,233,624,857,55,912
公投第１４案,桃園市,蘆竹區,濱海里,470,1465,201,496,697,49,746
公投第１４案,桃園市,蘆竹區,濱海里,471,1029,137,362,499,37,536
公投第１４案,桃園市,大園區,大園里,472,1538,222,449,671,34,705
公投第１４案,桃園市,大園區,大園里,473,1616,203,419,622,33,655
公投第１４案,桃園市,大園區,大園里,474,1437,265,510,775,36,811
公投第１４案,桃園市,大園區,大園里,475,1554,241,575,816,36,852
公投第１４案,桃園市,大園區,田心里,476,1237,208,402,610,33,643
公投第１４案,桃園市,大園區,田心里,477,1347,213,436,649,49,698
公投第１４案,桃園市,大園區,田心里,478,1261,213,415,628,21,649
公投第１４案,桃園市,大園區,田心里,479,1256,189,416,605,34,639
公投第１４案,桃園市,大園區,田心里,480,1370,197,427,624,22,646
公投第１４案,桃園市,大園區,溪海里,481,1610,209,506,715,41,756
公投第１４案,桃園市,大園區,溪海里,482,1419,188,483,671,34,705
公投第１４案,桃園市,大園區,溪海里,483,1588,173,461,634,21,655
公投第１４案,桃園市,大園區,和平里,484,1612,257,515,772,42,814
公投第１４案,桃園市,大園區,橫峰里,485,1440,201,481,682,34,716
公投第１４案,桃園市,大園區,橫峰里,486,1326,210,395,605,42,647
公投第１４案,桃園市,大園區,橫峰里,487,1455,230,534,764,55,819
公投第１４案,桃園市,大園區,橫峰里,488,1562,271,527,798,43,841
公投第１４案,桃園市,大園區,橫峰里,489,1284,223,473,696,31,727
公投第１４案,桃園市,大園區,橫峰里,490,1454,252,424,676,16,692
公投第１４案,桃園市,大園區,橫峰里,491,1490,299,443,742,15,757
公投第１４案,桃園市,大園區,五權里,492,1617,225,498,723,32,755
公投第１４案,桃園市,大園區,五權里,493,1594,269,501,770,58,828
公投第１４案,桃園市,大園區,五權里,494,1650,229,565,794,55,849
公投第１４案,桃園市,大園區,埔心里,495,1467,205,473,678,21,699
公投第１４案,桃園市,大園區,埔心里,496,1494,222,501,723,32,755
公投第１４案,桃園市,大園區,埔心里,497,1538,224,503,727,49,776
公投第１４案,桃園市,大園區,埔心里,498,1397,206,470,676,27,703
公投第１４案,桃園市,大園區,大海里,499,1637,237,509,746,32,778
公投第１４案,桃園市,大園區,三石里,500,1452,199,453,652,57,709
公投第１４案,桃園市,大園區,三石里,501,1414,239,565,804,47,851
公投第１４案,桃園市,大園區,菓林里,502,1670,246,572,818,34,852
公投第１４案,桃園市,大園區,菓林里,503,1701,258,507,765,19,784
公投第１４案,桃園市,大園區,菓林里,504,1813,230,515,745,37,782
公投第１４案,桃園市,大園區,菓林里,505,1687,256,518,774,31,805
公投第１４案,桃園市,大園區,竹圍里,506,1650,287,551,838,10,848
公投第１４案,桃園市,大園區,竹圍里,507,1556,289,548,837,50,887
公投第１４案,桃園市,大園區,海口里,508,1844,254,541,795,26,821
公投第１４案,桃園市,大園區,沙崙里,509,1336,181,418,599,54,653
公投第１４案,桃園市,大園區,沙崙里,510,1414,205,528,733,52,785
公投第１４案,桃園市,大園區,後厝里,511,1238,214,485,699,42,741
公投第１４案,桃園市,大園區,後厝里,512,1227,207,507,714,30,744
公投第１４案,桃園市,大園區,圳頭里,513,1199,202,376,578,27,605
公投第１４案,桃園市,大園區,圳頭里,514,1349,270,337,607,27,634
公投第１４案,桃園市,大園區,內海里,515,1120,175,375,550,25,575
公投第１４案,桃園市,大園區,內海里,516,1080,173,372,545,23,568
公投第１４案,桃園市,大園區,北港里,517,1341,199,423,622,37,659
公投第１４案,桃園市,大園區,北港里,518,1345,211,478,689,22,711
公投第１４案,桃園市,大園區,南港里,519,1565,196,466,662,46,708
公投第１４案,桃園市,大園區,南港里,520,1519,194,436,630,29,659
公投第１４案,桃園市,大園區,南港里,521,2130,275,662,937,50,987
公投第１４案,桃園市,大溪區,興和里,522,1477,265,516,781,51,832
公投第１４案,桃園市,大溪區,福仁里,523,1006,168,357,525,34,559
公投第１４案,桃園市,大溪區,田心里,524,1553,223,526,749,67,816
公投第１４案,桃園市,大溪區,田心里,525,1597,294,514,808,63,871
公投第１４案,桃園市,大溪區,田心里,526,1358,224,460,684,38,722
公投第１４案,桃園市,大溪區,一心里,527,1585,232,497,729,34,763
公投第１４案,桃園市,大溪區,一心里,528,1612,284,509,793,47,840
公投第１４案,桃園市,大溪區,一心里,529,1555,191,501,692,35,727
公投第１４案,桃園市,大溪區,一德里,530,1282,220,514,734,37,771
公投第１４案,桃園市,大溪區,一德里,531,1392,198,486,684,48,732
公投第１４案,桃園市,大溪區,一德里,532,1422,210,469,679,42,721
公投第１４案,桃園市,大溪區,一德里,533,1448,252,468,720,66,786
公投第１４案,桃園市,大溪區,月眉里,534,1269,243,487,730,46,776
公投第１４案,桃園市,大溪區,永福里,535,977,156,371,527,64,591
公投第１４案,桃園市,大溪區,康安里,536,1359,217,512,729,41,770
公投第１４案,桃園市,大溪區,義和里,537,1135,206,415,621,63,684
公投第１４案,桃園市,大溪區,義和里,538,660,120,188,308,44,352
公投第１４案,桃園市,大溪區,美華里,539,1056,161,329,490,41,531
公投第１４案,桃園市,大溪區,美華里,540,1263,189,410,599,53,652
公投第１４案,桃園市,大溪區,美華里,541,717,91,267,358,42,400
公投第１４案,桃園市,大溪區,福安里,542,1299,168,375,543,20,563
公投第１４案,桃園市,大溪區,福安里,543,976,162,319,481,62,543
公投第１４案,桃園市,大溪區,復興里,544,938,128,325,453,55,508
公投第１４案,桃園市,大溪區,新峰里,545,832,116,282,398,24,422
公投第１４案,桃園市,大溪區,中新里,546,866,114,256,370,26,396
公投第１４案,桃園市,大溪區,中新里,547,694,112,195,307,33,340
公投第１４案,桃園市,大溪區,瑞興里,548,1410,213,440,653,49,702
公投第１４案,桃園市,大溪區,瑞興里,549,1303,143,453,596,51,647
公投第１４案,桃園市,大溪區,仁善里,550,1125,184,377,561,28,589
公投第１４案,桃園市,大溪區,仁善里,551,1170,211,410,621,23,644
公投第１４案,桃園市,大溪區,仁善里,552,1308,226,497,723,42,765
公投第１４案,桃園市,大溪區,仁美里,553,1094,179,366,545,71,616
公投第１４案,桃園市,大溪區,仁美里,554,2153,331,763,1094,52,1146
公投第１４案,桃園市,大溪區,僑愛里,555,1173,142,495,637,41,678
公投第１４案,桃園市,大溪區,僑愛里,556,1369,182,500,682,22,704
公投第１４案,桃園市,大溪區,仁義里,557,1446,199,474,673,72,745
公投第１４案,桃園市,大溪區,仁義里,558,1406,147,437,584,53,637
公投第１４案,桃園市,大溪區,仁和里,559,1592,238,600,838,22,860
公投第１４案,桃園市,大溪區,仁和里,560,1497,246,550,796,61,857
公投第１４案,桃園市,大溪區,仁和里,561,1559,266,549,815,75,890
公投第１４案,桃園市,大溪區,仁愛里,562,1684,258,575,833,25,858
公投第１４案,桃園市,大溪區,仁愛里,563,1959,312,706,1018,65,1083
公投第１４案,桃園市,大溪區,仁愛里,564,1369,211,498,709,69,778
公投第１４案,桃園市,大溪區,仁武里,565,1431,231,518,749,53,802
公投第１４案,桃園市,大溪區,仁武里,566,1657,196,467,663,30,693
公投第１４案,桃園市,大溪區,仁文里,567,1387,184,400,584,30,614
公投第１４案,桃園市,大溪區,仁文里,568,1085,167,355,522,49,571
公投第１４案,桃園市,大溪區,仁文里,569,1403,214,536,750,40,790
公投第１４案,桃園市,大溪區,南興里,570,1511,241,473,714,70,784
公投第１４案,桃園市,大溪區,南興里,571,1719,251,472,723,76,799
公投第１４案,桃園市,大溪區,南興里,572,1717,213,503,716,77,793
公投第１４案,桃園市,大溪區,光明里,573,1207,162,414,576,73,649
公投第１４案,桃園市,大溪區,光明里,574,1188,171,429,600,74,674
公投第１４案,桃園市,大溪區,員林里,575,1514,213,500,713,22,735
公投第１４案,桃園市,大溪區,三元里,576,1529,234,556,790,65,855
公投第１４案,桃園市,大溪區,三元里,577,1260,199,510,709,34,743
公投第１４案,桃園市,大溪區,瑞源里,578,831,120,341,461,18,479
公投第１４案,桃園市,大溪區,瑞源里,579,1407,217,516,733,47,780
公投第１４案,桃園市,大溪區,瑞源里,580,1494,199,483,682,63,745
公投第１４案,桃園市,復興區,三民里,581,1991,197,834,1031,85,1116
公投第１４案,桃園市,復興區,澤仁里,582,1392,143,611,754,47,801
公投第１４案,桃園市,復興區,霞雲里,583,564,67,229,296,20,316
公投第１４案,桃園市,復興區,義盛里,584,716,93,279,372,18,390
公投第１４案,桃園市,復興區,羅浮里,585,1016,132,464,596,49,645
公投第１４案,桃園市,復興區,長興里,586,669,82,214,296,8,304
公投第１４案,桃園市,復興區,奎輝里,587,760,71,305,376,9,385
公投第１４案,桃園市,復興區,高義里,588,751,54,344,398,17,415
公投第１４案,桃園市,復興區,三光里,589,683,42,215,257,7,264
公投第１４案,桃園市,復興區,華陵里,590,1224,86,565,651,31,682
公投第１４案,桃園市,中壢區,後寮里,591,1401,210,489,699,41,740
公投第１４案,桃園市,中壢區,後寮里,592,1798,283,580,863,37,900
公投第１４案,桃園市,中壢區,後寮里,593,1642,263,479,742,32,774
公投第１４案,桃園市,中壢區,明德里,594,1670,281,564,845,35,880
公投第１４案,桃園市,中壢區,明德里,595,1456,263,512,775,26,801
公投第１４案,桃園市,中壢區,明德里,596,1531,286,607,893,26,919
公投第１４案,桃園市,中壢區,至善里,597,1623,244,662,906,33,939
公投第１４案,桃園市,中壢區,至善里,598,1953,241,627,868,25,893
公投第１４案,桃園市,中壢區,龍慈里,599,1155,208,431,639,21,660
公投第１４案,桃園市,中壢區,龍慈里,600,1800,231,556,787,33,820
公投第１４案,桃園市,中壢區,龍慈里,601,1757,250,572,822,27,849
公投第１４案,桃園市,中壢區,龍興里,602,1281,209,504,713,45,758
公投第１４案,桃園市,中壢區,龍興里,603,1462,242,566,808,24,832
公投第１４案,桃園市,中壢區,龍興里,604,1560,187,518,705,46,751
公投第１４案,桃園市,中壢區,龍德里,605,1602,272,650,922,22,944
公投第１４案,桃園市,中壢區,龍德里,606,1006,162,455,617,29,646
公投第１４案,桃園市,中壢區,龍德里,607,1474,246,561,807,25,832
公投第１４案,桃園市,中壢區,龍岡里,608,1627,210,622,832,65,897
公投第１４案,桃園市,中壢區,龍岡里,609,1519,228,590,818,41,859
公投第１４案,桃園市,中壢區,龍岡里,610,1526,212,583,795,58,853
公投第１４案,桃園市,中壢區,龍東里,611,1618,214,595,809,64,873
公投第１４案,桃園市,中壢區,龍東里,612,1554,232,625,857,49,906
公投第１４案,桃園市,中壢區,龍東里,613,1706,214,636,850,62,912
公投第１４案,桃園市,中壢區,龍昌里,614,1818,301,697,998,40,1038
公投第１４案,桃園市,中壢區,龍昌里,615,1991,274,683,957,39,996
公投第１４案,桃園市,中壢區,龍昌里,616,1609,229,600,829,34,863
公投第１４案,桃園市,中壢區,龍平里,617,1329,162,470,632,24,656
公投第１４案,桃園市,中壢區,龍平里,618,1587,205,517,722,71,793
公投第１４案,桃園市,中壢區,仁美里,619,1955,272,699,971,21,992
公投第１４案,桃園市,中壢區,仁美里,620,1711,258,577,835,52,887
公投第１４案,桃園市,中壢區,仁美里,621,1712,270,567,837,42,879
公投第１４案,桃園市,中壢區,仁福里,622,1448,221,571,792,42,834
公投第１４案,桃園市,中壢區,仁福里,623,1605,241,538,779,40,819
公投第１４案,桃園市,中壢區,仁福里,624,1633,224,544,768,10,778
公投第１４案,桃園市,中壢區,華愛里,625,1795,301,679,980,48,1028
公投第１４案,桃園市,中壢區,華愛里,626,1689,224,672,896,19,915
公投第１４案,桃園市,中壢區,普仁里,627,1201,182,470,652,19,671
公投第１４案,桃園市,中壢區,普仁里,628,1353,242,452,694,31,725
公投第１４案,桃園市,中壢區,普仁里,629,1587,234,534,768,31,799
公投第１４案,桃園市,中壢區,普忠里,630,1883,294,670,964,40,1004
公投第１４案,桃園市,中壢區,普忠里,631,1448,248,475,723,23,746
公投第１４案,桃園市,中壢區,普強里,632,1810,313,600,913,42,955
公投第１４案,桃園市,中壢區,普強里,633,1916,309,631,940,39,979
公投第１４案,桃園市,中壢區,普慶里,634,1177,184,470,654,25,679
公投第１４案,桃園市,中壢區,普慶里,635,1410,250,554,804,40,844
公投第１４案,桃園市,中壢區,信義里,636,1368,234,458,692,28,720
公投第１４案,桃園市,中壢區,信義里,637,1424,233,574,807,45,852
公投第１４案,桃園市,中壢區,信義里,638,1573,281,573,854,23,877
公投第１４案,桃園市,中壢區,正義里,639,1152,208,423,631,26,657
公投第１４案,桃園市,中壢區,正義里,640,1178,220,423,643,17,660
公投第１４案,桃園市,中壢區,正義里,641,1966,316,700,1016,31,1047
公投第１４案,桃園市,中壢區,普義里,642,3474,227,462,689,25,714
公投第１４案,桃園市,中壢區,普義里,643,2099,382,708,1090,42,1132
公投第１４案,桃園市,中壢區,德義里,644,1178,193,444,637,25,662
公投第１４案,桃園市,中壢區,德義里,645,1397,262,552,814,42,856
公投第１４案,桃園市,中壢區,仁義里,646,1669,286,598,884,43,927
公投第１４案,桃園市,中壢區,仁義里,647,2087,325,648,973,44,1017
公投第１４案,桃園市,中壢區,忠義里,648,1900,306,630,936,43,979
公投第１４案,桃園市,中壢區,忠義里,649,1640,256,448,704,18,722
公投第１４案,桃園市,中壢區,龍安里,650,994,164,402,566,30,596
公投第１４案,桃園市,中壢區,龍安里,651,1131,168,521,689,37,726
公投第１４案,桃園市,中壢區,仁愛里,652,1625,632,291,923,33,956
公投第１４案,桃園市,中壢區,仁愛里,653,1384,252,573,825,35,860
公投第１４案,桃園市,中壢區,仁德里,654,1588,266,552,818,35,853
公投第１４案,桃園市,中壢區,仁德里,655,1445,192,560,752,38,790
公投第１４案,桃園市,中壢區,仁和里,656,1743,178,544,722,31,753
公投第１４案,桃園市,中壢區,仁和里,657,1812,256,578,834,24,858
公投第１４案,桃園市,中壢區,仁祥里,658,1546,236,512,748,41,789
公投第１４案,桃園市,中壢區,仁祥里,659,1290,176,479,655,32,687
公投第１４案,桃園市,中壢區,華勛里,660,2145,262,727,989,60,1049
公投第１４案,桃園市,中壢區,華勛里,661,1451,208,480,688,32,720
公投第１４案,桃園市,中壢區,中堅里,662,1489,210,531,741,38,779
公投第１４案,桃園市,中壢區,中堅里,663,827,150,290,440,21,461
公投第１４案,桃園市,中壢區,中堅里,664,1442,219,489,708,30,738
公投第１４案,桃園市,中壢區,興仁里,665,1842,288,567,855,18,873
公投第１４案,桃園市,中壢區,興仁里,666,1520,238,475,713,22,735
公投第１４案,桃園市,中壢區,中正里,667,1764,256,534,790,32,822
公投第１４案,桃園市,中壢區,中正里,668,1488,231,574,805,17,822
公投第１４案,桃園市,中壢區,中正里,669,1593,245,571,816,32,848
公投第１４案,桃園市,中壢區,中山里,670,1505,261,517,778,25,803
公投第１４案,桃園市,中壢區,中山里,671,1661,252,585,837,22,859
公投第１４案,桃園市,中壢區,中山里,672,1492,242,544,786,40,826
公投第１４案,桃園市,中壢區,篤行里,673,1249,192,399,591,26,617
公投第１４案,桃園市,中壢區,篤行里,674,1257,215,466,681,26,707
公投第１４案,桃園市,中壢區,自強里,675,1659,251,559,810,55,865
公投第１４案,桃園市,中壢區,自強里,676,1815,330,639,969,29,998
公投第１４案,桃園市,中壢區,中興里,677,1702,266,566,832,30,862
公投第１４案,桃園市,中壢區,中興里,678,1541,282,519,801,25,826
公投第１４案,桃園市,中壢區,自立里,679,1659,238,543,781,36,817
公投第１４案,桃園市,中壢區,自立里,680,1874,239,666,905,67,972
公投第１４案,桃園市,中壢區,自立里,681,1603,184,589,773,31,804
公投第１４案,桃園市,中壢區,自信里,682,1735,277,562,839,39,878
公投第１４案,桃園市,中壢區,自信里,683,1815,315,573,888,32,920
公投第１４案,桃園市,中壢區,自信里,684,1873,200,614,814,26,840
公投第１４案,桃園市,中壢區,莊敬里,685,1739,220,697,917,46,963
公投第１４案,桃園市,中壢區,莊敬里,686,1709,263,549,812,35,847
公投第１４案,桃園市,中壢區,自治里,687,1655,246,620,866,45,911
公投第１４案,桃園市,中壢區,自治里,688,1664,224,636,860,30,890
公投第１４案,桃園市,中壢區,內壢里,689,1087,146,397,543,12,555
公投第１４案,桃園市,中壢區,內壢里,690,1065,171,386,557,43,600
公投第１４案,桃園市,中壢區,成功里,691,1844,289,637,926,63,989
公投第１４案,桃園市,中壢區,成功里,692,1220,166,377,543,38,581
公投第１４案,桃園市,中壢區,成功里,693,1219,204,422,626,29,655
公投第１４案,桃園市,中壢區,福德里,694,1260,201,454,655,42,697
公投第１４案,桃園市,中壢區,福德里,695,1594,250,631,881,47,928
公投第１４案,桃園市,中壢區,中原里,696,1733,309,573,882,60,942
公投第１４案,桃園市,中壢區,中原里,697,1979,323,675,998,44,1042
公投第１４案,桃園市,中壢區,忠孝里,698,1621,314,547,861,27,888
公投第１４案,桃園市,中壢區,忠孝里,699,1391,237,507,744,41,785
公投第１４案,桃園市,中壢區,忠孝里,700,1531,266,570,836,15,851
公投第１４案,桃園市,中壢區,復興里,701,1943,255,657,912,29,941
公投第１４案,桃園市,中壢區,復興里,702,1363,232,469,701,15,716
公投第１４案,桃園市,中壢區,復興里,703,2172,324,624,948,39,987
公投第１４案,桃園市,中壢區,復興里,704,1798,246,594,840,39,879
公投第１４案,桃園市,中壢區,復興里,705,1671,250,556,806,23,829
公投第１４案,桃園市,中壢區,復華里,706,1969,282,600,882,52,934
公投第１４案,桃園市,中壢區,復華里,707,1563,295,662,957,41,998
公投第１４案,桃園市,中壢區,復華里,708,1762,320,626,946,32,978
公投第１４案,桃園市,中壢區,文化里,709,1923,235,563,798,30,828
公投第１４案,桃園市,中壢區,文化里,710,1572,272,572,844,52,896
公投第１４案,桃園市,中壢區,文化里,711,1850,307,676,983,31,1014
公投第１４案,桃園市,中壢區,文化里,712,1583,266,514,780,42,822
公投第１４案,桃園市,中壢區,文化里,713,1735,297,561,858,39,897
公投第１４案,桃園市,中壢區,和平里,714,1292,202,454,656,31,687
公投第１４案,桃園市,中壢區,和平里,715,1265,204,464,668,18,686
公投第１４案,桃園市,中壢區,內定里,716,1798,258,643,901,34,935
公投第１４案,桃園市,中壢區,內定里,717,1822,290,700,990,53,1043
公投第１４案,桃園市,中壢區,內定里,718,1613,255,576,831,24,855
公投第１４案,桃園市,中壢區,內定里,719,1405,259,465,724,34,758
公投第１４案,桃園市,中壢區,石頭里,720,1730,531,397,928,55,983
公投第１４案,桃園市,中壢區,中央里,721,1384,241,576,817,33,850
公投第１４案,桃園市,中壢區,中央里,722,1122,202,422,624,14,638
公投第１４案,桃園市,中壢區,中央里,723,992,184,379,563,41,604
公投第１４案,桃園市,中壢區,新興里,724,1820,318,592,910,36,946
公投第１４案,桃園市,中壢區,新興里,725,1847,360,536,896,43,939
公投第１４案,桃園市,中壢區,林森里,726,1302,219,504,723,47,770
公投第１４案,桃園市,中壢區,林森里,727,1203,206,446,652,44,696
公投第１４案,桃園市,中壢區,林森里,728,1226,242,510,752,37,789
公投第１４案,桃園市,中壢區,振興里,729,1234,197,503,700,33,733
公投第１４案,桃園市,中壢區,振興里,730,2023,273,634,907,43,950
公投第１４案,桃園市,中壢區,振興里,731,1555,210,506,716,21,737
公投第１４案,桃園市,中壢區,東興里,732,1951,314,622,936,48,984
公投第１４案,桃園市,中壢區,東興里,733,1383,237,488,725,45,770
公投第１４案,桃園市,中壢區,健行里,734,1164,186,479,665,39,704
公投第１４案,桃園市,中壢區,健行里,735,1482,244,538,782,32,814
公投第１４案,桃園市,中壢區,健行里,736,1770,252,653,905,39,944
公投第１４案,桃園市,中壢區,水尾里,737,1703,303,629,932,56,988
公投第１４案,桃園市,中壢區,水尾里,738,1841,266,659,925,51,976
公投第１４案,桃園市,中壢區,金華里,739,1941,359,678,1037,28,1065
公投第１４案,桃園市,中壢區,金華里,740,2029,339,740,1079,38,1117
公投第１４案,桃園市,中壢區,忠福里,741,1636,301,627,928,27,955
公投第１４案,桃園市,中壢區,忠福里,742,1528,243,590,833,39,872
公投第１４案,桃園市,中壢區,忠福里,743,2289,332,712,1044,62,1106
公投第１４案,桃園市,中壢區,忠福里,744,2020,328,636,964,34,998
公投第１４案,桃園市,中壢區,幸福里,745,2027,326,709,1035,59,1094
公投第１４案,桃園市,中壢區,幸福里,746,1883,281,535,816,22,838
公投第１４案,桃園市,中壢區,幸福里,747,2080,315,677,992,48,1040
公投第１４案,桃園市,中壢區,永福里,748,646,121,223,344,12,356
公投第１４案,桃園市,中壢區,永福里,749,1780,315,751,1066,50,1116
公投第１４案,桃園市,中壢區,永福里,750,1372,99,537,636,17,653
公投第１４案,桃園市,中壢區,永福里,751,1668,276,645,921,34,955
公投第１４案,桃園市,中壢區,青埔里,752,1987,340,622,962,30,992
公投第１４案,桃園市,中壢區,青埔里,753,1520,266,544,810,17,827
公投第１４案,桃園市,中壢區,新街里,754,852,160,278,438,27,465
公投第１４案,桃園市,中壢區,新街里,755,1209,247,406,653,19,672
公投第１４案,桃園市,中壢區,興南里,756,1481,445,304,749,56,805
公投第１４案,桃園市,中壢區,興南里,757,1564,248,484,732,14,746
公投第１４案,桃園市,中壢區,興國里,758,1957,322,683,1005,54,1059
公投第１４案,桃園市,中壢區,興平里,759,1223,275,468,743,43,786
公投第１４案,桃園市,中壢區,興平里,760,1182,219,444,663,32,695
公投第１４案,桃園市,中壢區,興和里,761,1066,187,401,588,39,627
公投第１４案,桃園市,中壢區,興和里,762,1701,271,660,931,39,970
公投第１４案,桃園市,中壢區,永興里,763,943,156,315,471,32,503
公投第１４案,桃園市,中壢區,中壢里,764,731,135,281,416,26,442
公投第１４案,桃園市,中壢區,中榮里,765,851,155,307,462,32,494
公投第１４案,桃園市,中壢區,中建里,766,1011,202,337,539,18,557
公投第１４案,桃園市,中壢區,舊明里,767,1532,268,571,839,41,880
公投第１４案,桃園市,中壢區,新明里,768,1028,165,356,521,38,559
公投第１４案,桃園市,中壢區,新明里,769,1157,190,440,630,40,670
公投第１４案,桃園市,中壢區,新明里,770,1591,260,526,786,42,828
公投第１４案,桃園市,中壢區,光明里,771,2156,314,662,976,50,1026
公投第１４案,桃園市,中壢區,光明里,772,1479,220,468,688,19,707
公投第１４案,桃園市,中壢區,光明里,773,1780,291,608,899,42,941
公投第１４案,桃園市,中壢區,永光里,774,1651,259,586,845,48,893
公投第１４案,桃園市,中壢區,永光里,775,1870,347,632,979,37,1016
公投第１４案,桃園市,中壢區,永光里,776,1913,288,564,852,27,879
公投第１４案,桃園市,中壢區,三民里,777,1609,214,511,725,37,762
公投第１４案,桃園市,中壢區,三民里,778,1539,229,526,755,29,784
公投第１４案,桃園市,中壢區,五權里,779,1426,228,504,732,32,764
公投第１４案,桃園市,中壢區,五權里,780,1618,219,541,760,28,788
公投第１４案,桃園市,中壢區,五權里,781,1441,220,525,745,39,784
公投第１４案,桃園市,中壢區,五權里,782,1528,299,516,815,29,844
公投第１４案,桃園市,中壢區,五福里,783,1683,277,579,856,48,904
公投第１４案,桃園市,中壢區,五福里,784,1945,294,716,1010,64,1074
公投第１４案,桃園市,中壢區,芝芭里,785,1534,233,541,774,48,822
公投第１４案,桃園市,中壢區,芝芭里,786,1810,271,593,864,46,910
公投第１４案,桃園市,中壢區,洽溪里,787,1097,184,334,518,44,562
公投第１４案,桃園市,中壢區,洽溪里,788,1917,344,559,903,31,934
公投第１４案,桃園市,中壢區,洽溪里,789,1858,358,572,930,28,958
公投第１４案,桃園市,中壢區,內厝里,790,1576,278,565,843,33,876
公投第１４案,桃園市,中壢區,內厝里,791,1478,258,540,798,46,844
公投第１４案,桃園市,中壢區,內厝里,792,1589,278,528,806,34,840
公投第１４案,桃園市,中壢區,月眉里,793,2037,335,702,1037,70,1107
公投第１４案,桃園市,中壢區,月眉里,794,1158,206,460,666,34,700
公投第１４案,桃園市,中壢區,月眉里,795,1967,202,797,999,67,1066
公投第１４案,桃園市,中壢區,山東里,796,1830,274,587,861,67,928
公投第１４案,桃園市,中壢區,山東里,797,1856,257,675,932,47,979
公投第１４案,桃園市,中壢區,過嶺里,798,2068,304,672,976,61,1037
公投第１４案,桃園市,中壢區,過嶺里,799,2152,300,558,858,33,891
公投第１４案,桃園市,中壢區,過嶺里,800,2158,358,592,950,40,990
公投第１４案,桃園市,平鎮區,平鎮里,801,1487,206,487,693,35,728
公投第１４案,桃園市,平鎮區,平鎮里,802,1453,203,523,726,37,763
公投第１４案,桃園市,平鎮區,平鎮里,803,1491,255,525,780,33,813
公投第１４案,桃園市,平鎮區,鎮興里,804,1346,194,473,667,37,704
公投第１４案,桃園市,平鎮區,鎮興里,805,1660,218,595,813,30,843
公投第１４案,桃園市,平鎮區,南勢里,806,1921,234,665,899,27,926
公投第１４案,桃園市,平鎮區,南勢里,807,1974,276,747,1023,50,1073
公投第１４案,桃園市,平鎮區,南勢里,808,1867,267,632,899,37,936
公投第１４案,桃園市,平鎮區,金星里,809,1786,254,646,900,28,928
公投第１４案,桃園市,平鎮區,金星里,810,1634,202,456,658,26,684
公投第１４案,桃園市,平鎮區,金星里,811,1080,167,408,575,29,604
公投第１４案,桃園市,平鎮區,金星里,812,1514,254,514,768,30,798
公投第１４案,桃園市,平鎮區,平安里,813,1918,237,580,817,44,861
公投第１４案,桃園市,平鎮區,平安里,814,1182,151,433,584,73,657
公投第１４案,桃園市,平鎮區,平安里,815,1667,228,540,768,36,804
公投第１４案,桃園市,平鎮區,平南里,816,1640,215,520,735,27,762
公投第１４案,桃園市,平鎮區,平南里,817,1603,255,547,802,28,830
公投第１４案,桃園市,平鎮區,平南里,818,1556,227,626,853,18,871
公投第１４案,桃園市,平鎮區,平南里,819,1697,235,588,823,32,855
公投第１４案,桃園市,平鎮區,山峰里,820,1130,160,391,551,20,571
公投第１４案,桃園市,平鎮區,山峰里,821,1196,282,423,705,25,730
公投第１４案,桃園市,平鎮區,福林里,822,1685,238,617,855,29,884
公投第１４案,桃園市,平鎮區,福林里,823,1532,239,598,837,33,870
公投第１４案,桃園市,平鎮區,湧光里,824,1564,233,548,781,36,817
公投第１４案,桃園市,平鎮區,湧光里,825,1824,209,553,762,33,795
公投第１４案,桃園市,平鎮區,湧光里,826,1912,283,638,921,25,946
公投第１４案,桃園市,平鎮區,莊敬里,827,1048,131,385,516,48,564
公投第１４案,桃園市,平鎮區,莊敬里,828,1259,188,479,667,41,708
公投第１４案,桃園市,平鎮區,莊敬里,829,1061,150,391,541,26,567
公投第１４案,桃園市,平鎮區,莊敬里,830,1072,159,459,618,25,643
公投第１４案,桃園市,平鎮區,湧豐里,831,1788,246,629,875,45,920
公投第１４案,桃園市,平鎮區,湧安里,832,1510,224,552,776,17,793
公投第１４案,桃園市,平鎮區,湧安里,833,1403,196,494,690,50,740
公投第１４案,桃園市,平鎮區,湧安里,834,1407,217,503,720,47,767
公投第１４案,桃園市,平鎮區,宋屋里,835,1901,306,665,971,45,1016
公投第１４案,桃園市,平鎮區,宋屋里,836,1994,270,625,895,26,921
公投第１４案,桃園市,平鎮區,平興里,837,1730,270,602,872,29,901
公投第１４案,桃園市,平鎮區,平興里,838,1905,327,638,965,43,1008
公投第１４案,桃園市,平鎮區,平興里,839,1723,303,626,929,11,940
公投第１４案,桃園市,平鎮區,廣興里,840,1307,505,181,686,48,734
公投第１４案,桃園市,平鎮區,廣興里,841,1337,225,492,717,33,750
公投第１４案,桃園市,平鎮區,廣興里,842,980,191,426,617,23,640
公投第１４案,桃園市,平鎮區,廣興里,843,1818,299,586,885,49,934
公投第１４案,桃園市,平鎮區,廣達里,844,1463,253,516,769,38,807
公投第１４案,桃園市,平鎮區,廣達里,845,1213,233,452,685,35,720
公投第１４案,桃園市,平鎮區,廣達里,846,1085,196,411,607,28,635
公投第１４案,桃園市,平鎮區,廣仁里,847,1458,180,528,708,31,739
公投第１４案,桃園市,平鎮區,廣仁里,848,1408,214,521,735,45,780
公投第１４案,桃園市,平鎮區,廣仁里,849,1396,232,435,667,46,713
公投第１４案,桃園市,平鎮區,復旦里,850,1044,232,414,646,23,669
公投第１４案,桃園市,平鎮區,復旦里,851,1124,198,421,619,14,633
公投第１４案,桃園市,平鎮區,復旦里,852,1517,278,529,807,16,823
公投第１４案,桃園市,平鎮區,復旦里,853,1571,288,522,810,21,831
公投第１４案,桃園市,平鎮區,復興里,854,1752,300,665,965,28,993
公投第１４案,桃園市,平鎮區,復興里,855,1434,255,581,836,32,868
公投第１４案,桃園市,平鎮區,復興里,856,1710,314,637,951,33,984
公投第１４案,桃園市,平鎮區,義民里,857,1555,266,569,835,30,865
公投第１４案,桃園市,平鎮區,義民里,858,2051,338,617,955,35,990
公投第１４案,桃園市,平鎮區,義民里,859,1477,261,504,765,29,794
公投第１４案,桃園市,平鎮區,義興里,860,1501,252,525,777,32,809
公投第１４案,桃園市,平鎮區,義興里,861,1405,232,502,734,47,781
公投第１４案,桃園市,平鎮區,義興里,862,1656,250,576,826,50,876
公投第１４案,桃園市,平鎮區,義興里,863,1921,300,572,872,32,904
公投第１４案,桃園市,平鎮區,雙連里,864,1717,247,472,719,24,743
公投第１４案,桃園市,平鎮區,雙連里,865,1319,230,451,681,40,721
公投第１４案,桃園市,平鎮區,雙連里,866,1745,271,581,852,41,893
公投第１４案,桃園市,平鎮區,高雙里,867,1721,266,614,880,53,933
公投第１４案,桃園市,平鎮區,高雙里,868,1206,196,453,649,24,673
公投第１４案,桃園市,平鎮區,高雙里,869,1202,255,493,748,30,778
公投第１４案,桃園市,平鎮區,北勢里,870,1208,183,492,675,30,705
公投第１４案,桃園市,平鎮區,北勢里,871,1267,214,523,737,25,762
公投第１４案,桃園市,平鎮區,北華里,872,1094,188,398,586,24,610
公投第１４案,桃園市,平鎮區,北華里,873,1394,247,531,778,45,823
公投第１４案,桃園市,平鎮區,北華里,874,1215,252,464,716,14,730
公投第１４案,桃園市,平鎮區,新勢里,875,1010,179,373,552,33,585
公投第１４案,桃園市,平鎮區,新勢里,876,1261,223,479,702,23,725
公投第１４案,桃園市,平鎮區,新勢里,877,1314,220,525,745,31,776
公投第１４案,桃園市,平鎮區,北安里,878,722,117,276,393,28,421
公投第１４案,桃園市,平鎮區,北安里,879,839,131,296,427,22,449
公投第１４案,桃園市,平鎮區,新榮里,880,1399,222,521,743,29,772
公投第１４案,桃園市,平鎮區,新榮里,881,1968,330,613,943,43,986
公投第１４案,桃園市,平鎮區,新榮里,882,1672,267,600,867,29,896
公投第１４案,桃園市,平鎮區,新富里,883,2213,181,447,628,23,651
公投第１４案,桃園市,平鎮區,新富里,884,949,224,354,578,12,590
公投第１４案,桃園市,平鎮區,新富里,885,1621,323,613,936,34,970
公投第１４案,桃園市,平鎮區,新富里,886,1643,275,533,808,33,841
公投第１４案,桃園市,平鎮區,新英里,887,1844,332,636,968,41,1009
公投第１４案,桃園市,平鎮區,新英里,888,1752,294,609,903,41,944
公投第１４案,桃園市,平鎮區,新貴里,889,1577,239,504,743,48,791
公投第１４案,桃園市,平鎮區,新貴里,890,1517,252,548,800,29,829
公投第１４案,桃園市,平鎮區,北興里,891,1039,171,414,585,27,612
公投第１４案,桃園市,平鎮區,北興里,892,1318,214,533,747,31,778
公投第１４案,桃園市,平鎮區,北興里,893,1636,236,601,837,38,875
公投第１４案,桃園市,平鎮區,金陵里,894,1316,245,469,714,33,747
公投第１４案,桃園市,平鎮區,金陵里,895,1474,275,524,799,27,826
公投第１４案,桃園市,平鎮區,北貴里,896,1480,192,474,666,45,711
公投第１４案,桃園市,平鎮區,北貴里,897,1330,185,507,692,19,711
公投第１４案,桃園市,平鎮區,北貴里,898,1228,202,445,647,33,680
公投第１４案,桃園市,平鎮區,北富里,899,1377,246,533,779,33,812
公投第１４案,桃園市,平鎮區,北富里,900,1198,218,484,702,27,729
公投第１４案,桃園市,平鎮區,北富里,901,1231,205,515,720,27,747
公投第１４案,桃園市,平鎮區,建安里,902,1243,215,451,666,48,714
公投第１４案,桃園市,平鎮區,建安里,903,1590,224,578,802,39,841
公投第１４案,桃園市,平鎮區,建安里,904,1366,189,509,698,37,735
公投第１４案,桃園市,平鎮區,華安里,905,1332,187,506,693,45,738
公投第１４案,桃園市,平鎮區,華安里,906,1201,163,401,564,19,583
公投第１４案,桃園市,平鎮區,華安里,907,1668,234,524,758,26,784
公投第１４案,桃園市,平鎮區,東安里,908,1351,192,459,651,54,705
公投第１４案,桃園市,平鎮區,東安里,909,1460,196,484,680,21,701
公投第１４案,桃園市,平鎮區,新安里,910,1841,354,541,895,30,925
公投第１４案,桃園市,平鎮區,新安里,911,1475,216,478,694,18,712
公投第１４案,桃園市,平鎮區,新安里,912,1011,140,400,540,19,559
公投第１４案,桃園市,平鎮區,東勢里,913,1052,138,348,486,34,520
公投第１４案,桃園市,平鎮區,東勢里,914,1154,198,466,664,42,706
公投第１４案,桃園市,平鎮區,東勢里,915,1645,231,572,803,21,824
公投第１４案,桃園市,平鎮區,東勢里,916,1539,217,497,714,60,774
公投第１４案,桃園市,平鎮區,龍恩里,917,1385,210,495,705,47,752
公投第１４案,桃園市,平鎮區,龍恩里,918,1395,308,398,706,38,744
公投第１４案,桃園市,平鎮區,東社里,919,1711,226,607,833,36,869
公投第１４案,桃園市,平鎮區,東社里,920,1631,233,559,792,42,834
公投第１４案,桃園市,平鎮區,忠貞里,921,1110,199,401,600,21,621
公投第１４案,桃園市,平鎮區,貿易里,922,1931,235,786,1021,37,1058
公投第１４案,桃園市,平鎮區,龍興里,923,1127,161,435,596,25,621
公投第１４案,桃園市,平鎮區,龍興里,924,1414,217,514,731,47,778
公投第１４案,桃園市,平鎮區,中正里,925,1609,214,576,790,51,841
公投第１４案,桃園市,楊梅區,仁美里,926,1269,178,478,656,52,708
公投第１４案,桃園市,楊梅區,仁美里,927,1246,100,619,719,53,772
公投第１４案,桃園市,楊梅區,仁美里,928,1408,223,556,779,37,816
公投第１４案,桃園市,楊梅區,埔心里,929,1434,116,646,762,41,803
公投第１４案,桃園市,楊梅區,光華里,930,1515,191,538,729,52,781
公投第１４案,桃園市,楊梅區,光華里,931,1657,208,552,760,53,813
公投第１４案,桃園市,楊梅區,金龍里,932,1137,163,464,627,35,662
公投第１４案,桃園市,楊梅區,四維里,933,2211,323,748,1071,36,1107
公投第１４案,桃園市,楊梅區,四維里,934,2008,288,692,980,31,1011
公投第１４案,桃園市,楊梅區,永平里,935,1911,317,659,976,29,1005
公投第１４案,桃園市,楊梅區,瑞塘里,936,1449,216,554,770,47,817
公投第１４案,桃園市,楊梅區,瑞塘里,937,1877,245,575,820,47,867
公投第１４案,桃園市,楊梅區,瑞塘里,938,1988,257,665,922,35,957
公投第１４案,桃園市,楊梅區,瑞坪里,939,1931,318,663,981,25,1006
公投第１４案,桃園市,楊梅區,瑞坪里,940,1938,248,549,797,61,858
公投第１４案,桃園市,楊梅區,瑞坪里,941,1677,233,626,859,25,884
公投第１４案,桃園市,楊梅區,梅溪里,942,1848,296,604,900,21,921
公投第１４案,桃園市,楊梅區,梅溪里,943,1882,322,635,957,28,985
公投第１４案,桃園市,楊梅區,瑞溪里,944,1541,193,429,622,11,633
公投第１４案,桃園市,楊梅區,瑞溪里,945,1938,273,634,907,36,943
公投第１４案,桃園市,楊梅區,金溪里,946,1562,211,498,709,15,724
公投第１４案,桃園市,楊梅區,金溪里,947,2125,425,712,1137,39,1176
公投第１４案,桃園市,楊梅區,三民里,948,1516,237,602,839,48,887
公投第１４案,桃園市,楊梅區,三民里,949,1807,253,619,872,24,896
公投第１４案,桃園市,楊梅區,楊明里,950,2101,317,651,968,34,1002
公投第１４案,桃園市,楊梅區,楊明里,951,2054,309,709,1018,54,1072
公投第１４案,桃園市,楊梅區,楊明里,952,2226,304,709,1013,22,1035
公投第１４案,桃園市,楊梅區,裕成里,953,1405,229,506,735,12,747
公投第１４案,桃園市,楊梅區,裕成里,954,1843,282,568,850,25,875
公投第１４案,桃園市,楊梅區,裕新里,955,2324,310,685,995,42,1037
公投第１４案,桃園市,楊梅區,大同里,956,1713,260,612,872,27,899
公投第１４案,桃園市,楊梅區,大同里,957,1587,246,649,895,42,937
公投第１４案,桃園市,楊梅區,中山里,958,1416,224,563,787,30,817
公投第１４案,桃園市,楊梅區,中山里,959,1591,244,606,850,22,872
公投第１４案,桃園市,楊梅區,楊梅里,960,1943,267,692,959,40,999
公投第１４案,桃園市,楊梅區,楊梅里,961,1762,249,642,891,40,931
公投第１４案,桃園市,楊梅區,楊江里,962,1083,161,388,549,35,584
公投第１４案,桃園市,楊梅區,梅新里,963,2027,278,731,1009,36,1045
公投第１４案,桃園市,楊梅區,紅梅里,964,1274,184,488,672,57,729
公投第１４案,桃園市,楊梅區,紅梅里,965,1359,197,536,733,52,785
公投第１４案,桃園市,楊梅區,永寧里,966,2444,256,566,822,41,863
公投第１４案,桃園市,楊梅區,永寧里,967,2298,282,717,999,38,1037
公投第１４案,桃園市,楊梅區,永寧里,968,2222,303,758,1061,34,1095
公投第１４案,桃園市,楊梅區,大平里,969,1610,228,555,783,70,853
公投第１４案,桃園市,楊梅區,大平里,970,1627,235,561,796,71,867
公投第１４案,桃園市,楊梅區,秀才里,971,1589,193,765,958,46,1004
公投第１４案,桃園市,楊梅區,秀才里,972,1758,270,616,886,54,940
公投第１４案,桃園市,楊梅區,東流里,973,1776,207,522,729,48,777
公投第１４案,桃園市,楊梅區,東流里,974,1000,143,325,468,26,494
公投第１４案,桃園市,楊梅區,豐野里,975,2290,273,694,967,69,1036
公投第１４案,桃園市,楊梅區,豐野里,976,1551,228,537,765,51,816
公投第１４案,桃園市,楊梅區,富岡里,977,1861,226,655,881,52,933
公投第１４案,桃園市,楊梅區,富豐里,978,1141,149,350,499,36,535
公投第１４案,桃園市,楊梅區,富豐里,979,1785,221,598,819,44,863
公投第１４案,桃園市,楊梅區,員本里,980,1498,205,542,747,53,800
公投第１４案,桃園市,楊梅區,員本里,981,1187,170,397,567,58,625
公投第１４案,桃園市,楊梅區,三湖里,982,1270,192,468,660,49,709
公投第１４案,桃園市,楊梅區,三湖里,983,1424,187,522,709,45,754
公投第１４案,桃園市,楊梅區,頭湖里,984,1273,225,528,753,23,776
公投第１４案,桃園市,楊梅區,頭湖里,985,1534,218,463,681,31,712
公投第１４案,桃園市,楊梅區,上湖里,986,1783,241,509,750,70,820
公投第１４案,桃園市,楊梅區,上湖里,987,1709,212,582,794,24,818
公投第１４案,桃園市,楊梅區,上湖里,988,1920,234,590,824,61,885
公投第１４案,桃園市,楊梅區,上田里,989,1194,185,432,617,33,650
公投第１４案,桃園市,楊梅區,上田里,990,1408,206,551,757,18,775
公投第１４案,桃園市,楊梅區,高山里,991,1737,192,556,748,40,788
公投第１４案,桃園市,楊梅區,高山里,992,1920,249,673,922,33,955
公投第１４案,桃園市,楊梅區,高上里,993,1234,199,429,628,25,653
公投第１４案,桃園市,楊梅區,高上里,994,1491,214,557,771,59,830
公投第１４案,桃園市,楊梅區,青山里,995,2020,281,626,907,41,948
公投第１４案,桃園市,楊梅區,青山里,996,1863,264,567,831,33,864
公投第１４案,桃園市,楊梅區,高榮里,997,1692,225,634,859,57,916
公投第１４案,桃園市,楊梅區,高榮里,998,1686,262,579,841,29,870
公投第１４案,桃園市,楊梅區,雙榮里,999,1626,254,549,803,83,886
公投第１４案,桃園市,楊梅區,雙榮里,1000,1557,252,572,824,24,848
公投第１４案,桃園市,楊梅區,新榮里,1001,1603,270,596,866,60,926
公投第１４案,桃園市,楊梅區,新榮里,1002,1889,272,594,866,62,928
公投第１４案,桃園市,楊梅區,水美里,1003,1448,230,549,779,28,807
公投第１４案,桃園市,楊梅區,水美里,1004,1351,175,546,721,36,757
公投第１４案,桃園市,楊梅區,水美里,1005,1313,194,527,721,42,763
公投第１４案,桃園市,楊梅區,瑞原里,1006,1689,228,614,842,39,881
公投第１４案,桃園市,楊梅區,瑞原里,1007,2063,273,677,950,28,978
公投第１４案,桃園市,龍潭區,黃唐里,1008,1482,205,534,739,23,762
公投第１４案,桃園市,龍潭區,黃唐里,1009,1528,229,509,738,34,772
公投第１４案,桃園市,龍潭區,黃唐里,1010,1503,214,539,753,41,794
公投第１４案,桃園市,龍潭區,永興里,1011,1568,205,536,741,53,794
公投第１４案,桃園市,龍潭區,永興里,1012,1216,169,398,567,64,631
公投第１４案,桃園市,龍潭區,中山里,1013,2088,273,612,885,64,949
公投第１４案,桃園市,龍潭區,中山里,1014,1987,295,753,1048,65,1113
公投第１４案,桃園市,龍潭區,中山里,1015,1586,270,624,894,37,931
公投第１４案,桃園市,龍潭區,烏樹林里,1016,1221,183,410,593,35,628
公投第１４案,桃園市,龍潭區,烏樹林里,1017,1134,154,453,607,39,646
公投第１４案,桃園市,龍潭區,烏林里,1018,2081,261,682,943,55,998
公投第１４案,桃園市,龍潭區,烏林里,1019,1925,254,638,892,28,920
公投第１４案,桃園市,龍潭區,百年里,1020,2095,354,756,1110,29,1139
公投第１４案,桃園市,龍潭區,百年里,1021,2040,344,767,1111,50,1161
公投第１４案,桃園市,龍潭區,凌雲里,1022,1790,249,586,835,52,887
公投第１４案,桃園市,龍潭區,凌雲里,1023,1872,273,666,939,80,1019
公投第１４案,桃園市,龍潭區,龍祥里,1024,1726,263,653,916,57,973
公投第１４案,桃園市,龍潭區,龍祥里,1025,1792,252,670,922,55,977
公投第１４案,桃園市,龍潭區,八德里,1026,1398,213,507,720,33,753
公投第１４案,桃園市,龍潭區,八德里,1027,1345,181,473,654,30,684
公投第１４案,桃園市,龍潭區,八德里,1028,1409,210,517,727,44,771
公投第１４案,桃園市,龍潭區,聖德里,1029,1362,231,410,641,17,658
公投第１４案,桃園市,龍潭區,聖德里,1030,1650,289,607,896,43,939
公投第１４案,桃園市,龍潭區,上林里,1031,1597,205,573,778,55,833
公投第１４案,桃園市,龍潭區,上林里,1032,1410,216,506,722,26,748
公投第１４案,桃園市,龍潭區,上林里,1033,1275,194,472,666,41,707
公投第１４案,桃園市,龍潭區,龍潭里,1034,1909,329,724,1053,58,1111
公投第１４案,桃園市,龍潭區,龍星里,1035,2024,292,776,1068,42,1110
公投第１４案,桃園市,龍潭區,龍星里,1036,2002,277,755,1032,46,1078
公投第１４案,桃園市,龍潭區,中正里,1037,1786,296,684,980,35,1015
公投第１４案,桃園市,龍潭區,中正里,1038,1756,284,629,913,43,956
公投第１４案,桃園市,龍潭區,中正里,1039,1830,287,710,997,26,1023
公投第１４案,桃園市,龍潭區,上華里,1040,1697,270,694,964,35,999
公投第１４案,桃園市,龍潭區,上華里,1041,1519,231,597,828,28,856
公投第１４案,桃園市,龍潭區,九龍里,1042,1805,233,619,852,40,892
公投第１４案,桃園市,龍潭區,九龍里,1043,1792,211,570,781,28,809
公投第１４案,桃園市,龍潭區,武漢里,1044,1500,205,618,823,54,877
公投第１４案,桃園市,龍潭區,祥和里,1045,1427,195,489,684,32,716
公投第１４案,桃園市,龍潭區,東興里,1046,1444,169,443,612,42,654
公投第１４案,桃園市,龍潭區,東興里,1047,1321,173,448,621,51,672
公投第１４案,桃園市,龍潭區,東興里,1048,1215,252,438,690,31,721
公投第１４案,桃園市,龍潭區,中興里,1049,1297,174,476,650,45,695
公投第１４案,桃園市,龍潭區,中興里,1050,1407,190,482,672,17,689
公投第１４案,桃園市,龍潭區,中興里,1051,1564,215,523,738,36,774
公投第１４案,桃園市,龍潭區,北興里,1052,1317,177,482,659,41,700
公投第１４案,桃園市,龍潭區,北興里,1053,1023,123,350,473,35,508
公投第１４案,桃園市,龍潭區,佳安里,1054,1721,258,627,885,50,935
公投第１４案,桃園市,龍潭區,佳安里,1055,1764,267,657,924,44,968
公投第１４案,桃園市,龍潭區,三坑里,1056,1499,195,573,768,58,826
公投第１４案,桃園市,龍潭區,大平里,1057,2151,260,706,966,40,1006
公投第１４案,桃園市,龍潭區,三林里,1058,1524,229,600,829,33,862
公投第１４案,桃園市,龍潭區,三林里,1059,1456,228,618,846,29,875
公投第１４案,桃園市,龍潭區,建林里,1060,1847,275,807,1082,30,1112
公投第１４案,桃園市,龍潭區,建林里,1061,1899,295,821,1116,27,1143
公投第１４案,桃園市,龍潭區,富林里,1062,1725,208,695,903,34,937
公投第１４案,桃園市,龍潭區,富林里,1063,1665,238,725,963,50,1013
公投第１４案,桃園市,龍潭區,高平里,1064,1649,247,549,796,34,830
公投第１４案,桃園市,龍潭區,高平里,1065,1539,188,519,707,39,746
公投第１４案,桃園市,龍潭區,高原里,1066,1541,236,606,842,43,885
公投第１４案,桃園市,龍潭區,高原里,1067,1375,239,476,715,39,754
公投第１４案,桃園市,龍潭區,高原里,1068,1453,230,522,752,30,782
公投第１４案,桃園市,龍潭區,三和里,1069,1074,181,387,568,42,610
公投第１４案,桃園市,龍潭區,三和里,1070,1299,242,494,736,20,756
公投第１４案,桃園市,龍潭區,三水里,1071,678,97,216,313,14,327
公投第１４案,桃園市,新屋區,新屋里,1072,1306,212,533,745,30,775
公投第１４案,桃園市,新屋區,新屋里,1073,1556,250,574,824,39,863
公投第１４案,桃園市,新屋區,新生里,1074,1849,311,746,1057,54,1111
公投第１４案,桃園市,新屋區,新生里,1075,2096,375,779,1154,70,1224
公投第１４案,桃園市,新屋區,後湖里,1076,1517,203,547,750,47,797
公投第１４案,桃園市,新屋區,清華里,1077,2095,325,814,1139,65,1204
公投第１４案,桃園市,新屋區,清華里,1078,1856,242,579,821,40,861
公投第１４案,桃園市,新屋區,石磊里,1079,1986,275,757,1032,67,1099
公投第１４案,桃園市,新屋區,東明里,1080,1425,189,466,655,49,704
公投第１４案,桃園市,新屋區,社子里,1081,1385,179,471,650,35,685
公投第１４案,桃園市,新屋區,埔頂里,1082,1271,231,497,728,53,781
公投第１４案,桃園市,新屋區,埔頂里,1083,1271,168,473,641,41,682
公投第１４案,桃園市,新屋區,九斗里,1084,1234,202,457,659,43,702
公投第１４案,桃園市,新屋區,九斗里,1085,1085,168,393,561,45,606
公投第１４案,桃園市,新屋區,頭洲里,1086,1992,280,813,1093,40,1133
公投第１４案,桃園市,新屋區,頭洲里,1087,2032,318,800,1118,74,1192
公投第１４案,桃園市,新屋區,大坡里,1088,1291,172,472,644,61,705
公投第１４案,桃園市,新屋區,望間里,1089,1401,177,511,688,40,728
公投第１４案,桃園市,新屋區,後庄里,1090,1106,171,434,605,42,647
公投第１４案,桃園市,新屋區,蚵間里,1091,908,140,334,474,17,491
公投第１４案,桃園市,新屋區,深圳里,1092,663,102,264,366,42,408
公投第１４案,桃園市,新屋區,槺榔里,1093,1088,133,405,538,47,585
公投第１４案,桃園市,新屋區,笨港里,1094,1050,158,455,613,56,669
公投第１４案,桃園市,新屋區,永安里,1095,896,121,374,495,27,522
公投第１４案,桃園市,新屋區,永安里,1096,1369,218,537,755,62,817
公投第１４案,桃園市,新屋區,永興里,1097,995,119,350,469,31,500
公投第１４案,桃園市,新屋區,下埔里,1098,741,102,289,391,32,423
公投第１４案,桃園市,新屋區,石牌里,1099,943,155,370,525,57,582
公投第１４案,桃園市,新屋區,下田里,1100,1714,208,609,817,82,899
公投第１４案,桃園市,新屋區,赤欄里,1101,1340,182,544,726,21,747
公投第１４案,桃園市,觀音區,觀音里,1102,1371,194,435,629,40,669
公投第１４案,桃園市,觀音區,觀音里,1103,1362,164,394,558,28,586
公投第１４案,桃園市,觀音區,白玉里,1104,997,156,314,470,63,533
公投第１４案,桃園市,觀音區,廣興里,1105,1407,179,460,639,27,666
公投第１４案,桃園市,觀音區,大潭里,1106,1692,270,588,858,30,888
公投第１４案,桃園市,觀音區,保生里,1107,1279,179,461,640,32,672
公投第１４案,桃園市,觀音區,保生里,1108,791,111,289,400,15,415
公投第１４案,桃園市,觀音區,武威里,1109,892,154,322,476,30,506
公投第１４案,桃園市,觀音區,三和里,1110,886,149,362,511,20,531
公投第１４案,桃園市,觀音區,新興里,1111,712,105,258,363,35,398
公投第１４案,桃園市,觀音區,坑尾里,1112,1609,237,490,727,87,814
公投第１４案,桃園市,觀音區,金湖里,1113,1274,195,458,653,52,705
公投第１４案,桃園市,觀音區,金湖里,1114,1351,166,403,569,33,602
公投第１４案,桃園市,觀音區,藍埔里,1115,1262,236,455,691,38,729
公投第１４案,桃園市,觀音區,藍埔里,1116,1242,209,437,646,61,707
公投第１４案,桃園市,觀音區,大同里,1117,1461,247,483,730,44,774
公投第１４案,桃園市,觀音區,大同里,1118,1613,253,545,798,44,842
公投第１４案,桃園市,觀音區,大堀里,1119,1479,217,520,737,52,789
公投第１４案,桃園市,觀音區,崙坪里,1120,1552,218,463,681,60,741
公投第１４案,桃園市,觀音區,崙坪里,1121,1517,237,507,744,30,774
公投第１４案,桃園市,觀音區,崙坪里,1122,1691,244,534,778,58,836
公投第１４案,桃園市,觀音區,富源里,1123,1157,204,421,625,20,645
公投第１４案,桃園市,觀音區,富源里,1124,1455,206,496,702,46,748
公投第１４案,桃園市,觀音區,富源里,1125,1150,175,396,571,39,610
公投第１４案,桃園市,觀音區,上大里,1126,1112,162,426,588,37,625
公投第１４案,桃園市,觀音區,上大里,1127,1251,177,417,594,22,616
公投第１４案,桃園市,觀音區,新坡里,1128,1446,225,487,712,70,782
公投第１４案,桃園市,觀音區,新坡里,1129,1493,243,473,716,74,790
公投第１４案,桃園市,觀音區,廣福里,1130,1339,190,451,641,60,701
公投第１４案,桃園市,觀音區,廣福里,1131,1137,189,445,634,36,670
公投第１４案,桃園市,觀音區,塔腳里,1132,1043,129,359,488,38,526
公投第１４案,桃園市,觀音區,保障里,1133,993,142,290,432,30,462
公投第１４案,桃園市,觀音區,保障里,1134,975,152,309,461,37,498
公投第１４案,桃園市,觀音區,草漯里,1135,2029,272,591,863,45,908
公投第１４案,桃園市,觀音區,草新里,1136,1765,297,628,925,39,964
公投第１４案,桃園市,觀音區,草新里,1137,1809,265,618,883,41,924
公投第１４案,桃園市,觀音區,草新里,1138,1869,267,606,873,32,905
公投第１４案,桃園市,觀音區,樹林里,1139,1870,219,542,761,48,809
公投第１４案,桃園市,觀音區,樹林里,1140,1932,215,427,642,49,691
公投第１４案,桃園市,觀音區,富林里,1141,899,103,281,384,13,397
公投第１４案,桃園市,觀音區,富林里,1142,985,124,293,417,14,431
